district_id,forecast_area_id,district_region_id,planning_area_id,inhabitants,inhabitants_percentage,inhabitants_with_migration_background,inhabitants_with_migration_background_percentage,inhabitants_germans,inhabitants_germans_percentage,inhabitants_germans_without_migration_background,inhabitants_germans_without_migration_background_percentage,inhabitants_germans_with_migration_background,inhabitants_germans_with_migration_background_percentage,inhabitants_foreigners,inhabitants_foreigners_percentage
01,10,01,01,3580,100.0,2404,67.2,1999,55.8,1176,32.8,823,23,1581,44.2
01,10,01,02,2034,100.0,1438,70.7,941,46.3,596,29.3,345,17,1093,53.7
01,10,01,03,5790,100.0,3594,62.1,3588,62,2196,37.9,1392,24,2202,38
01,10,01,04,4889,100.0,3252,66.5,2929,59.9,1637,33.5,1292,26.4,1960,40.1
01,10,02,05,2917,100.0,2033,69.7,1389,47.6,884,30.3,505,17.3,1528,52.4
01,10,02,06,1876,100.0,1027,54.7,1202,64.1,849,45.3,353,18.8,674,35.9
01,10,02,07,8844,100.0,5089,57.5,5587,63.2,3755,42.5,1832,20.7,3257,36.8
01,10,03,08,7297,100.0,3650,50,4795,65.7,3647,50,1148,15.7,2502,34.3
01,10,03,09,12651,100.0,5700,45.1,8991,71.1,6951,54.9,2040,16.1,3660,28.9
01,10,03,10,10181,100.0,5618,55.2,6304,61.9,4563,44.8,1741,17.1,3877,38.1
01,10,03,11,9787,100.0,5368,54.8,6332,64.7,4419,45.2,1913,19.5,3455,35.3
01,10,03,12,10727,100.0,5681,53,6943,64.7,5046,47,1897,17.7,3784,35.3
01,10,03,13,11590,100.0,6059,52.3,7406,63.9,5531,47.7,1875,16.2,4184,36.1
01,10,04,14,5513,100.0,3289,59.7,3091,56.1,2224,40.3,867,15.7,2422,43.9
01,10,04,15,13348,100.0,6171,46.2,9185,68.8,7177,53.8,2008,15,4163,31.2
01,10,04,16,13523,100.0,6048,44.7,9591,70.9,7475,55.3,2116,15.6,3932,29.1
01,20,05,17,3924,100.0,2489,63.4,2157,55,1435,36.6,722,18.4,1767,45
01,20,05,18,7096,100.0,4742,66.8,3826,53.9,2354,33.2,1472,20.7,3270,46.1
01,20,05,19,9592,100.0,5611,58.5,5761,60.1,3981,41.5,1780,18.6,3831,39.9
01,20,05,20,9513,100.0,4841,50.9,6524,68.6,4672,49.1,1852,19.5,2989,31.4
01,20,05,21,5259,100.0,3289,62.5,3133,59.6,1970,37.5,1163,22.1,2126,40.4
01,20,05,22,11521,100.0,4558,39.6,8898,77.2,6963,60.4,1935,16.8,2623,22.8
01,20,06,23,10990,100.0,6023,54.8,7259,66.1,4967,45.2,2292,20.9,3731,33.9
01,20,06,24,6942,100.0,5139,74,3349,48.2,1803,26,1546,22.3,3593,51.8
01,20,06,25,6905,100.0,4293,62.2,4464,64.6,2612,37.8,1852,26.8,2441,35.4
01,20,06,26,6079,100.0,2856,47,4307,70.9,3223,53,1084,17.8,1772,29.1
01,20,06,27,3388,100.0,2328,68.7,2193,64.7,1060,31.3,1133,33.4,1195,35.3
01,20,06,28,3281,100.0,1573,47.9,2395,73,1708,52.1,687,20.9,886,27
01,20,06,29,6039,100.0,3084,51.1,3921,64.9,2955,48.9,966,16,2118,35.1
01,30,07,30,8060,100.0,5901,73.2,4092,50.8,2159,26.8,1933,24,3968,49.2
01,30,07,31,8922,100.0,5654,63.4,5177,58,3268,36.6,1909,21.4,3745,42
01,30,07,32,10078,100.0,6403,63.5,6003,59.6,3675,36.5,2328,23.1,4075,40.4
01,30,07,33,11684,100.0,7508,64.3,7042,60.3,4176,35.7,2866,24.5,4642,39.7
01,30,08,34,14258,100.0,9698,68,9793,68.7,4560,32,5233,36.7,4465,31.3
01,30,08,35,10821,100.0,6823,63.1,7180,66.4,3998,36.9,3182,29.4,3641,33.6
01,30,08,36,14947,100.0,10137,67.8,8583,57.4,4810,32.2,3773,25.2,6364,42.6
01,40,09,37,10966,100.0,6004,54.8,7206,65.7,4962,45.2,2244,20.5,3760,34.3
01,40,09,38,9681,100.0,5386,55.6,6229,64.3,4295,44.4,1934,20,3452,35.7
01,40,09,39,6149,100.0,3572,58.1,3620,58.9,2577,41.9,1043,17,2529,41.1
01,40,09,40,7094,100.0,3092,43.6,5677,80,4002,56.4,1675,23.6,1417,20
01,40,09,41,3863,100.0,1952,50.5,2753,71.3,1911,49.5,842,21.8,1110,28.7
01,40,09,42,8789,100.0,5053,57.5,5337,60.7,3736,42.5,1601,18.2,3452,39.3
01,40,10,43,7627,100.0,5264,69,4390,57.6,2363,31,2027,26.6,3237,42.4
01,40,10,44,10226,100.0,7225,70.7,5590,54.7,3001,29.3,2589,25.3,4636,45.3
01,40,10,45,5531,100.0,4110,74.3,3050,55.1,1421,25.7,1629,29.5,2481,44.9
01,40,10,46,8869,100.0,4778,53.9,5731,64.6,4091,46.1,1640,18.5,3138,35.4
01,40,10,47,8206,100.0,5867,71.5,3907,47.6,2339,28.5,1568,19.1,4299,52.4
01,40,10,48,9520,100.0,6093,64,5439,57.1,3427,36,2012,21.1,4081,42.9
01,40,10,49,6637,100.0,4194,63.2,3794,57.2,2443,36.8,1351,20.4,2843,42.8
02,10,01,01,7225,100.0,5489,76,3596,49.8,1736,24,1860,25.7,3629,50.2
02,10,01,02,8660,100.0,6274,72.4,5460,63,2386,27.6,3074,35.5,3200,37
02,10,01,03,5470,100.0,3550,64.9,3669,67.1,1920,35.1,1749,32,1801,32.9
02,10,01,04,5550,100.0,3916,70.6,3443,62,1634,29.4,1809,32.6,2107,38
02,10,01,05,9263,100.0,6743,72.8,5930,64,2520,27.2,3410,36.8,3333,36
02,10,01,06,4813,100.0,3173,65.9,3250,67.5,1640,34.1,1610,33.5,1563,32.5
02,20,02,07,2666,100.0,1275,47.8,1867,70,1391,52.2,476,17.9,799,30
02,20,02,08,5745,100.0,2731,47.5,4018,69.9,3014,52.5,1004,17.5,1727,30.1
02,20,02,09,10957,100.0,4773,43.6,8147,74.4,6184,56.4,1963,17.9,2810,25.6
02,20,02,10,12350,100.0,5880,47.6,8696,70.4,6470,52.4,2226,18,3654,29.6
02,20,02,11,14595,100.0,6493,44.5,10817,74.1,8102,55.5,2715,18.6,3778,25.9
02,20,02,12,8340,100.0,4262,51.1,6120,73.4,4078,48.9,2042,24.5,2220,26.6
02,20,02,13,10004,100.0,4674,46.7,7065,70.6,5330,53.3,1735,17.3,2939,29.4
02,30,03,14,7085,100.0,4275,60.3,4586,64.7,2810,39.7,1776,25.1,2499,35.3
02,30,03,15,8209,100.0,4755,57.9,5398,65.8,3454,42.1,1944,23.7,2811,34.2
02,30,03,16,4160,100.0,2121,51,2940,70.7,2039,49,901,21.7,1220,29.3
02,30,04,17,8301,100.0,4653,56.1,5417,65.3,3648,43.9,1769,21.3,2884,34.7
02,30,04,18,7629,100.0,3838,50.3,5231,68.6,3791,49.7,1440,18.9,2398,31.4
02,30,04,19,10396,100.0,5503,52.9,6880,66.2,4893,47.1,1987,19.1,3516,33.8
02,40,05,20,5904,100.0,2540,43,4396,74.5,3364,57,1032,17.5,1508,25.5
02,40,05,21,8712,100.0,3801,43.6,6287,72.2,4911,56.4,1376,15.8,2425,27.8
02,40,05,22,11394,100.0,4102,36,8844,77.6,7292,64,1552,13.6,2550,22.4
02,40,06,23,14037,100.0,7584,54,9127,65,6453,46,2674,19,4910,35
02,40,06,24,11887,100.0,5000,42.1,8241,69.3,6887,57.9,1354,11.4,3646,30.7
02,40,06,25,1328,100.0,947,71.3,565,42.5,381,28.7,184,13.9,763,57.5
02,50,07,26,9175,100.0,3784,41.2,6572,71.6,5391,58.8,1181,12.9,2603,28.4
02,50,07,27,6519,100.0,2690,41.3,4726,72.5,3829,58.7,897,13.8,1793,27.5
02,50,07,28,10073,100.0,3849,38.2,7429,73.8,6224,61.8,1205,12,2644,26.2
02,50,07,29,5407,100.0,2096,38.8,4110,76,3311,61.2,799,14.8,1297,24
02,50,08,30,4071,100.0,1825,44.8,2789,68.5,2246,55.2,543,13.3,1282,31.5
02,50,08,31,7857,100.0,3475,44.2,5436,69.2,4382,55.8,1054,13.4,2421,30.8
02,50,08,32,9541,100.0,4670,48.9,6263,65.6,4871,51.1,1392,14.6,3278,34.4
02,50,08,33,10045,100.0,4287,42.7,6885,68.5,5758,57.3,1127,11.2,3160,31.5
02,50,08,34,11299,100.0,4374,38.7,8334,73.8,6925,61.3,1409,12.5,2965,26.2
02,50,08,35,8820,100.0,4318,49,5677,64.4,4502,51,1175,13.3,3143,35.6
02,50,08,36,5137,100.0,1454,28.3,4421,86.1,3683,71.7,738,14.4,716,13.9
03,10,01,01,4720,100.0,1011,21.4,4069,86.2,3709,78.6,360,7.6,651,13.8
03,10,01,02,3505,100.0,1312,37.4,2511,71.6,2193,62.6,318,9.1,994,28.4
03,10,01,03,9449,100.0,2654,28.1,7371,78,6795,71.9,576,6.1,2078,22
03,20,02,04,2423,100.0,533,22,1990,82.1,1890,78,100,4.1,433,17.9
03,20,02,05,9167,100.0,2183,23.8,7759,84.6,6984,76.2,775,8.5,1408,15.4
03,20,02,06,6842,100.0,1810,26.5,5585,81.6,5032,73.5,553,8.1,1257,18.4
03,20,02,07,11799,100.0,2825,23.9,10067,85.3,8974,76.1,1093,9.3,1732,14.7
03,20,03,08,5261,100.0,917,17.4,4825,91.7,4344,82.6,481,9.1,436,8.3
03,20,03,09,5484,100.0,1172,21.4,4833,88.1,4312,78.6,521,9.5,651,11.9
03,20,03,10,8088,100.0,1622,20.1,7310,90.4,6466,79.9,844,10.4,778,9.6
03,30,04,11,11764,100.0,3187,27.1,9736,82.8,8577,72.9,1159,9.9,2028,17.2
03,30,04,12,5226,100.0,732,14,4875,93.3,4494,86,381,7.3,351,6.7
03,30,04,13,3195,100.0,358,11.2,3032,94.9,2837,88.8,195,6.1,163,5.1
03,30,05,14,6869,100.0,837,12.2,6379,92.9,6032,87.8,347,5.1,490,7.1
03,30,05,15,49,100.0,6,12.2,43,87.8,43,87.8,0,0,6,12.2
03,30,05,16,9560,100.0,3255,34,7168,75,6305,66,863,9,2392,25
03,30,05,17,1088,100.0,59,5.4,1060,97.4,1029,94.6,31,2.8,28,2.6
03,40,06,18,4783,100.0,1175,24.6,4347,90.9,3608,75.4,739,15.5,436,9.1
03,40,06,19,10596,100.0,2556,24.1,9248,87.3,8040,75.9,1208,11.4,1348,12.7
03,40,06,20,3506,100.0,830,23.7,3069,87.5,2676,76.3,393,11.2,437,12.5
03,40,07,21,11895,100.0,3152,26.5,10099,84.9,8743,73.5,1356,11.4,1796,15.1
03,40,07,22,3807,100.0,900,23.6,3281,86.2,2907,76.4,374,9.8,526,13.8
03,40,07,23,7507,100.0,2164,28.8,6223,82.9,5343,71.2,880,11.7,1284,17.1
03,40,07,24,8494,100.0,1861,21.9,7403,87.2,6633,78.1,770,9.1,1091,12.8
03,40,07,25,7645,100.0,1310,17.1,6929,90.6,6335,82.9,594,7.8,716,9.4
03,40,08,26,7222,100.0,1924,26.6,5850,81,5298,73.4,552,7.6,1372,19
03,40,08,27,9703,100.0,2793,28.8,7924,81.7,6910,71.2,1014,10.5,1779,18.3
03,40,08,28,4934,100.0,1530,31,3865,78.3,3404,69,461,9.3,1069,21.7
03,40,08,29,5968,100.0,1571,26.3,4895,82,4397,73.7,498,8.3,1073,18
03,40,08,30,9293,100.0,2025,21.8,8008,86.2,7268,78.2,740,8,1285,13.8
03,40,08,31,0,0.0,0,–,0,–,0,–,0,–,0,–
03,50,09,32,6659,100.0,2295,34.5,4811,72.2,4364,65.5,447,6.7,1848,27.8
03,50,09,33,7686,100.0,1824,23.7,6488,84.4,5862,76.3,626,8.1,1198,15.6
03,50,09,34,10363,100.0,3480,33.6,8012,77.3,6883,66.4,1129,10.9,2351,22.7
03,50,09,35,6799,100.0,2165,31.8,5330,78.4,4634,68.2,696,10.2,1469,21.6
03,50,09,36,10052,100.0,2717,27,8291,82.5,7335,73,956,9.5,1761,17.5
03,50,10,37,8487,100.0,2144,25.3,6962,82,6343,74.7,619,7.3,1525,18
03,50,10,38,7506,100.0,1630,21.7,6396,85.2,5876,78.3,520,6.9,1110,14.8
03,60,11,39,4040,100.0,1697,42,2889,71.5,2343,58,546,13.5,1151,28.5
03,60,11,40,6016,100.0,2248,37.4,4466,74.2,3768,62.6,698,11.6,1550,25.8
03,60,11,41,7057,100.0,2841,40.3,5090,72.1,4216,59.7,874,12.4,1967,27.9
03,60,11,42,10860,100.0,4343,40,7917,72.9,6517,60,1400,12.9,2943,27.1
03,60,12,43,6990,100.0,2339,33.5,5514,78.9,4651,66.5,863,12.3,1476,21.1
03,60,12,44,7614,100.0,2388,31.4,6077,79.8,5226,68.6,851,11.2,1537,20.2
03,60,12,45,13511,100.0,4759,35.2,10289,76.2,8752,64.8,1537,11.4,3222,23.8
03,60,13,46,5888,100.0,2318,39.4,4319,73.4,3570,60.6,749,12.7,1569,26.6
03,60,13,47,9495,100.0,3371,35.5,7346,77.4,6124,64.5,1222,12.9,2149,22.6
03,60,13,48,7470,100.0,2739,36.7,5704,76.4,4731,63.3,973,13,1766,23.6
03,60,14,49,9928,100.0,2478,25,8359,84.2,7450,75,909,9.2,1569,15.8
03,60,14,50,5449,100.0,3417,62.7,2404,44.1,2032,37.3,372,6.8,3045,55.9
03,60,14,51,6527,100.0,2384,36.5,4875,74.7,4143,63.5,732,11.2,1652,25.3
03,60,14,52,4746,100.0,2092,44.1,3291,69.3,2654,55.9,637,13.4,1455,30.7
03,60,14,53,3391,100.0,1325,39.1,2579,76.1,2066,60.9,513,15.1,812,23.9
03,70,15,54,11453,100.0,4843,42.3,8246,72,6610,57.7,1636,14.3,3207,28
03,70,15,55,7258,100.0,2654,36.6,5553,76.5,4604,63.4,949,13.1,1705,23.5
03,70,15,56,8598,100.0,3638,42.3,6184,71.9,4960,57.7,1224,14.2,2414,28.1
03,70,16,57,3215,100.0,1144,35.6,2492,77.5,2071,64.4,421,13.1,723,22.5
03,70,16,58,8285,100.0,3038,36.7,6304,76.1,5247,63.3,1057,12.8,1981,23.9
03,70,16,59,9477,100.0,3818,40.3,6972,73.6,5659,59.7,1313,13.9,2505,26.4
03,70,16,60,12614,100.0,3965,31.4,10191,80.8,8649,68.6,1542,12.2,2423,19.2
04,10,01,01,11768,100.0,6552,55.7,7711,65.5,5216,44.3,2495,21.2,4057,34.5
04,10,01,02,7878,100.0,4770,60.5,5459,69.3,3108,39.5,2351,29.8,2419,30.7
04,20,02,03,1456,100.0,421,28.9,1216,83.5,1035,71.1,181,12.4,240,16.5
04,20,02,04,3325,100.0,1461,43.9,2286,68.8,1864,56.1,422,12.7,1039,31.2
04,20,02,05,2522,100.0,865,34.3,2004,79.5,1657,65.7,347,13.8,518,20.5
04,20,02,06,2848,100.0,893,31.4,2396,84.1,1955,68.6,441,15.5,452,15.9
04,20,02,07,2996,100.0,1134,37.9,2189,73.1,1862,62.1,327,10.9,807,26.9
04,20,03,08,6113,100.0,2320,38,4684,76.6,3793,62,891,14.6,1429,23.4
04,20,03,09,6895,100.0,2210,32.1,5746,83.3,4685,67.9,1061,15.4,1149,16.7
04,20,03,10,7533,100.0,2922,38.8,5951,79,4611,61.2,1340,17.8,1582,21
04,20,03,11,7424,100.0,3242,43.7,5496,74,4182,56.3,1314,17.7,1928,26
04,30,04,12,4539,100.0,2753,60.7,2522,55.6,1786,39.3,736,16.2,2017,44.4
04,30,04,13,9973,100.0,4932,49.5,7463,74.8,5041,50.5,2422,24.3,2510,25.2
04,30,04,14,10581,100.0,4380,41.4,8075,76.3,6201,58.6,1874,17.7,2506,23.7
04,30,04,15,6258,100.0,2581,41.2,4774,76.3,3677,58.8,1097,17.5,1484,23.7
04,30,04,16,11646,100.0,5032,43.2,8716,74.8,6614,56.8,2102,18,2930,25.2
04,30,05,17,9468,100.0,4788,50.6,6534,69,4680,49.4,1854,19.6,2934,31
04,30,05,18,6682,100.0,3766,56.4,4182,62.6,2916,43.6,1266,18.9,2500,37.4
04,30,06,19,9007,100.0,4428,49.2,6431,71.4,4579,50.8,1852,20.6,2576,28.6
04,30,06,20,4118,100.0,2680,65.1,2456,59.6,1438,34.9,1018,24.7,1662,40.4
04,30,06,21,10941,100.0,5644,51.6,7664,70,5297,48.4,2367,21.6,3277,30
04,30,06,22,5269,100.0,3209,60.9,3482,66.1,2060,39.1,1422,27,1787,33.9
04,30,06,23,12187,100.0,7080,58.1,7657,62.8,5107,41.9,2550,20.9,4530,37.2
04,30,06,24,9314,100.0,4390,47.1,6608,70.9,4924,52.9,1684,18.1,2706,29.1
04,40,07,25,61,100.0,35,57.4,33,54.1,26,42.6,7,11.5,28,45.9
04,40,07,26,5417,100.0,2511,46.4,4072,75.2,2906,53.6,1166,21.5,1345,24.8
04,40,07,27,8322,100.0,3700,44.5,6271,75.4,4622,55.5,1649,19.8,2051,24.6
04,40,07,28,3189,100.0,1368,42.9,2469,77.4,1821,57.1,648,20.3,720,22.6
04,40,07,29,2840,100.0,1186,41.8,2244,79,1654,58.2,590,20.8,596,21
04,40,08,30,8457,100.0,4179,49.4,5993,70.9,4278,50.6,1715,20.3,2464,29.1
04,40,08,31,1543,100.0,516,33.4,1295,83.9,1027,66.6,268,17.4,248,16.1
04,40,08,32,6998,100.0,2047,29.3,5884,84.1,4951,70.7,933,13.3,1114,15.9
04,40,08,33,3901,100.0,1550,39.7,3134,80.3,2351,60.3,783,20.1,767,19.7
04,40,08,34,3384,100.0,1184,35,2769,81.8,2200,65,569,16.8,615,18.2
04,40,08,35,10164,100.0,3000,29.5,8564,84.3,7164,70.5,1400,13.8,1600,15.7
04,50,09,36,5621,100.0,2701,48.1,4012,71.4,2920,51.9,1092,19.4,1609,28.6
04,50,09,37,7653,100.0,3500,45.7,5576,72.9,4153,54.3,1423,18.6,2077,27.1
04,50,09,38,8281,100.0,4113,49.7,5898,71.2,4168,50.3,1730,20.9,2383,28.8
04,50,09,39,6761,100.0,3554,52.6,4772,70.6,3207,47.4,1565,23.1,1989,29.4
04,50,10,40,5895,100.0,2770,47,4376,74.2,3125,53,1251,21.2,1519,25.8
04,50,10,41,5420,100.0,2608,48.1,3884,71.7,2812,51.9,1072,19.8,1536,28.3
04,50,10,42,3664,100.0,2192,59.8,2299,62.7,1472,40.2,827,22.6,1365,37.3
04,50,10,43,10999,100.0,5323,48.4,7903,71.9,5676,51.6,2227,20.2,3096,28.1
04,50,10,44,5328,100.0,2421,45.4,3890,73,2907,54.6,983,18.4,1438,27
04,50,10,45,9363,100.0,4897,52.3,6294,67.2,4466,47.7,1828,19.5,3069,32.8
04,50,11,46,4744,100.0,2317,48.8,3328,70.2,2427,51.2,901,19,1416,29.8
04,50,11,47,5452,100.0,2420,44.4,4135,75.8,3032,55.6,1103,20.2,1317,24.2
04,50,11,48,4564,100.0,2267,49.7,3218,70.5,2297,50.3,921,20.2,1346,29.5
04,50,11,49,9878,100.0,4310,43.6,7369,74.6,5568,56.4,1801,18.2,2509,25.4
04,50,11,50,3016,100.0,1252,41.5,2261,75,1764,58.5,497,16.5,755,25
04,50,11,51,7420,100.0,2687,36.2,5944,80.1,4733,63.8,1211,16.3,1476,19.9
04,50,11,52,6861,100.0,3185,46.4,4998,72.8,3676,53.6,1322,19.3,1863,27.2
04,50,11,53,7563,100.0,3718,49.2,5407,71.5,3845,50.8,1562,20.7,2156,28.5
05,10,01,01,4504,100.0,1254,27.8,3929,87.2,3250,72.2,679,15.1,575,12.8
05,10,01,02,4377,100.0,1338,30.6,3581,81.8,3039,69.4,542,12.4,796,18.2
05,10,01,03,6107,100.0,3289,53.9,4115,67.4,2818,46.1,1297,21.2,1992,32.6
05,10,01,04,6960,100.0,3759,54,4594,66,3201,46,1393,20,2366,34
05,10,01,05,7689,100.0,1883,24.5,6777,88.1,5806,75.5,971,12.6,912,11.9
05,10,02,06,3623,100.0,1723,47.6,2608,72,1900,52.4,708,19.5,1015,28
05,10,02,07,2331,100.0,724,31.1,2057,88.2,1607,68.9,450,19.3,274,11.8
05,10,02,08,11137,100.0,5891,52.9,7690,69,5246,47.1,2444,21.9,3447,31
05,10,02,09,11935,100.0,6953,58.3,8329,69.8,4982,41.7,3347,28,3606,30.2
05,10,02,10,7911,100.0,3614,45.7,5493,69.4,4297,54.3,1196,15.1,2418,30.6
05,10,02,11,6210,100.0,2523,40.6,4899,78.9,3687,59.4,1212,19.5,1311,21.1
05,10,03,12,4007,100.0,1880,46.9,2759,68.9,2127,53.1,632,15.8,1248,31.1
05,10,03,13,7231,100.0,4361,60.3,4561,63.1,2870,39.7,1691,23.4,2670,36.9
05,10,03,14,7493,100.0,4879,65.1,3934,52.5,2614,34.9,1320,17.6,3559,47.5
05,10,03,15,7334,100.0,3867,52.7,4688,63.9,3467,47.3,1221,16.6,2646,36.1
05,10,03,16,10505,100.0,5031,47.9,7489,71.3,5474,52.1,2015,19.2,3016,28.7
05,10,03,17,4458,100.0,2779,62.3,2141,48,1679,37.7,462,10.4,2317,52
05,20,04,18,3847,100.0,979,25.4,3533,91.8,2868,74.6,665,17.3,314,8.2
05,20,04,19,1632,100.0,97,5.9,1601,98.1,1535,94.1,66,4,31,1.9
05,20,04,20,5910,100.0,2193,37.1,4828,81.7,3717,62.9,1111,18.8,1082,18.3
05,20,04,21,4360,100.0,1536,35.2,3379,77.5,2824,64.8,555,12.7,981,22.5
05,20,04,22,1201,100.0,370,30.8,992,82.6,831,69.2,161,13.4,209,17.4
05,20,04,23,6809,100.0,2798,41.1,5124,75.3,4011,58.9,1113,16.3,1685,24.7
05,20,05,24,3380,100.0,1073,31.7,2919,86.4,2307,68.3,612,18.1,461,13.6
05,20,05,25,2464,100.0,787,31.9,2153,87.4,1677,68.1,476,19.3,311,12.6
05,20,05,26,5806,100.0,3679,63.4,3290,56.7,2127,36.6,1163,20,2516,43.3
05,20,05,27,12030,100.0,8153,67.8,7165,59.6,3877,32.2,3288,27.3,4865,40.4
05,20,05,28,7291,100.0,2496,34.2,5936,81.4,4795,65.8,1141,15.6,1355,18.6
05,20,06,29,8357,100.0,3934,47.1,5832,69.8,4423,52.9,1409,16.9,2525,30.2
05,20,06,30,10042,100.0,4391,43.7,7193,71.6,5651,56.3,1542,15.4,2849,28.4
05,20,06,31,8679,100.0,4007,46.2,6056,69.8,4672,53.8,1384,15.9,2623,30.2
05,20,06,32,3655,100.0,1896,51.9,2459,67.3,1759,48.1,700,19.2,1196,32.7
05,20,06,33,2159,100.0,765,35.4,1759,81.5,1394,64.6,365,16.9,400,18.5
05,20,06,34,4319,100.0,886,20.5,3854,89.2,3433,79.5,421,9.7,465,10.8
05,30,07,35,4520,100.0,2978,65.9,3155,69.8,1542,34.1,1613,35.7,1365,30.2
05,30,07,36,3575,100.0,2031,56.8,2720,76.1,1544,43.2,1176,32.9,855,23.9
05,30,07,37,11913,100.0,6088,51.1,8668,72.8,5825,48.9,2843,23.9,3245,27.2
05,30,08,38,16,100.0,3,18.8,13,81.3,13,81.3,0,0,3,18.8
05,30,08,39,8314,100.0,4551,54.7,5713,68.7,3763,45.3,1950,23.5,2601,31.3
05,30,08,40,503,100.0,273,54.3,337,67,230,45.7,107,21.3,166,33
05,30,08,41,4605,100.0,2380,51.7,3198,69.4,2225,48.3,973,21.1,1407,30.6
05,40,09,42,3691,100.0,852,23.1,3316,89.8,2839,76.9,477,12.9,375,10.2
05,40,09,43,10533,100.0,2363,22.4,9673,91.8,8170,77.6,1503,14.3,860,8.2
05,40,09,44,2183,100.0,436,20,1992,91.3,1747,80,245,11.2,191,8.7
05,40,09,45,3671,100.0,677,18.4,3412,92.9,2994,81.6,418,11.4,259,7.1
06,10,01,01,6912,100.0,2103,30.4,5841,84.5,4809,69.6,1032,14.9,1071,15.5
06,10,01,02,9048,100.0,3782,41.8,6854,75.8,5266,58.2,1588,17.6,2194,24.2
06,10,01,03,6186,100.0,2163,35,5147,83.2,4023,65,1124,18.2,1039,16.8
06,10,02,04,6803,100.0,2663,39.1,5420,79.7,4140,60.9,1280,18.8,1383,20.3
06,10,02,05,9988,100.0,3815,38.2,7962,79.7,6173,61.8,1789,17.9,2026,20.3
06,10,02,06,7751,100.0,2761,35.6,6232,80.4,4990,64.4,1242,16,1519,19.6
06,10,02,07,8168,100.0,3201,39.2,6385,78.2,4967,60.8,1418,17.4,1783,21.8
06,10,02,08,7065,100.0,2468,34.9,5775,81.7,4597,65.1,1178,16.7,1290,18.3
06,10,02,09,9322,100.0,3798,40.7,7255,77.8,5524,59.3,1731,18.6,2067,22.2
06,10,02,10,5004,100.0,1709,34.2,4072,81.4,3295,65.8,777,15.5,932,18.6
06,20,03,11,4873,100.0,1386,28.4,4194,86.1,3487,71.6,707,14.5,679,13.9
06,20,03,12,6285,100.0,2270,36.1,4923,78.3,4015,63.9,908,14.4,1362,21.7
06,20,03,13,7395,100.0,2775,37.5,5880,79.5,4620,62.5,1260,17,1515,20.5
06,20,03,14,7210,100.0,2567,35.6,5818,80.7,4643,64.4,1175,16.3,1392,19.3
06,20,03,15,6890,100.0,2613,37.9,5553,80.6,4277,62.1,1276,18.5,1337,19.4
06,20,03,16,5788,100.0,2707,46.8,4219,72.9,3081,53.2,1138,19.7,1569,27.1
06,20,03,17,6257,100.0,1486,23.7,5580,89.2,4771,76.3,809,12.9,677,10.8
06,20,04,18,0,100.0,0,–,0,–,0,–,0,–,0,–
06,20,04,19,4539,100.0,2553,56.2,3170,69.8,1986,43.8,1184,26.1,1369,30.2
06,20,04,20,7403,100.0,2533,34.2,5933,80.1,4870,65.8,1063,14.4,1470,19.9
06,20,04,21,8417,100.0,2683,31.9,6861,81.5,5734,68.1,1127,13.4,1556,18.5
06,20,04,22,7009,100.0,1777,25.4,5982,85.3,5232,74.6,750,10.7,1027,14.7
06,20,04,23,8606,100.0,2751,32,7289,84.7,5855,68,1434,16.7,1317,15.3
06,30,05,24,5624,100.0,1573,28,4753,84.5,4051,72,702,12.5,871,15.5
06,30,05,25,5820,100.0,1790,30.8,4776,82.1,4030,69.2,746,12.8,1044,17.9
06,30,05,26,3350,100.0,1151,34.4,2717,81.1,2199,65.6,518,15.5,633,18.9
06,30,05,27,8541,100.0,2754,32.2,7171,84,5787,67.8,1384,16.2,1370,16
06,30,05,28,10947,100.0,3007,27.5,9446,86.3,7940,72.5,1506,13.8,1501,13.7
06,30,06,29,6988,100.0,2158,30.9,5843,83.6,4830,69.1,1013,14.5,1145,16.4
06,30,06,30,5667,100.0,2493,44,4039,71.3,3174,56,865,15.3,1628,28.7
06,30,06,31,2881,100.0,1089,37.8,2188,75.9,1792,62.2,396,13.7,693,24.1
06,30,06,32,13695,100.0,4393,32.1,11632,84.9,9302,67.9,2330,17,2063,15.1
06,30,06,33,11955,100.0,3526,29.5,10035,83.9,8429,70.5,1606,13.4,1920,16.1
06,30,06,34,8285,100.0,2195,26.5,7117,85.9,6090,73.5,1027,12.4,1168,14.1
06,40,07,35,10188,100.0,2635,25.9,8716,85.6,7553,74.1,1163,11.4,1472,14.4
06,40,07,36,5139,100.0,1225,23.8,4628,90.1,3914,76.2,714,13.9,511,9.9
06,40,07,37,11337,100.0,3975,35.1,8622,76.1,7362,64.9,1260,11.1,2715,23.9
06,40,08,38,7341,100.0,1521,20.7,6630,90.3,5820,79.3,810,11,711,9.7
06,40,08,39,5370,100.0,1354,25.2,4700,87.5,4016,74.8,684,12.7,670,12.5
06,40,08,40,7080,100.0,1394,19.7,6408,90.5,5686,80.3,722,10.2,672,9.5
06,40,08,41,6191,100.0,1930,31.2,5120,82.7,4261,68.8,859,13.9,1071,17.3
06,40,08,42,4773,100.0,1889,39.6,4017,84.2,2884,60.4,1133,23.7,756,15.8
06,40,08,43,4690,100.0,1479,31.5,3900,83.2,3211,68.5,689,14.7,790,16.8
06,40,08,44,7263,100.0,2623,36.1,5903,81.3,4640,63.9,1263,17.4,1360,18.7
07,10,01,01,9794,100.0,5026,51.3,6904,70.5,4768,48.7,2136,21.8,2890,29.5
07,10,01,02,8696,100.0,4746,54.6,5603,64.4,3950,45.4,1653,19,3093,35.6
07,10,01,03,7897,100.0,5223,66.1,4895,62,2674,33.9,2221,28.1,3002,38
07,10,02,04,10425,100.0,4436,42.6,7721,74.1,5989,57.4,1732,16.6,2704,25.9
07,10,02,05,5177,100.0,3498,67.6,3180,61.4,1679,32.4,1501,29,1997,38.6
07,10,02,06,8355,100.0,4330,51.8,5842,69.9,4025,48.2,1817,21.7,2513,30.1
07,20,03,07,10549,100.0,4195,39.8,8298,78.7,6354,60.2,1944,18.4,2251,21.3
07,20,03,08,10698,100.0,5246,49,7518,70.3,5452,51,2066,19.3,3180,29.7
07,20,04,09,9300,100.0,3618,38.9,7286,78.3,5682,61.1,1604,17.2,2014,21.7
07,20,04,10,5538,100.0,3074,55.5,3855,69.6,2464,44.5,1391,25.1,1683,30.4
07,20,04,11,2741,100.0,1269,46.3,2014,73.5,1472,53.7,542,19.8,727,26.5
07,20,04,12,2611,100.0,1609,61.6,1644,63,1002,38.4,642,24.6,967,37
07,20,04,13,7708,100.0,2897,37.6,6032,78.3,4811,62.4,1221,15.8,1676,21.7
07,20,04,14,3778,100.0,1599,42.3,2908,77,2179,57.7,729,19.3,870,23
07,30,05,15,6961,100.0,2071,29.8,5914,85,4890,70.2,1024,14.7,1047,15
07,30,05,16,8896,100.0,2919,32.8,7273,81.8,5977,67.2,1296,14.6,1623,18.2
07,30,05,17,10082,100.0,3879,38.5,7863,78,6203,61.5,1660,16.5,2219,22
07,30,06,18,9243,100.0,3336,36.1,7465,80.8,5907,63.9,1558,16.9,1778,19.2
07,30,06,19,12219,100.0,5835,47.8,9140,74.8,6384,52.2,2756,22.6,3079,25.2
07,40,07,20,11668,100.0,5181,44.4,9149,78.4,6487,55.6,2662,22.8,2519,21.6
07,40,07,21,7639,100.0,4090,53.5,4540,59.4,3549,46.5,991,13,3099,40.6
07,40,08,22,3291,100.0,1369,41.6,2436,74,1922,58.4,514,15.6,855,26
07,40,08,23,9690,100.0,3869,39.9,7714,79.6,5821,60.1,1893,19.5,1976,20.4
07,40,08,24,7387,100.0,3204,43.4,5579,75.5,4183,56.6,1396,18.9,1808,24.5
07,40,08,25,7213,100.0,3313,45.9,5364,74.4,3900,54.1,1464,20.3,1849,25.6
07,40,08,26,5110,100.0,1660,32.5,4281,83.8,3450,67.5,831,16.3,829,16.2
07,40,09,27,11415,100.0,5744,50.3,8060,70.6,5671,49.7,2389,20.9,3355,29.4
07,40,09,28,3965,100.0,2449,61.8,2388,60.2,1516,38.2,872,22,1577,39.8
07,50,10,29,8544,100.0,4063,47.6,6359,74.4,4481,52.4,1878,22,2185,25.6
07,50,10,30,8753,100.0,3988,45.6,6651,76,4765,54.4,1886,21.5,2102,24
07,50,10,31,9124,100.0,3467,38,7406,81.2,5657,62,1749,19.2,1718,18.8
07,50,10,32,6284,100.0,2596,41.3,5082,80.9,3688,58.7,1394,22.2,1202,19.1
07,50,11,33,8254,100.0,3788,45.9,5997,72.7,4466,54.1,1531,18.5,2257,27.3
07,50,11,34,10548,100.0,3610,34.2,8871,84.1,6938,65.8,1933,18.3,1677,15.9
07,50,11,35,2257,100.0,688,30.5,1925,85.3,1569,69.5,356,15.8,332,14.7
07,60,12,36,10335,100.0,5017,48.5,7482,72.4,5318,51.5,2164,20.9,2853,27.6
07,60,12,37,4785,100.0,1477,30.9,4088,85.4,3308,69.1,780,16.3,697,14.6
07,60,12,38,2877,100.0,1273,44.2,2327,80.9,1604,55.8,723,25.1,550,19.1
07,60,13,39,5721,100.0,2626,45.9,4644,81.2,3095,54.1,1549,27.1,1077,18.8
07,60,13,40,6416,100.0,2997,46.7,5102,79.5,3419,53.3,1683,26.2,1314,20.5
07,60,13,41,2225,100.0,773,34.7,1819,81.8,1452,65.3,367,16.5,406,18.2
07,60,14,42,10408,100.0,2843,27.3,9067,87.1,7565,72.7,1502,14.4,1341,12.9
07,60,14,43,10849,100.0,2967,27.3,9529,87.8,7882,72.7,1647,15.2,1320,12.2
07,60,15,44,9262,100.0,3511,37.9,7540,81.4,5751,62.1,1789,19.3,1722,18.6
07,60,15,45,8570,100.0,3727,43.5,6578,76.8,4843,56.5,1735,20.2,1992,23.2
07,60,15,46,6977,100.0,1681,24.1,6209,89,5296,75.9,913,13.1,768,11
07,60,15,47,3828,100.0,1012,26.4,3238,84.6,2816,73.6,422,11,590,15.4
07,60,15,48,2896,100.0,642,22.2,2597,89.7,2254,77.8,343,11.8,299,10.3
08,10,01,01,4626,100.0,2685,58,2836,61.3,1941,42,895,19.3,1790,38.7
08,10,01,02,8181,100.0,4539,55.5,5196,63.5,3642,44.5,1554,19,2985,36.5
08,10,01,03,7205,100.0,3724,51.7,4838,67.1,3481,48.3,1357,18.8,2367,32.9
08,10,01,04,6699,100.0,4068,60.7,4115,61.4,2631,39.3,1484,22.2,2584,38.6
08,10,01,05,6338,100.0,4004,63.2,3956,62.4,2334,36.8,1622,25.6,2382,37.6
08,10,02,06,9350,100.0,5570,59.6,5751,61.5,3780,40.4,1971,21.1,3599,38.5
08,10,02,07,7442,100.0,5088,68.4,4775,64.2,2354,31.6,2421,32.5,2667,35.8
08,10,02,08,11955,100.0,6944,58.1,7489,62.6,5011,41.9,2478,20.7,4466,37.4
08,10,02,09,8834,100.0,5407,61.2,5199,58.9,3427,38.8,1772,20.1,3635,41.1
08,10,03,10,7560,100.0,3971,52.5,5131,67.9,3589,47.5,1542,20.4,2429,32.1
08,10,03,11,7076,100.0,3527,49.8,4796,67.8,3549,50.2,1247,17.6,2280,32.2
08,10,03,12,11499,100.0,6162,53.6,7583,65.9,5337,46.4,2246,19.5,3916,34.1
08,10,03,13,3740,100.0,1480,39.6,2932,78.4,2260,60.4,672,18,808,21.6
08,10,03,14,7930,100.0,4893,61.7,4736,59.7,3037,38.3,1699,21.4,3194,40.3
08,10,04,15,6388,100.0,3535,55.3,4123,64.5,2853,44.7,1270,19.9,2265,35.5
08,10,04,16,6577,100.0,3647,55.5,4249,64.6,2930,44.5,1319,20.1,2328,35.4
08,10,04,17,9569,100.0,5416,56.6,6063,63.4,4153,43.4,1910,20,3506,36.6
08,10,04,18,9193,100.0,4525,49.2,6344,69,4668,50.8,1676,18.2,2849,31
08,10,04,19,7192,100.0,4651,64.7,4110,57.1,2541,35.3,1569,21.8,3082,42.9
08,10,05,20,5737,100.0,4418,77,3420,59.6,1319,23,2101,36.6,2317,40.4
08,10,05,21,9457,100.0,6551,69.3,6371,67.4,2906,30.7,3465,36.6,3086,32.6
08,20,06,22,5860,100.0,4214,71.9,3059,52.2,1646,28.1,1413,24.1,2801,47.8
08,20,06,23,6692,100.0,3660,54.7,4368,65.3,3032,45.3,1336,20,2324,34.7
08,20,06,24,8988,100.0,4781,53.2,6394,71.1,4207,46.8,2187,24.3,2594,28.9
08,20,07,25,2524,100.0,921,36.5,2147,85.1,1603,63.5,544,21.6,377,14.9
08,20,07,26,6109,100.0,2033,33.3,5146,84.2,4076,66.7,1070,17.5,963,15.8
08,20,07,27,8115,100.0,2991,36.9,6630,81.7,5124,63.1,1506,18.6,1485,18.3
08,20,07,28,1206,100.0,424,35.2,1014,84.1,782,64.8,232,19.2,192,15.9
08,20,07,29,1869,100.0,737,39.4,1563,83.6,1132,60.6,431,23.1,306,16.4
08,20,07,30,3373,100.0,1276,37.8,2680,79.5,2097,62.2,583,17.3,693,20.5
08,20,08,31,8275,100.0,2739,33.1,7020,84.8,5536,66.9,1484,17.9,1255,15.2
08,20,08,32,12116,100.0,4738,39.1,9955,82.2,7378,60.9,2577,21.3,2161,17.8
08,20,08,33,9255,100.0,5007,54.1,6561,70.9,4248,45.9,2313,25,2694,29.1
08,30,09,34,12623,100.0,7220,57.2,9673,76.6,5403,42.8,4270,33.8,2950,23.4
08,30,09,35,7611,100.0,3935,51.7,5823,76.5,3676,48.3,2147,28.2,1788,23.5
08,30,10,36,7448,100.0,3954,53.1,5813,78,3494,46.9,2319,31.1,1635,22
08,30,10,37,11049,100.0,6805,61.6,8279,74.9,4244,38.4,4035,36.5,2770,25.1
08,40,11,38,2900,100.0,1131,39,2406,83,1769,61,637,22,494,17
08,40,11,39,4092,100.0,1637,40,3321,81.2,2455,60,866,21.2,771,18.8
08,40,11,40,2670,100.0,1078,40.4,2182,81.7,1592,59.6,590,22.1,488,18.3
08,40,12,41,8319,100.0,3559,42.8,6731,80.9,4760,57.2,1971,23.7,1588,19.1
08,40,12,42,6893,100.0,2172,31.5,6003,87.1,4721,68.5,1282,18.6,890,12.9
08,40,12,43,10078,100.0,3620,35.9,8351,82.9,6458,64.1,1893,18.8,1727,17.1
08,40,12,44,7315,100.0,2207,30.2,6506,88.9,5108,69.8,1398,19.1,809,11.1
08,40,12,45,3720,100.0,1288,34.6,3259,87.6,2432,65.4,827,22.2,461,12.4
08,40,12,46,7840,100.0,2466,31.5,6796,86.7,5374,68.5,1422,18.1,1044,13.3
09,10,01,01,13453,100.0,4924,36.6,10508,78.1,8529,63.4,1979,14.7,2945,21.9
09,10,02,02,4280,100.0,1035,24.2,3686,86.1,3245,75.8,441,10.3,594,13.9
09,10,02,03,7473,100.0,2305,30.8,5801,77.6,5168,69.2,633,8.5,1672,22.4
09,10,03,04,12007,100.0,2931,24.4,10191,84.9,9076,75.6,1115,9.3,1816,15.1
09,10,03,05,4338,100.0,1260,29,3521,81.2,3078,71,443,10.2,817,18.8
09,10,03,06,3059,100.0,1050,34.3,2469,80.7,2009,65.7,460,15,590,19.3
09,10,04,07,8670,100.0,1772,20.4,7557,87.2,6898,79.6,659,7.6,1113,12.8
09,10,04,08,8870,100.0,2312,26.1,7405,83.5,6558,73.9,847,9.5,1465,16.5
09,10,04,09,4096,100.0,1226,29.9,3519,85.9,2870,70.1,649,15.8,577,14.1
09,20,05,10,8024,100.0,3438,42.8,5332,66.5,4586,57.2,746,9.3,2692,33.5
09,20,05,11,13207,100.0,4259,32.2,10203,77.3,8948,67.8,1255,9.5,3004,22.7
09,20,05,12,4433,100.0,1797,40.5,3019,68.1,2636,59.5,383,8.6,1414,31.9
09,20,06,13,10704,100.0,4498,42,7256,67.8,6206,58,1050,9.8,3448,32.2
09,20,06,14,3804,100.0,707,18.6,3291,86.5,3097,81.4,194,5.1,513,13.5
09,20,07,15,4259,100.0,2183,51.3,2701,63.4,2076,48.7,625,14.7,1558,36.6
09,20,07,16,8373,100.0,2807,33.5,6182,73.8,5566,66.5,616,7.4,2191,26.2
09,20,07,17,9785,100.0,2734,27.9,7771,79.4,7051,72.1,720,7.4,2014,20.6
09,20,08,18,4330,100.0,1271,29.4,3353,77.4,3059,70.6,294,6.8,977,22.6
09,20,08,19,8588,100.0,2643,30.8,6711,78.1,5945,69.2,766,8.9,1877,21.9
09,30,09,20,13253,100.0,3322,25.1,11542,87.1,9931,74.9,1611,12.2,1711,12.9
09,30,09,21,2878,100.0,587,20.4,2534,88,2291,79.6,243,8.4,344,12
09,30,09,22,6013,100.0,1665,27.7,4922,81.9,4348,72.3,574,9.5,1091,18.1
09,30,09,23,9100,100.0,3071,33.7,7223,79.4,6029,66.3,1194,13.1,1877,20.6
09,30,10,24,3776,100.0,1119,29.6,3112,82.4,2657,70.4,455,12,664,17.6
09,30,10,25,11919,100.0,2869,24.1,10007,84,9050,75.9,957,8,1912,16
09,30,11,26,8376,100.0,1836,21.9,7227,86.3,6540,78.1,687,8.2,1149,13.7
09,30,12,27,1852,100.0,218,11.8,1768,95.5,1634,88.2,134,7.2,84,4.5
09,30,12,28,2635,100.0,383,14.5,2439,92.6,2252,85.5,187,7.1,196,7.4
09,40,13,29,11009,100.0,1539,14,10037,91.2,9470,86,567,5.2,972,8.8
09,40,13,30,1916,100.0,251,13.1,1797,93.8,1665,86.9,132,6.9,119,6.2
09,40,14,31,5992,100.0,1181,19.7,5146,85.9,4811,80.3,335,5.6,846,14.1
09,40,14,32,1572,100.0,343,21.8,1375,87.5,1229,78.2,146,9.3,197,12.5
09,40,14,33,4478,100.0,954,21.3,3791,84.7,3524,78.7,267,6,687,15.3
09,40,15,34,7494,100.0,2094,27.9,6038,80.6,5400,72.1,638,8.5,1456,19.4
09,40,16,35,7059,100.0,782,11.1,6679,94.6,6277,88.9,402,5.7,380,5.4
09,50,17,36,4677,100.0,672,14.4,4233,90.5,4005,85.6,228,4.9,444,9.5
09,50,17,37,14359,100.0,1635,11.4,13446,93.6,12724,88.6,722,5,913,6.4
09,50,18,38,11138,100.0,1872,16.8,10008,89.9,9266,83.2,742,6.7,1130,10.1
09,50,19,39,6829,100.0,1780,26.1,5582,81.7,5049,73.9,533,7.8,1247,18.3
09,50,19,40,2759,100.0,674,24.4,2273,82.4,2085,75.6,188,6.8,486,17.6
09,50,19,41,2937,100.0,645,22,2511,85.5,2292,78,219,7.5,426,14.5
09,50,20,42,4315,100.0,792,18.4,3777,87.5,3523,81.6,254,5.9,538,12.5
09,50,20,43,9147,100.0,1138,12.4,8457,92.5,8009,87.6,448,4.9,690,7.5
10,10,01,01,5837,100.0,2049,35.1,4515,77.4,3788,64.9,727,12.5,1322,22.6
10,10,01,02,3680,100.0,1430,38.9,2649,72,2250,61.1,399,10.8,1031,28
10,10,01,03,8110,100.0,2592,32,6488,80,5518,68,970,12,1622,20
10,10,01,04,7521,100.0,2471,32.9,6278,83.5,5050,67.1,1228,16.3,1243,16.5
10,10,02,05,1221,100.0,884,72.4,404,33.1,337,27.6,67,5.5,817,66.9
10,10,02,06,11809,100.0,3958,33.5,9343,79.1,7851,66.5,1492,12.6,2466,20.9
10,10,02,07,8320,100.0,1878,22.6,7083,85.1,6442,77.4,641,7.7,1237,14.9
10,10,02,08,10330,100.0,3534,34.2,8083,78.2,6796,65.8,1287,12.5,2247,21.8
10,10,02,09,9642,100.0,3637,37.7,7123,73.9,6005,62.3,1118,11.6,2519,26.1
10,10,02,10,10868,100.0,3512,32.3,8890,81.8,7356,67.7,1534,14.1,1978,18.2
10,10,03,11,2670,100.0,1246,46.7,1737,65.1,1424,53.3,313,11.7,933,34.9
10,10,03,12,16216,100.0,5981,36.9,12437,76.7,10235,63.1,2202,13.6,3779,23.3
10,10,03,13,4981,100.0,1906,38.3,3678,73.8,3075,61.7,603,12.1,1303,26.2
10,10,03,14,6455,100.0,1633,25.3,5536,85.8,4822,74.7,714,11.1,919,14.2
10,10,03,15,8228,100.0,2977,36.2,6441,78.3,5251,63.8,1190,14.5,1787,21.7
10,10,03,16,3696,100.0,700,18.9,3373,91.3,2996,81.1,377,10.2,323,8.7
10,20,04,17,8063,100.0,3586,44.5,5630,69.8,4477,55.5,1153,14.3,2433,30.2
10,20,04,18,7367,100.0,2245,30.5,5709,77.5,5122,69.5,587,8,1658,22.5
10,20,04,19,4357,100.0,2034,46.7,2896,66.5,2323,53.3,573,13.2,1461,33.5
10,20,04,20,9010,100.0,3877,43,5868,65.1,5133,57,735,8.2,3142,34.9
10,20,04,21,1757,100.0,875,49.8,1222,69.6,882,50.2,340,19.4,535,30.4
10,20,04,22,7368,100.0,3668,49.8,4401,59.7,3700,50.2,701,9.5,2967,40.3
10,20,04,23,6138,100.0,2600,42.4,4223,68.8,3538,57.6,685,11.2,1915,31.2
10,20,05,24,11814,100.0,3889,32.9,8919,75.5,7925,67.1,994,8.4,2895,24.5
10,20,05,25,5380,100.0,1932,35.9,3902,72.5,3448,64.1,454,8.4,1478,27.5
10,20,05,26,6241,100.0,2649,42.4,4237,67.9,3592,57.6,645,10.3,2004,32.1
10,20,06,27,3689,100.0,1078,29.2,2993,81.1,2611,70.8,382,10.4,696,18.9
10,20,06,28,6514,100.0,2107,32.3,4997,76.7,4407,67.7,590,9.1,1517,23.3
10,20,06,29,9187,100.0,2219,24.2,7802,84.9,6968,75.8,834,9.1,1385,15.1
10,20,06,30,6627,100.0,1334,20.1,5814,87.7,5293,79.9,521,7.9,813,12.3
10,30,07,31,7926,100.0,1844,23.3,6744,85.1,6082,76.7,662,8.4,1182,14.9
10,30,07,32,7237,100.0,2047,28.3,5923,81.8,5190,71.7,733,10.1,1314,18.2
10,30,07,33,5190,100.0,1637,31.5,4152,80,3553,68.5,599,11.5,1038,20
10,30,07,34,10606,100.0,1733,16.3,9776,92.2,8873,83.7,903,8.5,830,7.8
10,40,08,35,7832,100.0,936,12,7373,94.1,6896,88,477,6.1,459,5.9
10,40,08,36,3981,100.0,592,14.9,3611,90.7,3389,85.1,222,5.6,370,9.3
10,40,08,37,7870,100.0,826,10.5,7524,95.6,7044,89.5,480,6.1,346,4.4
10,40,09,38,10234,100.0,1200,11.7,9650,94.3,9034,88.3,616,6,584,5.7
10,40,09,39,4529,100.0,704,15.5,4149,91.6,3825,84.5,324,7.2,380,8.4
10,40,09,40,5847,100.0,538,9.2,5590,95.6,5309,90.8,281,4.8,257,4.4
10,40,09,41,9743,100.0,1046,10.7,9285,95.3,8697,89.3,588,6,458,4.7
11,10,01,01,3356,100.0,444,13.2,3127,93.2,2912,86.8,215,6.4,229,6.8
11,10,01,02,3095,100.0,1341,43.3,2107,68.1,1754,56.7,353,11.4,988,31.9
11,10,02,03,9394,100.0,3830,40.8,6857,73,5564,59.2,1293,13.8,2537,27
11,10,02,04,7463,100.0,3029,40.6,5419,72.6,4434,59.4,985,13.2,2044,27.4
11,10,02,05,6304,100.0,2468,39.1,4552,72.2,3836,60.9,716,11.4,1752,27.8
11,10,02,06,7807,100.0,2959,37.9,5659,72.5,4848,62.1,811,10.4,2148,27.5
11,10,03,07,11702,100.0,4133,35.3,9203,78.6,7569,64.7,1634,14,2499,21.4
11,10,03,08,9886,100.0,3756,38,7325,74.1,6130,62,1195,12.1,2561,25.9
11,10,03,09,6569,100.0,2149,32.7,5013,76.3,4420,67.3,593,9,1556,23.7
11,20,04,10,10413,100.0,3895,37.4,7540,72.4,6518,62.6,1022,9.8,2873,27.6
11,20,04,11,6917,100.0,2108,30.5,5491,79.4,4809,69.5,682,9.9,1426,20.6
11,20,05,12,3999,100.0,979,24.5,3259,81.5,3020,75.5,239,6,740,18.5
11,20,05,13,10466,100.0,3662,35,7732,73.9,6804,65,928,8.9,2734,26.1
11,20,05,14,16289,100.0,6259,38.4,12033,73.9,10030,61.6,2003,12.3,4256,26.1
11,20,05,15,5002,100.0,1803,36,3800,76,3199,64,601,12,1202,24
11,30,06,16,5992,100.0,2487,41.5,4500,75.1,3505,58.5,995,16.6,1492,24.9
11,30,06,17,4407,100.0,1536,34.9,3506,79.6,2871,65.1,635,14.4,901,20.4
11,30,06,18,3850,100.0,1440,37.4,2822,73.3,2410,62.6,412,10.7,1028,26.7
11,30,06,19,8889,100.0,3731,42,6228,70.1,5158,58,1070,12,2661,29.9
11,30,06,20,11346,100.0,4549,40.1,8416,74.2,6797,59.9,1619,14.3,2930,25.8
11,30,07,21,6848,100.0,4830,70.5,2550,37.2,2018,29.5,532,7.8,4298,62.8
11,30,07,22,10326,100.0,3290,31.9,8352,80.9,7036,68.1,1316,12.7,1974,19.1
11,30,07,23,2581,100.0,1784,69.1,1011,39.2,797,30.9,214,8.3,1570,60.8
11,30,07,24,4372,100.0,1550,35.5,3311,75.7,2822,64.5,489,11.2,1061,24.3
11,30,07,25,10202,100.0,3053,29.9,8105,79.4,7149,70.1,956,9.4,2097,20.6
11,30,08,26,10508,100.0,4712,44.8,7492,71.3,5796,55.2,1696,16.1,3016,28.7
11,40,09,27,4173,100.0,1178,28.2,3442,82.5,2995,71.8,447,10.7,731,17.5
11,40,09,28,2933,100.0,1324,45.1,1892,64.5,1609,54.9,283,9.6,1041,35.5
11,40,09,29,16901,100.0,5844,34.6,12634,74.8,11057,65.4,1577,9.3,4267,25.2
11,40,09,30,4760,100.0,1123,23.6,4062,85.3,3637,76.4,425,8.9,698,14.7
11,40,09,31,7064,100.0,2272,32.2,5547,78.5,4792,67.8,755,10.7,1517,21.5
11,40,10,32,6292,100.0,2676,42.5,4387,69.7,3616,57.5,771,12.3,1905,30.3
11,40,10,33,6890,100.0,3069,44.5,4926,71.5,3821,55.5,1105,16,1964,28.5
11,40,10,34,3379,100.0,1318,39,2448,72.4,2061,61,387,11.5,931,27.6
11,40,11,35,11011,100.0,4263,38.7,8288,75.3,6748,61.3,1540,14,2723,24.7
11,40,11,36,8336,100.0,2645,31.7,6339,76,5691,68.3,648,7.8,1997,24
11,40,11,37,9004,100.0,3695,41,6585,73.1,5309,59,1276,14.2,2419,26.9
11,50,12,38,4899,100.0,1580,32.3,3979,81.2,3319,67.7,660,13.5,920,18.8
11,50,13,39,10574,100.0,3119,29.5,8423,79.7,7455,70.5,968,9.2,2151,20.3
11,50,13,40,11246,100.0,2295,20.4,9828,87.4,8951,79.6,877,7.8,1418,12.6
11,50,13,41,10103,100.0,3433,34,7656,75.8,6670,66,986,9.8,2447,24.2
12,10,01,01,11188,100.0,6735,60.2,7119,63.6,4453,39.8,2666,23.8,4069,36.4
12,10,01,02,9980,100.0,5515,55.3,6528,65.4,4465,44.7,2063,20.7,3452,34.6
12,10,01,03,7592,100.0,3812,50.2,5405,71.2,3780,49.8,1625,21.4,2187,28.8
12,10,02,04,9554,100.0,5258,55,6312,66.1,4296,45,2016,21.1,3242,33.9
12,10,02,05,13988,100.0,7291,52.1,9638,68.9,6697,47.9,2941,21,4350,31.1
12,10,02,06,4780,100.0,1960,41,3666,76.7,2820,59,846,17.7,1114,23.3
12,20,03,07,2804,100.0,1347,48,1916,68.3,1457,52,459,16.4,888,31.7
12,20,03,08,5868,100.0,2963,50.5,4178,71.2,2905,49.5,1273,21.7,1690,28.8
12,20,03,09,11286,100.0,6776,60,6858,60.8,4510,40,2348,20.8,4428,39.2
12,20,03,10,8284,100.0,5286,63.8,5016,60.6,2998,36.2,2018,24.4,3268,39.4
12,20,04,11,294,100.0,203,69,179,60.9,91,31,88,29.9,115,39.1
12,20,04,12,6518,100.0,2647,40.6,5007,76.8,3871,59.4,1136,17.4,1511,23.2
12,20,04,13,8103,100.0,3769,46.5,6033,74.5,4334,53.5,1699,21,2070,25.5
12,20,04,14,5440,100.0,4461,82,1193,21.9,979,18,214,3.9,4247,78.1
12,20,05,15,11322,100.0,3432,30.3,9258,81.8,7890,69.7,1368,12.1,2064,18.2
12,40,06,16,6113,100.0,1181,19.3,5534,90.5,4932,80.7,602,9.8,579,9.5
12,40,06,17,6704,100.0,1053,15.7,6274,93.6,5651,84.3,623,9.3,430,6.4
12,40,06,18,3789,100.0,741,19.6,3465,91.4,3048,80.4,417,11,324,8.6
12,40,06,19,7726,100.0,1355,17.5,7094,91.8,6371,82.5,723,9.4,632,8.2
12,40,07,20,8480,100.0,1321,15.6,7925,93.5,7159,84.4,766,9,555,6.5
12,40,07,21,7891,100.0,1356,17.2,7259,92,6535,82.8,724,9.2,632,8
12,40,07,22,8517,100.0,1636,19.2,7655,89.9,6881,80.8,774,9.1,862,10.1
12,40,07,23,8090,100.0,1559,19.3,7324,90.5,6531,80.7,793,9.8,766,9.5
12,50,08,24,9681,100.0,2018,20.8,8656,89.4,7663,79.2,993,10.3,1025,10.6
12,50,08,25,7079,100.0,2563,36.2,5309,75,4516,63.8,793,11.2,1770,25
12,50,09,26,5181,100.0,1788,34.5,4135,79.8,3393,65.5,742,14.3,1046,20.2
12,50,09,27,6874,100.0,2139,31.1,5795,84.3,4735,68.9,1060,15.4,1079,15.7
12,50,09,28,5158,100.0,1266,24.5,4490,87,3892,75.5,598,11.6,668,13
12,50,09,29,5104,100.0,1040,20.4,4713,92.3,4064,79.6,649,12.7,391,7.7
12,50,09,30,9873,100.0,3857,39.1,7497,75.9,6016,60.9,1481,15,2376,24.1
12,60,10,31,3333,100.0,1189,35.7,2745,82.4,2144,64.3,601,18,588,17.6
12,60,10,32,6250,100.0,3626,58,4030,64.5,2624,42,1406,22.5,2220,35.5
12,60,11,33,11448,100.0,6280,54.9,8329,72.8,5168,45.1,3161,27.6,3119,27.2
12,60,11,34,16006,100.0,8249,51.5,11749,73.4,7757,48.5,3992,24.9,4257,26.6
12,60,12,35,10610,100.0,6471,61,7285,68.7,4139,39,3146,29.7,3325,31.3
12,60,12,36,3190,100.0,1529,47.9,2530,79.3,1661,52.1,869,27.2,660,20.7
