district_id,forecast_area_id,district_region_id,planning_area_id,inhabitants,inhabitants_percentage,inhabitants_with_migration_background,inhabitants_with_migration_background_percentage,inhabitants_germans,inhabitants_germans_percentage,inhabitants_germans_without_migration_background,inhabitants_germans_without_migration_background_percentage,inhabitants_germans_with_migration_background,inhabitants_germans_with_migration_background_percentage,inhabitants_foreigners,inhabitants_foreigners_percentage
01,01,11,01,3384,100.0,2054,60.7,1967,58.1,1330,39.3,637,18.8,1417,41.9
01,01,11,02,196,100.0,76,38.8,129,65.8,120,61.2,9,4.6,67,34.2
01,01,11,03,5038,100.0,2885,57.3,3287,65.2,2153,42.7,1134,22.5,1751,34.8
01,01,11,04,4759,100.0,3110,65.3,2858,60.1,1649,34.7,1209,25.4,1901,39.9
01,01,11,05,1421,100.0,899,63.3,767,54.0,522,36.7,245,17.2,654,46.0
01,01,12,01,2405,100.0,1438,59.8,1419,59.0,967,40.2,452,18.8,986,41.0
01,01,12,02,632,100.0,303,47.9,401,63.4,329,52.1,72,11.4,231,36.6
01,01,12,03,1115,100.0,593,53.2,707,63.4,522,46.8,185,16.6,408,36.6
01,01,12,04,8279,100.0,4152,50.2,5522,66.7,4127,49.8,1395,16.8,2757,33.3
01,01,13,01,6919,100.0,2964,42.8,4806,69.5,3955,57.2,851,12.3,2113,30.5
01,01,13,02,12572,100.0,5040,40.1,9143,72.7,7532,59.9,1611,12.8,3429,27.3
01,01,13,03,9999,100.0,4764,47.6,6506,65.1,5235,52.4,1271,12.7,3493,34.9
01,01,13,04,8761,100.0,3644,41.6,6473,73.9,5117,58.4,1356,15.5,2288,26.1
01,01,13,05,8243,100.0,3254,39.5,6081,73.8,4989,60.5,1092,13.2,2162,26.2
01,01,13,06,10607,100.0,4651,43.8,7439,70.1,5956,56.2,1483,14.0,3168,29.9
01,01,14,01,17948,100.0,7792,43.4,12281,68.4,10156,56.6,2125,11.8,5667,31.6
01,01,14,02,13645,100.0,5493,40.3,9869,72.3,8152,59.7,1717,12.6,3776,27.7
01,02,21,01,3557,100.0,1915,53.8,2214,62.2,1642,46.2,572,16.1,1343,37.8
01,02,21,02,6709,100.0,4139,61.7,3828,57.1,2570,38.3,1258,18.8,2881,42.9
01,02,21,03,272,100.0,213,78.3,119,43.8,59,21.7,60,22.1,153,56.3
01,02,21,04,18974,100.0,9586,50.5,12755,67.2,9388,49.5,3367,17.7,6219,32.8
01,02,21,05,5426,100.0,3234,59.6,3357,61.9,2192,40.4,1165,21.5,2069,38.1
01,02,21,06,11421,100.0,4053,35.5,9092,79.6,7368,64.5,1724,15.1,2329,20.4
01,02,22,01,11027,100.0,5556,50.4,7568,68.6,5471,49.6,2097,19.0,3459,31.4
01,02,22,02,2495,100.0,1554,62.3,1622,65.0,941,37.7,681,27.3,873,35.0
01,02,22,03,7083,100.0,4225,59.6,4697,66.3,2858,40.4,1839,26.0,2386,33.7
01,02,22,04,6236,100.0,2780,44.6,4462,71.6,3456,55.4,1006,16.1,1774,28.4
01,02,22,05,3349,100.0,2121,63.3,2222,66.3,1228,36.7,994,29.7,1127,33.7
01,02,22,06,3044,100.0,1252,41.1,2368,77.8,1792,58.9,576,18.9,676,22.2
01,02,22,07,5771,100.0,2713,47.0,3818,66.2,3058,53.0,760,13.2,1953,33.8
01,03,31,01,27088,100.0,17200,63.5,15724,58.0,9888,36.5,5836,21.5,11364,42.0
01,03,31,02,12063,100.0,7462,61.9,7365,61.1,4601,38.1,2764,22.9,4698,38.9
01,03,32,01,13919,100.0,9338,67.1,9626,69.2,4581,32.9,5045,36.2,4293,30.8
01,03,32,02,10273,100.0,5946,57.9,7327,71.3,4327,42.1,3000,29.2,2946,28.7
01,03,32,03,14684,100.0,9428,64.2,8758,59.6,5256,35.8,3502,23.8,5926,40.4
01,04,41,01,21023,100.0,10358,49.3,14386,68.4,10665,50.7,3721,17.7,6637,31.6
01,04,41,02,16630,100.0,6815,41.0,12588,75.7,9815,59.0,2773,16.7,4042,24.3
01,04,41,03,8684,100.0,4656,53.6,5442,62.7,4028,46.4,1414,16.3,3242,37.3
01,04,42,01,24356,100.0,16713,68.6,13567,55.7,7643,31.4,5924,24.3,10789,44.3
01,04,42,02,17122,100.0,10105,59.0,10030,58.6,7017,41.0,3013,17.6,7092,41.4
01,04,42,03,16328,100.0,9793,60.0,9797,60.0,6535,40.0,3262,20.0,6531,40.0
02,01,01,01,6823,100.0,4940,72.4,3762,55.1,1883,27.6,1879,27.5,3061,44.9
02,01,01,02,13693,100.0,9349,68.3,9104,66.5,4344,31.7,4760,34.8,4589,33.5
02,01,01,03,15302,100.0,10806,70.6,9856,64.4,4496,29.4,5360,35.0,5446,35.6
02,01,01,04,5086,100.0,3315,65.2,3425,67.3,1771,34.8,1654,32.5,1661,32.7
02,02,02,01,1790,100.0,690,38.5,1406,78.5,1100,61.5,306,17.1,384,21.5
02,02,02,02,6099,100.0,2722,44.6,4326,70.9,3377,55.4,949,15.6,1773,29.1
02,02,02,03,11056,100.0,4412,39.9,8310,75.2,6644,60.1,1666,15.1,2746,24.8
02,02,02,04,12808,100.0,5537,43.2,9271,72.4,7271,56.8,2000,15.6,3537,27.6
02,02,02,05,15107,100.0,6269,41.5,11246,74.4,8838,58.5,2408,15.9,3861,25.6
02,02,02,06,19040,100.0,8875,46.6,13730,72.1,10165,53.4,3565,18.7,5310,27.9
02,03,03,01,8996,100.0,5706,63.4,5545,61.6,3290,36.6,2255,25.1,3451,38.4
02,03,03,02,13131,100.0,7131,54.3,8851,67.4,6000,45.7,2851,21.7,4280,32.6
02,03,04,01,15263,100.0,7534,49.4,10377,68.0,7729,50.6,2648,17.3,4886,32.0
02,03,04,02,11172,100.0,5692,50.9,7436,66.6,5480,49.1,1956,17.5,3736,33.4
02,04,05,01,5390,100.0,1551,28.8,4524,83.9,3839,71.2,685,12.7,866,16.1
02,04,05,02,7443,100.0,2290,30.8,5985,80.4,5153,69.2,832,11.2,1458,19.6
02,04,05,03,11157,100.0,2973,26.6,9228,82.7,8184,73.4,1044,9.4,1929,17.3
02,04,07,01,13151,100.0,5550,42.2,9571,72.8,7601,57.8,1970,15.0,3580,27.2
02,04,07,02,10973,100.0,3137,28.6,8802,80.2,7836,71.4,966,8.8,2171,19.8
02,04,07,03,1155,100.0,792,68.6,469,40.6,363,31.4,106,9.2,686,59.4
02,05,06,01,9124,100.0,2871,31.5,7106,77.9,6253,68.5,853,9.3,2018,22.1
02,05,06,02,21730,100.0,6774,31.2,16946,78.0,14956,68.8,1990,9.2,4784,22.0
02,05,08,01,20028,100.0,7043,35.2,14908,74.4,12985,64.8,1923,9.6,5120,25.6
02,05,08,02,21280,100.0,6930,32.6,16215,76.2,14350,67.4,1865,8.8,5065,23.8
02,05,08,03,7598,100.0,2629,34.6,5730,75.4,4969,65.4,761,10.0,1868,24.6
02,05,08,04,4725,100.0,1136,24.0,4101,86.8,3589,76.0,512,10.8,624,13.2
03,01,01,01,4119,100.0,614,14.9,3716,90.2,3505,85.1,211,5.1,403,9.8
03,01,01,02,12348,100.0,2377,19.3,10545,85.4,9971,80.7,574,4.6,1803,14.6
03,01,01,04,239,100.0,57,23.8,209,87.4,182,76.2,27,11.3,30,12.6
03,02,02,03,2285,100.0,337,14.7,2020,88.4,1948,85.3,72,3.2,265,11.6
03,02,02,09,14967,100.0,2393,16.0,13603,90.9,12574,84.0,1029,6.9,1364,9.1
03,02,02,10,11488,100.0,1701,14.8,10533,91.7,9787,85.2,746,6.5,955,8.3
03,02,03,07,18304,100.0,2434,13.3,17292,94.5,15870,86.7,1422,7.8,1012,5.5
03,03,04,05,11352,100.0,1912,16.8,10269,90.5,9440,83.2,829,7.3,1083,9.5
03,03,04,06,8225,100.0,722,8.8,7926,96.4,7503,91.2,423,5.1,299,3.6
03,03,07,11,6869,100.0,502,7.3,6665,97.0,6367,92.7,298,4.3,204,3.0
03,03,07,15,7664,100.0,1477,19.3,6647,86.7,6187,80.7,460,6.0,1017,13.3
03,03,07,16,1131,100.0,41,3.6,1112,98.3,1090,96.4,22,1.9,19,1.7
03,04,05,08,4588,100.0,932,20.3,4303,93.8,3656,79.7,647,14.1,285,6.2
03,04,05,12,10074,100.0,1646,16.3,9306,92.4,8428,83.7,878,8.7,768,7.6
03,04,05,13,3356,100.0,496,14.8,3127,93.2,2860,85.2,267,8.0,229,6.8
03,04,06,14,36487,100.0,5650,15.5,33411,91.6,30837,84.5,2574,7.1,3076,8.4
03,04,08,18,34800,100.0,5989,17.2,31000,89.1,28811,82.8,2189,6.3,3800,10.9
03,05,09,19,5583,100.0,1101,19.7,4724,84.6,4482,80.3,242,4.3,859,15.4
03,05,09,20,7430,100.0,1096,14.8,6799,91.5,6334,85.2,465,6.3,631,8.5
03,05,09,23,9674,100.0,2127,22.0,8256,85.3,7547,78.0,709,7.3,1418,14.7
03,05,09,24,6140,100.0,1434,23.4,5154,83.9,4706,76.6,448,7.3,986,16.1
03,05,09,25,9755,100.0,1823,18.7,8593,88.1,7932,81.3,661,6.8,1162,11.9
03,05,10,17,4250,100.0,939,22.1,3587,84.4,3311,77.9,276,6.5,663,15.6
03,05,10,21,6468,100.0,760,11.8,5957,92.1,5708,88.2,249,3.8,511,7.9
03,05,10,22,4651,100.0,445,9.6,4395,94.5,4206,90.4,189,4.1,256,5.5
03,06,11,26,15688,100.0,4663,29.7,12486,79.6,11025,70.3,1461,9.3,3202,20.4
03,06,11,31,10755,100.0,3610,33.6,8235,76.6,7145,66.4,1090,10.1,2520,23.4
03,06,12,27,14649,100.0,3892,26.6,12097,82.6,10757,73.4,1340,9.1,2552,17.4
03,06,12,28,12787,100.0,3090,24.2,10697,83.7,9697,75.8,1000,7.8,2090,16.3
03,06,13,32,22873,100.0,7216,31.5,18101,79.1,15657,68.5,2444,10.7,4772,20.9
03,06,14,29,10001,100.0,1660,16.6,9035,90.3,8341,83.4,694,6.9,966,9.7
03,06,14,30,4126,100.0,1721,41.7,2678,64.9,2405,58.3,273,6.6,1448,35.1
03,06,14,34,6472,100.0,1751,27.1,5246,81.1,4721,72.9,525,8.1,1226,18.9
03,06,14,35,3941,100.0,1163,29.5,3146,79.8,2778,70.5,368,9.3,795,20.2
03,06,14,41,2660,100.0,736,27.7,2268,85.3,1924,72.3,344,12.9,392,14.7
03,07,15,36,11137,100.0,4043,36.3,8375,75.2,7094,63.7,1281,11.5,2762,24.8
03,07,15,37,16027,100.0,5621,35.1,12159,75.9,10406,64.9,1753,10.9,3868,24.1
03,07,16,33,3229,100.0,988,30.6,2583,80.0,2241,69.4,342,10.6,646,20.0
03,07,16,38,17709,100.0,5660,32.0,13961,78.8,12049,68.0,1912,10.8,3748,21.2
03,07,16,39,12738,100.0,3424,26.9,10574,83.0,9314,73.1,1260,9.9,2164,17.0
04,01,01,01,10785,100.0,5120,47.5,7850,72.8,5665,52.5,2185,20.3,2935,27.2
04,01,01,02,812,100.0,337,41.5,518,63.8,475,58.5,43,5.3,294,36.2
04,01,01,03,7881,100.0,4284,54.4,5760,73.1,3597,45.6,2163,27.4,2121,26.9
04,02,02,04,181,100.0,63,34.8,145,80.1,118,65.2,27,14.9,36,19.9
04,02,02,05,1329,100.0,339,25.5,1135,85.4,990,74.5,145,10.9,194,14.6
04,02,02,06,2869,100.0,815,28.4,2374,82.7,2054,71.6,320,11.2,495,17.3
04,02,02,07,2559,100.0,767,30.0,2107,82.3,1792,70.0,315,12.3,452,17.7
04,02,02,08,2922,100.0,784,26.8,2509,85.9,2138,73.2,371,12.7,413,14.1
04,02,02,09,3214,100.0,1241,38.6,2272,70.7,1973,61.4,299,9.3,942,29.3
04,02,03,10,616,100.0,338,54.9,335,54.4,278,45.1,57,9.3,281,45.6
04,02,03,11,15071,100.0,5049,33.5,12015,79.7,10022,66.5,1993,13.2,3056,20.3
04,02,03,12,5552,100.0,1793,32.3,4443,80.0,3759,67.7,684,12.3,1109,20.0
04,02,03,13,7452,100.0,2881,38.7,5682,76.2,4571,61.3,1111,14.9,1770,23.8
04,02,03,14,12,100.0,12,100.0,0,0.0,0,0.0,0,0.0,12,100.0
04,03,04,15,3048,100.0,1618,53.1,1853,60.8,1430,46.9,423,13.9,1195,39.2
04,03,04,16,10652,100.0,5221,49.0,7757,72.8,5431,51.0,2326,21.8,2895,27.2
04,03,04,17,10976,100.0,4294,39.1,8414,76.7,6682,60.9,1732,15.8,2562,23.3
04,03,05,18,9581,100.0,4335,45.2,6978,72.8,5246,54.8,1732,18.1,2603,27.2
04,03,05,19,5901,100.0,2715,46.0,4277,72.5,3186,54.0,1091,18.5,1624,27.5
04,03,06,20,8887,100.0,3973,44.7,6558,73.8,4914,55.3,1644,18.5,2329,26.2
04,03,06,21,3026,100.0,1750,57.8,1947,64.3,1276,42.2,671,22.2,1079,35.7
04,03,06,22,10833,100.0,5152,47.6,7838,72.4,5681,52.4,2157,19.9,2995,27.6
04,03,06,23,5049,100.0,2849,56.4,3406,67.5,2200,43.6,1206,23.9,1643,32.5
04,03,07,24,6490,100.0,2450,37.8,5027,77.5,4040,62.2,987,15.2,1463,22.5
04,03,07,25,12302,100.0,5023,40.8,9090,73.9,7279,59.2,1811,14.7,3212,26.1
04,03,07,26,5795,100.0,2633,45.4,4152,71.6,3162,54.6,990,17.1,1643,28.4
04,03,08,27,12235,100.0,6611,54.0,7948,65.0,5624,46.0,2324,19.0,4287,35.0
04,03,08,28,9668,100.0,4417,45.7,6808,70.4,5251,54.3,1557,16.1,2860,29.6
04,03,09,29,6072,100.0,2664,43.9,4425,72.9,3408,56.1,1017,16.7,1647,27.1
04,03,09,30,5649,100.0,2596,46.0,4008,71.0,3053,54.0,955,16.9,1641,29.0
04,03,09,31,3711,100.0,2144,57.8,2245,60.5,1567,42.2,678,18.3,1466,39.5
04,03,10,32,15628,100.0,6695,42.8,11585,74.1,8933,57.2,2652,17.0,4043,25.9
04,04,11,33,60,100.0,29,48.3,31,51.7,31,51.7,0,0.0,29,48.3
04,04,11,34,5228,100.0,2104,40.2,4100,78.4,3124,59.8,976,18.7,1128,21.6
04,04,11,35,2829,100.0,1036,36.6,2277,80.5,1793,63.4,484,17.1,552,19.5
04,04,11,36,3072,100.0,1091,35.5,2484,80.9,1981,64.5,503,16.4,588,19.1
04,04,11,37,8280,100.0,3184,38.5,6535,78.9,5096,61.5,1439,17.4,1745,21.1
04,04,12,38,6086,100.0,2147,35.3,5058,83.1,3939,64.7,1119,18.4,1028,16.9
04,04,12,39,353,100.0,275,77.9,100,28.3,78,22.1,22,6.2,253,71.7
04,04,12,40,1522,100.0,423,27.8,1300,85.4,1099,72.2,201,13.2,222,14.6
04,04,12,41,7031,100.0,1752,24.9,6072,86.4,5279,75.1,793,11.3,959,13.6
04,04,13,42,4141,100.0,1407,34.0,3381,81.6,2734,66.0,647,15.6,760,18.4
04,04,13,43,3556,100.0,1122,31.6,2977,83.7,2434,68.4,543,15.3,579,16.3
04,04,13,44,10810,100.0,3000,27.8,9078,84.0,7810,72.2,1268,11.7,1732,16.0
04,05,14,45,6325,100.0,2741,43.3,4850,76.7,3584,56.7,1266,20.0,1475,23.3
04,05,14,46,10778,100.0,4711,43.7,8069,74.9,6067,56.3,2002,18.6,2709,25.1
04,05,14,47,5365,100.0,2264,42.2,4043,75.4,3101,57.8,942,17.6,1322,24.6
04,05,14,48,9367,100.0,4452,47.5,6545,69.9,4915,52.5,1630,17.4,2822,30.1
04,05,15,49,4642,100.0,2021,43.5,3377,72.7,2621,56.5,756,16.3,1265,27.3
04,05,15,50,5574,100.0,2325,41.7,4174,74.9,3249,58.3,925,16.6,1400,25.1
04,05,15,51,4518,100.0,1947,43.1,3411,75.5,2571,56.9,840,18.6,1107,24.5
04,05,16,52,9914,100.0,3970,40.0,7453,75.2,5944,60.0,1509,15.2,2461,24.8
04,05,16,53,6993,100.0,2977,42.6,5190,74.2,4016,57.4,1174,16.8,1803,25.8
04,05,16,54,3055,100.0,1091,35.7,2398,78.5,1964,64.3,434,14.2,657,21.5
04,05,16,55,7300,100.0,3162,43.3,5438,74.5,4138,56.7,1300,17.8,1862,25.5
04,05,16,56,7698,100.0,2505,32.5,6227,80.9,5193,67.5,1034,13.4,1471,19.1
04,06,17,57,72,100.0,24,33.3,54,75.0,48,66.7,6,8.3,18,25.0
05,01,01,01,10290,100.0,2874,27.9,8886,86.4,7416,72.1,1470,14.3,1404,13.6
05,01,01,02,7193,100.0,2230,31.0,5842,81.2,4963,69.0,879,12.2,1351,18.8
05,01,01,03,7738,100.0,1445,18.7,7051,91.1,6293,81.3,758,9.8,687,8.9
05,01,02,04,3608,100.0,1563,43.3,2719,75.4,2045,56.7,674,18.7,889,24.6
05,01,02,05,1960,100.0,579,29.5,1735,88.5,1381,70.5,354,18.1,225,11.5
05,01,02,06,10613,100.0,4239,39.9,8443,79.6,6374,60.1,2069,19.5,2170,20.4
05,01,02,07,11618,100.0,5916,50.9,8995,77.4,5702,49.1,3293,28.3,2623,22.6
05,01,02,08,7715,100.0,2705,35.1,6122,79.4,5010,64.9,1112,14.4,1593,20.6
05,01,02,09,6103,100.0,1920,31.5,5197,85.2,4183,68.5,1014,16.6,906,14.8
05,01,03,10,3974,100.0,1491,37.5,3090,77.8,2483,62.5,607,15.3,884,22.2
05,01,03,11,5681,100.0,2853,50.2,4308,75.8,2828,49.8,1480,26.1,1373,24.2
05,01,03,12,7394,100.0,4174,56.5,4378,59.2,3220,43.5,1158,15.7,3016,40.8
05,01,03,13,6916,100.0,2914,42.1,5077,73.4,4002,57.9,1075,15.5,1839,26.6
05,01,03,14,12412,100.0,4964,40.0,9559,77.0,7448,60.0,2111,17.0,2853,23.0
05,01,03,39,995,100.0,675,67.8,384,38.6,320,32.2,64,6.4,611,61.4
05,02,04,15,3862,100.0,798,20.7,3643,94.3,3064,79.3,579,15.0,219,5.7
05,02,04,16,1685,100.0,88,5.2,1659,98.5,1597,94.8,62,3.7,26,1.5
05,02,04,17,5962,100.0,1860,31.2,5013,84.1,4102,68.8,911,15.3,949,15.9
05,02,04,18,4392,100.0,1168,26.6,3690,84.0,3224,73.4,466,10.6,702,16.0
05,02,04,19,7117,100.0,2024,28.4,6099,85.7,5093,71.6,1006,14.1,1018,14.3
05,02,04,20,969,100.0,193,19.9,874,90.2,776,80.1,98,10.1,95,9.8
05,02,05,21,3235,100.0,878,27.1,2935,90.7,2357,72.9,578,17.9,300,9.3
05,02,05,22,7436,100.0,3525,47.4,5176,69.6,3911,52.6,1265,17.0,2260,30.4
05,02,05,23,12761,100.0,7392,57.9,8941,70.1,5369,42.1,3572,28.0,3820,29.9
05,02,05,24,6328,100.0,1363,21.5,5709,90.2,4965,78.5,744,11.8,619,9.8
05,02,06,25,7664,100.0,2789,36.4,6045,78.9,4875,63.6,1170,15.3,1619,21.1
05,02,06,26,18379,100.0,6383,34.7,14461,78.7,11996,65.3,2465,13.4,3918,21.3
05,02,06,27,4440,100.0,1988,44.8,3187,71.8,2452,55.2,735,16.6,1253,28.2
05,02,06,28,2041,100.0,505,24.7,1808,88.6,1536,75.3,272,13.3,233,11.4
05,02,06,29,4420,100.0,720,16.3,4088,92.5,3700,83.7,388,8.8,332,7.5
05,03,07,30,4026,100.0,2176,54.0,3286,81.6,1850,46.0,1436,35.7,740,18.4
05,03,07,31,11699,100.0,4941,42.2,9350,79.9,6758,57.8,2592,22.2,2349,20.1
05,03,08,32,12065,100.0,5452,45.2,9044,75.0,6613,54.8,2431,20.1,3021,25.0
05,03,08,33,512,100.0,231,45.1,401,78.3,281,54.9,120,23.4,111,21.7
05,04,09,34,3539,100.0,915,25.9,2992,84.5,2624,74.1,368,10.4,547,15.5
05,04,09,35,454,100.0,105,23.1,386,85.0,349,76.9,37,8.1,68,15.0
05,04,09,36,10014,100.0,1732,17.3,9434,94.2,8282,82.7,1152,11.5,580,5.8
05,04,09,37,2195,100.0,340,15.5,2081,94.8,1855,84.5,226,10.3,114,5.2
05,04,09,38,3675,100.0,503,13.7,3488,94.9,3172,86.3,316,8.6,187,5.1
06,01,01,01,6964,100.0,1811,26.0,6014,86.4,5153,74.0,861,12.4,950,13.6
06,01,01,02,8836,100.0,3167,35.8,7126,80.6,5669,64.2,1457,16.5,1710,19.4
06,01,01,03,6336,100.0,1992,31.4,5347,84.4,4344,68.6,1003,15.8,989,15.6
06,01,02,04,6885,100.0,2313,33.6,5757,83.6,4572,66.4,1185,17.2,1128,16.4
06,01,02,05,9823,100.0,3119,31.8,8211,83.6,6704,68.2,1507,15.3,1612,16.4
06,01,02,06,7745,100.0,2229,28.8,6579,84.9,5516,71.2,1063,13.7,1166,15.1
06,01,02,07,7850,100.0,2561,32.6,6531,83.2,5289,67.4,1242,15.8,1319,16.8
06,01,02,08,6715,100.0,1999,29.8,5677,84.5,4716,70.2,961,14.3,1038,15.5
06,01,02,09,9227,100.0,3095,33.5,7581,82.2,6132,66.5,1449,15.7,1646,17.8
06,01,02,10,4939,100.0,1393,28.2,4198,85.0,3546,71.8,652,13.2,741,15.0
06,02,03,01,5034,100.0,1140,22.6,4488,89.2,3894,77.4,594,11.8,546,10.8
06,02,03,02,5651,100.0,1420,25.1,4995,88.4,4231,74.9,764,13.5,656,11.6
06,02,03,03,7366,100.0,2215,30.1,6208,84.3,5151,69.9,1057,14.3,1158,15.7
06,02,03,04,7211,100.0,2082,28.9,6158,85.4,5129,71.1,1029,14.3,1053,14.6
06,02,03,05,11414,100.0,3841,33.7,9423,82.6,7573,66.3,1850,16.2,1991,17.4
06,02,03,06,6438,100.0,1233,19.2,5906,91.7,5205,80.8,701,10.9,532,8.3
06,02,04,07,4644,100.0,2298,49.5,3478,74.9,2346,50.5,1132,24.4,1166,25.1
06,02,04,08,6922,100.0,1903,27.5,5881,85.0,5019,72.5,862,12.5,1041,15.0
06,02,04,09,8282,100.0,2052,24.8,7177,86.7,6230,75.2,947,11.4,1105,13.3
06,02,04,10,7166,100.0,1406,19.6,6356,88.7,5760,80.4,596,8.3,810,11.3
06,02,04,11,8575,100.0,2145,25.0,7586,88.5,6430,75.0,1156,13.5,989,11.5
06,03,05,01,5748,100.0,1325,23.1,4935,85.9,4423,76.9,512,8.9,813,14.1
06,03,05,02,5640,100.0,1315,23.3,4967,88.1,4325,76.7,642,11.4,673,11.9
06,03,05,03,11872,100.0,3392,28.6,10102,85.1,8480,71.4,1622,13.7,1770,14.9
06,03,05,04,11062,100.0,2419,21.9,9863,89.2,8643,78.1,1220,11.0,1199,10.8
06,03,06,05,7108,100.0,2000,28.1,6036,84.9,5108,71.9,928,13.1,1072,15.1
06,03,06,06,5273,100.0,1733,32.9,4292,81.4,3540,67.1,752,14.3,981,18.6
06,03,06,07,3118,100.0,1134,36.4,2319,74.4,1984,63.6,335,10.7,799,25.6
06,03,06,08,13667,100.0,3842,28.1,11794,86.3,9825,71.9,1969,14.4,1873,13.7
06,03,06,09,12208,100.0,3028,24.8,10578,86.6,9180,75.2,1398,11.5,1630,13.4
06,03,06,10,8502,100.0,1987,23.4,7431,87.4,6515,76.6,916,10.8,1071,12.6
06,04,07,01,10246,100.0,2244,21.9,9041,88.2,8002,78.1,1039,10.1,1205,11.8
06,04,07,02,5506,100.0,1296,23.5,4851,88.1,4210,76.5,641,11.6,655,11.9
06,04,07,03,11156,100.0,3224,28.9,8915,79.9,7932,71.1,983,8.8,2241,20.1
06,04,08,04,7609,100.0,1441,18.9,6874,90.3,6168,81.1,706,9.3,735,9.7
06,04,08,05,5345,100.0,1152,21.6,4759,89.0,4193,78.4,566,10.6,586,11.0
06,04,08,06,7313,100.0,1168,16.0,6712,91.8,6145,84.0,567,7.8,601,8.2
06,04,08,07,5927,100.0,1395,23.5,5206,87.8,4532,76.5,674,11.4,721,12.2
06,04,08,08,4666,100.0,1737,37.2,3985,85.4,2929,62.8,1056,22.6,681,14.6
06,04,08,09,4999,100.0,1532,30.6,4071,81.4,3467,69.4,604,12.1,928,18.6
06,04,08,10,7089,100.0,2217,31.3,5872,82.8,4872,68.7,1000,14.1,1217,17.2
07,01,01,01,9984,100.0,4942,49.5,6977,69.9,5042,50.5,1935,19.4,3007,30.1
07,01,01,02,16634,100.0,9548,57.4,10696,64.3,7086,42.6,3610,21.7,5938,35.7
07,01,01,03,10641,100.0,4206,39.5,8080,75.9,6435,60.5,1645,15.5,2561,24.1
07,01,01,04,13820,100.0,7921,57.3,9044,65.4,5899,42.7,3145,22.8,4776,34.6
07,02,02,01,10705,100.0,3856,36.0,8596,80.3,6849,64.0,1747,16.3,2109,19.7
07,02,02,02,10310,100.0,4474,43.4,7654,74.2,5836,56.6,1818,17.6,2656,25.8
07,02,02,03,18047,100.0,8081,44.8,13256,73.5,9966,55.2,3290,18.2,4791,26.5
07,02,02,04,12184,100.0,4543,37.3,9493,77.9,7641,62.7,1852,15.2,2691,22.1
07,03,03,01,24833,100.0,6862,27.6,21083,84.9,17971,72.4,3112,12.5,3750,15.1
07,03,03,02,9439,100.0,3029,32.1,7834,83.0,6410,67.9,1424,15.1,1605,17.0
07,03,03,03,12399,100.0,5446,43.9,9596,77.4,6953,56.1,2643,21.3,2803,22.6
07,04,04,01,18738,100.0,7757,41.4,14396,76.8,10981,58.6,3415,18.2,4342,23.2
07,04,04,02,2368,100.0,506,21.4,2145,90.6,1862,78.6,283,12.0,223,9.4
07,04,04,03,24316,100.0,9162,37.7,19324,79.5,15154,62.3,4170,17.1,4992,20.5
07,04,04,04,5196,100.0,1372,26.4,4544,87.5,3824,73.6,720,13.9,652,12.5
07,04,04,05,11060,100.0,4757,43.0,8420,76.1,6303,57.0,2117,19.1,2640,23.9
07,04,04,06,4094,100.0,2323,56.7,2640,64.5,1771,43.3,869,21.2,1454,35.5
07,05,05,01,16725,100.0,6737,40.3,13192,78.9,9988,59.7,3204,19.2,3533,21.1
07,05,05,02,8119,100.0,2997,36.9,6462,79.6,5122,63.1,1340,16.5,1657,20.4
07,05,05,03,9263,100.0,3005,32.4,7800,84.2,6258,67.6,1542,16.6,1463,15.8
07,05,05,04,5652,100.0,1816,32.1,4832,85.5,3836,67.9,996,17.6,820,14.5
07,05,05,05,10673,100.0,3107,29.1,9209,86.3,7566,70.9,1643,15.4,1464,13.7
07,05,05,06,2287,100.0,562,24.6,2054,89.8,1725,75.4,329,14.4,233,10.2
07,06,06,01,10199,100.0,4204,41.2,7874,77.2,5995,58.8,1879,18.4,2325,22.8
07,06,06,02,4703,100.0,1108,23.6,4239,90.1,3595,76.4,644,13.7,464,9.9
07,06,06,03,2861,100.0,1067,37.3,2377,83.1,1794,62.7,583,20.4,484,16.9
07,06,06,04,14592,100.0,5523,37.8,12445,85.3,9069,62.2,3376,23.1,2147,14.7
07,07,07,01,10526,100.0,2309,21.9,9499,90.2,8217,78.1,1282,12.2,1027,9.8
07,07,07,02,10931,100.0,2257,20.6,10037,91.8,8674,79.4,1363,12.5,894,8.2
07,07,07,03,7640,100.0,1990,26.0,6751,88.4,5650,74.0,1101,14.4,889,11.6
07,07,07,04,8547,100.0,3368,39.4,6663,78.0,5179,60.6,1484,17.4,1884,22.0
07,07,07,05,7031,100.0,1276,18.1,6484,92.2,5755,81.9,729,10.4,547,7.8
07,07,07,06,3936,100.0,837,21.3,3451,87.7,3099,78.7,352,8.9,485,12.3
07,07,07,07,2976,100.0,491,16.5,2735,91.9,2485,83.5,250,8.4,241,8.1
08,01,01,15,880,100.0,384,43.6,649,73.8,496,56.4,153,17.4,231,26.3
08,01,01,16,3697,100.0,2129,57.6,2268,61.3,1568,42.4,700,18.9,1429,38.7
08,01,01,17,16138,100.0,8256,51.2,10582,65.6,7882,48.8,2700,16.7,5556,34.4
08,01,01,18,11891,100.0,7206,60.6,7465,62.8,4685,39.4,2780,23.4,4426,37.2
08,01,02,11,10029,100.0,5891,58.7,6070,60.5,4138,41.3,1932,19.3,3959,39.5
08,01,02,12,7475,100.0,5049,67.5,4910,65.7,2426,32.5,2484,33.2,2565,34.3
08,01,02,13,12455,100.0,6805,54.6,8092,65.0,5650,45.4,2442,19.6,4363,35.0
08,01,02,14,8197,100.0,4723,57.6,5147,62.8,3474,42.4,1673,20.4,3050,37.2
08,01,03,01,27732,100.0,13599,49.0,18984,68.5,14133,51.0,4851,17.5,8748,31.5
08,01,03,02,3696,100.0,1388,37.6,2878,77.9,2308,62.4,570,15.4,818,22.1
08,01,03,03,8418,100.0,5139,61.0,5045,59.9,3279,39.0,1766,21.0,3373,40.1
08,01,04,04,23741,100.0,12588,53.0,15575,65.6,11153,47.0,4422,18.6,8166,34.4
08,01,04,05,9049,100.0,4262,47.1,6257,69.1,4787,52.9,1470,16.2,2792,30.9
08,01,04,06,7143,100.0,4219,59.1,4351,60.9,2924,40.9,1427,20.0,2792,39.1
08,01,04,07,799,100.0,357,44.7,563,70.5,442,55.3,121,15.1,236,29.5
08,01,05,08,5772,100.0,4158,72.0,3770,65.3,1614,28.0,2156,37.4,2002,34.7
08,01,05,09,9459,100.0,6232,65.9,6666,70.5,3227,34.1,3439,36.4,2793,29.5
08,01,05,10,480,100.0,325,67.7,220,45.8,155,32.3,65,13.5,260,54.2
08,02,06,19,11646,100.0,6503,55.8,7619,65.4,5143,44.2,2476,21.3,4027,34.6
08,02,06,20,9354,100.0,4198,44.9,7321,78.3,5156,55.1,2165,23.1,2033,21.7
08,02,06,21,2346,100.0,615,26.2,2155,91.9,1731,73.8,424,18.1,191,8.1
08,02,06,22,14211,100.0,4071,28.6,12292,86.5,10140,71.4,2152,15.1,1919,13.5
08,02,06,23,1281,100.0,388,30.3,1108,86.5,893,69.7,215,16.8,173,13.5
08,02,06,24,1410,100.0,508,36.0,1231,87.3,902,64.0,329,23.3,179,12.7
08,02,06,25,3319,100.0,988,29.8,2797,84.3,2331,70.2,466,14.0,522,15.7
08,02,07,26,8403,100.0,2148,25.6,7492,89.2,6255,74.4,1237,14.7,911,10.8
08,02,07,27,12013,100.0,3730,31.0,10244,85.3,8283,69.0,1961,16.3,1769,14.7
08,02,07,28,8851,100.0,3852,43.5,6852,77.4,4999,56.5,1853,20.9,1999,22.6
08,03,08,29,12437,100.0,6328,50.9,9879,79.4,6109,49.1,3770,30.3,2558,20.6
08,03,08,30,7415,100.0,3043,41.0,6214,83.8,4372,59.0,1842,24.8,1201,16.2
08,03,08,31,17564,100.0,8959,51.0,13912,79.2,8605,49.0,5307,30.2,3652,20.8
08,04,09,32,2868,100.0,952,33.2,2478,86.4,1916,66.8,562,19.6,390,13.6
08,04,09,33,4157,100.0,1345,32.4,3579,86.1,2812,67.6,767,18.5,578,13.9
08,04,09,34,2679,100.0,847,31.6,2335,87.2,1832,68.4,503,18.8,344,12.8
08,04,10,35,8239,100.0,2765,33.6,7073,85.8,5474,66.4,1599,19.4,1166,14.2
08,04,10,36,6866,100.0,1633,23.8,6204,90.4,5233,76.2,971,14.1,662,9.6
08,04,10,37,9865,100.0,2607,26.4,8677,88.0,7258,73.6,1419,14.4,1188,12.0
08,04,10,38,7011,100.0,1636,23.3,6460,92.1,5375,76.7,1085,15.5,551,7.9
08,04,10,39,3870,100.0,1122,29.0,3497,90.4,2748,71.0,749,19.4,373,9.6
08,04,10,40,7930,100.0,1922,24.2,7165,90.4,6008,75.8,1157,14.6,765,9.6
09,01,01,01,12471,100.0,3918,31.4,10078,80.8,8553,68.6,1525,12.2,2393,19.2
09,01,01,02,69,100.0,12,17.4,60,87.0,57,82.6,3,4.3,9,13.0
09,01,02,01,4341,100.0,751,17.3,3939,90.7,3590,82.7,349,8.0,402,9.3
09,01,02,02,6980,100.0,1196,17.1,6217,89.1,5784,82.9,433,6.2,763,10.9
09,01,03,01,15668,100.0,2427,15.5,14251,91.0,13241,84.5,1010,6.4,1417,9.0
09,01,03,02,2894,100.0,679,23.5,2614,90.3,2215,76.5,399,13.8,280,9.7
09,01,04,01,8503,100.0,925,10.9,8010,94.2,7578,89.1,432,5.1,493,5.8
09,01,04,02,11436,100.0,1707,14.9,10604,92.7,9729,85.1,875,7.7,832,7.3
09,02,05,01,7398,100.0,2178,29.4,5758,77.8,5220,70.6,538,7.3,1640,22.2
09,02,05,02,15732,100.0,3364,21.4,13500,85.8,12368,78.6,1132,7.2,2232,14.2
09,02,06,01,8970,100.0,2604,29.0,6974,77.7,6366,71.0,608,6.8,1996,22.3
09,02,06,02,3587,100.0,279,7.8,3448,96.1,3308,92.2,140,3.9,139,3.9
09,02,07,01,2763,100.0,1147,41.5,1876,67.9,1616,58.5,260,9.4,887,32.1
09,02,07,02,16805,100.0,2750,16.4,14929,88.8,14055,83.6,874,5.2,1876,11.2
09,02,08,01,2948,100.0,281,9.5,2779,94.3,2667,90.5,112,3.8,169,5.7
09,02,08,02,7916,100.0,1511,19.1,6879,86.9,6405,80.9,474,6.0,1037,13.1
09,03,09,01,13213,100.0,1787,13.5,12417,94.0,11426,86.5,991,7.5,796,6.0
09,03,09,02,5665,100.0,788,13.9,5259,92.8,4877,86.1,382,6.7,406,7.2
09,03,09,03,8167,100.0,1547,18.9,7476,91.5,6620,81.1,856,10.5,691,8.5
09,03,10,01,13117,100.0,1684,12.8,12094,92.2,11433,87.2,661,5.0,1023,7.8
09,03,11,01,6530,100.0,871,13.3,5961,91.3,5659,86.7,302,4.6,569,8.7
09,03,12,01,1833,100.0,171,9.3,1767,96.4,1662,90.7,105,5.7,66,3.6
09,03,12,02,2577,100.0,269,10.4,2435,94.5,2308,89.6,127,4.9,142,5.5
09,04,13,01,14701,100.0,1338,9.1,13903,94.6,13363,90.9,540,3.7,798,5.4
09,04,13,02,1898,100.0,188,9.9,1813,95.5,1710,90.1,103,5.4,85,4.5
09,04,14,01,4833,100.0,389,8.0,4668,96.6,4444,92.0,224,4.6,165,3.4
09,04,14,02,1558,100.0,212,13.6,1454,93.3,1346,86.4,108,6.9,104,6.7
09,04,15,01,7712,100.0,1419,18.4,6795,88.1,6293,81.6,502,6.5,917,11.9
09,04,16,01,6755,100.0,497,7.4,6543,96.9,6258,92.6,285,4.2,212,3.1
09,05,17,01,4052,100.0,435,10.7,3768,93.0,3617,89.3,151,3.7,284,7.0
09,05,17,02,15002,100.0,1238,8.3,14407,96.0,13764,91.7,643,4.3,595,4.0
09,05,18,01,9477,100.0,889,9.4,9002,95.0,8588,90.6,414,4.4,475,5.0
09,05,19,01,11304,100.0,1374,12.2,10481,92.7,9930,87.8,551,4.9,823,7.3
09,05,20,01,12900,100.0,1040,8.1,12365,95.9,11860,91.9,505,3.9,535,4.1
10,01,01,01,5752,100.0,1510,26.3,4944,86.0,4242,73.7,702,12.2,808,14.0
10,01,01,02,18455,100.0,4800,26.0,16183,87.7,13655,74.0,2528,13.7,2272,12.3
10,01,02,03,1330,100.0,865,65.0,519,39.0,465,35.0,54,4.1,811,61.0
10,01,02,04,10747,100.0,2611,24.3,9517,88.6,8136,75.7,1381,12.9,1230,11.4
10,01,02,05,8172,100.0,1290,15.8,7485,91.6,6882,84.2,603,7.4,687,8.4
10,01,02,06,17600,100.0,4466,25.4,14958,85.0,13134,74.6,1824,10.4,2642,15.0
10,01,02,07,10733,100.0,2561,23.9,9598,89.4,8172,76.1,1426,13.3,1135,10.6
10,01,03,08,2187,100.0,593,27.1,1825,83.4,1594,72.9,231,10.6,362,16.6
10,01,03,09,14391,100.0,3312,23.0,12999,90.3,11079,77.0,1920,13.3,1392,9.7
10,01,03,10,18199,100.0,4075,22.4,16261,89.4,14124,77.6,2137,11.7,1938,10.6
10,01,03,11,3695,100.0,524,14.2,3507,94.9,3171,85.8,336,9.1,188,5.1
10,02,04,12,6835,100.0,2035,29.8,5735,83.9,4800,70.2,935,13.7,1100,16.1
10,02,04,13,16114,100.0,3461,21.5,13864,86.0,12653,78.5,1211,7.5,2250,14.0
10,02,04,14,1676,100.0,737,44.0,1384,82.6,939,56.0,445,26.6,292,17.4
10,02,04,15,5776,100.0,1759,30.5,4440,76.9,4017,69.5,423,7.3,1336,23.1
10,02,04,16,5646,100.0,1582,28.0,4559,80.7,4064,72.0,495,8.8,1087,19.3
10,02,05,17,9213,100.0,1351,14.7,8380,91.0,7862,85.3,518,5.6,833,9.0
10,02,05,18,5314,100.0,1029,19.4,4636,87.2,4285,80.6,351,6.6,678,12.8
10,02,05,19,6105,100.0,1825,29.9,4879,79.9,4280,70.1,599,9.8,1226,20.1
10,02,06,20,3367,100.0,575,17.1,3092,91.8,2792,82.9,300,8.9,275,8.2
10,02,06,21,6329,100.0,1259,19.9,5562,87.9,5070,80.1,492,7.8,767,12.1
10,02,06,22,8634,100.0,1172,13.6,8113,94.0,7462,86.4,651,7.5,521,6.0
10,02,06,23,6527,100.0,812,12.4,6183,94.7,5715,87.6,468,7.2,344,5.3
10,03,07,24,7871,100.0,1363,17.3,6995,88.9,6508,82.7,487,6.2,876,11.1
10,03,07,25,6311,100.0,1320,20.9,5516,87.4,4991,79.1,525,8.3,795,12.6
10,03,07,26,3497,100.0,659,18.8,3081,88.1,2838,81.2,243,6.9,416,11.9
10,03,07,27,9733,100.0,1030,10.6,9353,96.1,8703,89.4,650,6.7,380,3.9
10,04,08,28,7805,100.0,699,9.0,7498,96.1,7106,91.0,392,5.0,307,3.9
10,04,08,29,3923,100.0,398,10.1,3671,93.6,3525,89.9,146,3.7,252,6.4
10,04,08,30,7646,100.0,517,6.8,7480,97.8,7129,93.2,351,4.6,166,2.2
10,04,09,31,9714,100.0,821,8.5,9376,96.5,8893,91.5,483,5.0,338,3.5
10,04,09,32,4273,100.0,437,10.2,4051,94.8,3836,89.8,215,5.0,222,5.2
10,04,09,33,15169,100.0,1060,7.0,14773,97.4,14109,93.0,664,4.4,396,2.6
11,01,01,01,648,100.0,76,11.7,599,92.4,572,88.3,27,4.2,49,7.6
11,01,01,02,2594,100.0,155,6.0,2540,97.9,2439,94.0,101,3.9,54,2.1
11,01,01,03,1541,100.0,380,24.7,1251,81.2,1161,75.3,90,5.8,290,18.8
11,01,02,04,8928,100.0,2651,29.7,7385,82.7,6277,70.3,1108,12.4,1543,17.3
11,01,02,05,6704,100.0,1855,27.7,5740,85.6,4849,72.3,891,13.3,964,14.4
11,01,02,06,6078,100.0,1521,25.0,5144,84.6,4557,75.0,587,9.7,934,15.4
11,01,02,07,7459,100.0,1826,24.5,6222,83.4,5633,75.5,589,7.9,1237,16.6
11,01,03,08,11808,100.0,3387,28.7,9889,83.7,8421,71.3,1468,12.4,1919,16.3
11,01,03,09,9715,100.0,2633,27.1,8142,83.8,7082,72.9,1060,10.9,1573,16.2
11,01,03,10,5754,100.0,1117,19.4,5022,87.3,4637,80.6,385,6.7,732,12.7
11,02,04,11,9461,100.0,2571,27.2,7590,80.2,6890,72.8,700,7.4,1871,19.8
11,02,04,12,6827,100.0,1461,21.4,5961,87.3,5366,78.6,595,8.7,866,12.7
11,02,05,13,3964,100.0,829,20.9,3340,84.3,3135,79.1,205,5.2,624,15.7
11,02,05,14,9628,100.0,2297,23.9,7866,81.7,7331,76.1,535,5.6,1762,18.3
11,02,05,15,14813,100.0,3833,25.9,12580,84.9,10980,74.1,1600,10.8,2233,15.1
11,02,05,16,4033,100.0,661,16.4,3717,92.2,3372,83.6,345,8.6,316,7.8
11,03,06,17,6310,100.0,2234,35.4,4892,77.5,4076,64.6,816,12.9,1418,22.5
11,03,06,18,16424,100.0,4489,27.3,13733,83.6,11935,72.7,1798,10.9,2691,16.4
11,03,06,19,11012,100.0,3489,31.7,8952,81.3,7523,68.3,1429,13.0,2060,18.7
11,03,07,20,5732,100.0,3514,61.3,2547,44.4,2218,38.7,329,5.7,3185,55.6
11,03,07,21,25075,100.0,6579,26.2,20546,81.9,18496,73.8,2050,8.2,4529,18.1
11,03,08,24,10084,100.0,3620,35.9,7843,77.8,6464,64.1,1379,13.7,2241,22.2
11,04,09,25,4214,100.0,962,22.8,3590,85.2,3252,77.2,338,8.0,624,14.8
11,04,09,26,29258,100.0,6415,21.9,24970,85.3,22843,78.1,2127,7.3,4288,14.7
11,04,10,22,5507,100.0,1882,34.2,4162,75.6,3625,65.8,537,9.8,1345,24.4
11,04,10,23,6692,100.0,2250,33.6,5399,80.7,4442,66.4,957,14.3,1293,19.3
11,04,10,27,3022,100.0,809,26.8,2524,83.5,2213,73.2,311,10.3,498,16.5
11,04,11,28,25613,100.0,6141,24.0,22002,85.9,19472,76.0,2530,9.9,3611,14.1
11,05,12,29,4216,100.0,868,20.6,3706,87.9,3348,79.4,358,8.5,510,12.1
11,05,13,30,9821,100.0,1923,19.6,8482,86.4,7898,80.4,584,5.9,1339,13.6
11,05,13,31,10540,100.0,1270,12.0,9911,94.0,9270,88.0,641,6.1,629,6.0
11,05,13,32,7018,100.0,917,13.1,6575,93.7,6101,86.9,474,6.8,443,6.3
12,10,31,15,7749,100.0,3287,42.4,5896,76.1,4462,57.6,1434,18.5,1853,23.9
12,10,31,16,9871,100.0,4648,47.1,7089,71.8,5223,52.9,1866,18.9,2782,28.2
12,10,31,17,10930,100.0,5771,52.8,7457,68.2,5159,47.2,2298,21.0,3473,31.8
12,10,32,18,13835,100.0,5989,43.3,10541,76.2,7846,56.7,2695,19.5,3294,23.8
12,10,32,19,8778,100.0,3876,44.2,6678,76.1,4902,55.8,1776,20.2,2100,23.9
12,10,32,20,4633,100.0,1358,29.3,3920,84.6,3275,70.7,645,13.9,713,15.4
12,21,41,25,7497,100.0,2311,30.8,6270,83.6,5186,69.2,1084,14.5,1227,16.4
12,21,41,26,8106,100.0,3155,38.9,6470,79.8,4951,61.1,1519,18.7,1636,20.2
12,21,44,21,2747,100.0,1023,37.2,2124,77.3,1724,62.8,400,14.6,623,22.7
12,21,44,22,8224,100.0,4796,58.3,5490,66.8,3428,41.7,2062,25.1,2734,33.2
12,21,44,23,5694,100.0,2326,40.9,4510,79.2,3368,59.1,1142,20.1,1184,20.8
12,21,44,24,10833,100.0,5484,50.6,7457,68.8,5349,49.4,2108,19.5,3376,31.2
12,21,45,27,10911,100.0,2415,22.1,9558,87.6,8496,77.9,1062,9.7,1353,12.4
12,21,45,28,256,100.0,98,38.3,191,74.6,158,61.7,33,12.9,65,25.4
12,22,42,29,6026,100.0,826,13.7,5704,94.7,5200,86.3,504,8.4,322,5.3
12,22,42,30,18072,100.0,2409,13.3,17110,94.7,15663,86.7,1447,8.0,962,5.3
12,23,11,01,16643,100.0,2329,14.0,15547,93.4,14314,86.0,1233,7.4,1096,6.6
12,23,11,02,16828,100.0,2178,12.9,15938,94.7,14650,87.1,1288,7.7,890,5.3
12,30,12,03,15084,100.0,4560,30.2,12255,81.2,10524,69.8,1731,11.5,2829,18.8
12,30,12,04,6229,100.0,1403,22.5,5595,89.8,4826,77.5,769,12.3,634,10.2
12,30,12,05,5005,100.0,926,18.5,4596,91.8,4079,81.5,517,10.3,409,8.2
12,30,12,06,5185,100.0,841,16.2,4886,94.2,4344,83.8,542,10.5,299,5.8
12,30,21,07,3071,100.0,1297,42.2,2517,82.0,1774,57.8,743,24.2,554,18.0
12,30,21,08,14578,100.0,6226,42.7,11640,79.8,8352,57.3,3288,22.6,2938,20.2
12,30,21,09,11691,100.0,5987,51.2,8726,74.6,5704,48.8,3022,25.8,2965,25.4
12,30,21,10,10574,100.0,5832,55.2,7560,71.5,4742,44.8,2818,26.7,3014,28.5
12,30,22,11,3339,100.0,950,28.5,2919,87.4,2389,71.5,530,15.9,420,12.6
12,30,22,12,5964,100.0,2837,47.6,4186,70.2,3127,52.4,1059,17.8,1778,29.8
12,30,43,13,6735,100.0,1613,23.9,5726,85.0,5122,76.1,604,9.0,1009,15.0
12,30,43,14,9738,100.0,1429,14.7,9053,93.0,8309,85.3,744,7.6,685,7.0
