district_id,forecast_area_id,district_region_id,planning_area_id,inhabitants,inhabitants_percentage,inhabitants_with_migration_background,inhabitants_with_migration_background_percentage,inhabitants_germans,inhabitants_germans_percentage,inhabitants_germans_without_migration_background,inhabitants_germans_without_migration_background_percentage,inhabitants_germans_with_migration_background,inhabitants_germans_with_migration_background_percentage,inhabitants_foreigners,inhabitants_foreigners_percentage
01,01,11,01,3225,100.0,1879,58.3,1922,59.6,1346,41.7,576,17.9,1303,40.4
01,01,11,02,185,100.0,77,41.6,123,66.5,108,58.4,15,8.1,62,33.5
01,01,11,03,5173,100.0,2942,56.9,3306,63.9,2231,43.1,1075,20.8,1867,36.1
01,01,11,04,4786,100.0,3138,65.6,2876,60.1,1648,34.4,1228,25.7,1910,39.9
01,01,11,05,1225,100.0,733,59.8,706,57.6,492,40.2,214,17.5,519,42.4
01,01,12,01,2310,100.0,1304,56.5,1432,62.0,1006,43.5,426,18.4,878,38.0
01,01,12,02,607,100.0,301,49.6,378,62.3,306,50.4,72,11.9,229,37.7
01,01,12,03,1086,100.0,565,52.0,681,62.7,521,48.0,160,14.7,405,37.3
01,01,12,04,7869,100.0,3719,47.3,5385,68.4,4150,52.7,1235,15.7,2484,31.6
01,01,13,01,6781,100.0,2844,41.9,4725,69.7,3937,58.1,788,11.6,2056,30.3
01,01,13,02,12677,100.0,4931,38.9,9291,73.3,7746,61.1,1545,12.2,3386,26.7
01,01,13,03,9898,100.0,4501,45.5,6582,66.5,5397,54.5,1185,12.0,3316,33.5
01,01,13,04,8666,100.0,3288,37.9,6561,75.7,5378,62.1,1183,13.7,2105,24.3
01,01,13,05,7833,100.0,2866,36.6,5911,75.5,4967,63.4,944,12.1,1922,24.5
01,01,13,06,10328,100.0,4340,42.0,7351,71.2,5988,58.0,1363,13.2,2977,28.8
01,01,14,01,17364,100.0,7155,41.2,12158,70.0,10209,58.8,1949,11.2,5206,30.0
01,01,14,02,13507,100.0,5148,38.1,9954,73.7,8359,61.9,1595,11.8,3553,26.3
01,02,21,01,3627,100.0,1933,53.3,2288,63.1,1694,46.7,594,16.4,1339,36.9
01,02,21,02,6517,100.0,3925,60.2,3799,58.3,2592,39.8,1207,18.5,2718,41.7
01,02,21,03,258,100.0,186,72.1,123,47.7,72,27.9,51,19.8,135,52.3
01,02,21,04,18820,100.0,9335,49.6,12741,67.7,9485,50.4,3256,17.3,6079,32.3
01,02,21,05,5354,100.0,3119,58.3,3367,62.9,2235,41.7,1132,21.1,1987,37.1
01,02,21,06,11463,100.0,3940,34.4,9190,80.2,7523,65.6,1667,14.5,2273,19.8
01,02,22,01,11020,100.0,5429,49.3,7657,69.5,5591,50.7,2066,18.7,3363,30.5
01,02,22,02,1618,100.0,1050,64.9,1082,66.9,568,35.1,514,31.8,536,33.1
01,02,22,03,7122,100.0,4234,59.4,4659,65.4,2888,40.6,1771,24.9,2463,34.6
01,02,22,04,6010,100.0,2519,41.9,4428,73.7,3491,58.1,937,15.6,1582,26.3
01,02,22,05,3329,100.0,2029,60.9,2244,67.4,1300,39.1,944,28.4,1085,32.6
01,02,22,06,3012,100.0,1214,40.3,2338,77.6,1798,59.7,540,17.9,674,22.4
01,02,22,07,5727,100.0,2563,44.8,3897,68.0,3164,55.2,733,12.8,1830,32.0
01,03,31,01,26808,100.0,16654,62.1,15875,59.2,10154,37.9,5721,21.3,10933,40.8
01,03,31,02,12120,100.0,7398,61.0,7418,61.2,4722,39.0,2696,22.2,4702,38.8
01,03,32,01,13477,100.0,8970,66.6,9340,69.3,4507,33.4,4833,35.9,4137,30.7
01,03,32,02,9789,100.0,5436,55.5,7176,73.3,4353,44.5,2823,28.8,2613,26.7
01,03,32,03,14473,100.0,9180,63.4,8693,60.1,5293,36.6,3400,23.5,5780,39.9
01,04,41,01,20920,100.0,10041,48.0,14448,69.1,10879,52.0,3569,17.1,6472,30.9
01,04,41,02,16420,100.0,6405,39.0,12581,76.6,10015,61.0,2566,15.6,3839,23.4
01,04,41,03,8676,100.0,4573,52.7,5476,63.1,4103,47.3,1373,15.8,3200,36.9
01,04,42,01,24302,100.0,16508,67.9,13662,56.2,7794,32.1,5868,24.1,10640,43.8
01,04,42,02,16926,100.0,9796,57.9,10072,59.5,7130,42.1,2942,17.4,6854,40.5
01,04,42,03,16657,100.0,9833,59.0,9994,60.0,6824,41.0,3170,19.0,6663,40.0
02,01,01,01,6647,100.0,4717,71.0,3787,57.0,1930,29.0,1857,27.9,2860,43.0
02,01,01,02,13433,100.0,9128,68.0,8978,66.8,4305,32.0,4673,34.8,4455,33.2
02,01,01,03,15380,100.0,10703,69.6,9956,64.7,4677,30.4,5279,34.3,5424,35.3
02,01,01,04,5015,100.0,3249,64.8,3363,67.1,1766,35.2,1597,31.8,1652,32.9
02,02,02,01,976,100.0,498,51.0,678,69.5,478,49.0,200,20.5,298,30.5
02,02,02,02,5998,100.0,2564,42.7,4333,72.2,3434,57.3,899,15.0,1665,27.8
02,02,02,03,10920,100.0,4215,38.6,8303,76.0,6705,61.4,1598,14.6,2617,24.0
02,02,02,04,12564,100.0,5258,41.8,9225,73.4,7306,58.2,1919,15.3,3339,26.6
02,02,02,05,15003,100.0,6053,40.3,11298,75.3,8950,59.7,2348,15.7,3705,24.7
02,02,02,06,19041,100.0,8669,45.5,13820,72.6,10372,54.5,3448,18.1,5221,27.4
02,03,03,01,9040,100.0,5679,62.8,5638,62.4,3361,37.2,2277,25.2,3402,37.6
02,03,03,02,13131,100.0,7062,53.8,8821,67.2,6069,46.2,2752,21.0,4310,32.8
02,03,04,01,15264,100.0,7390,48.4,10429,68.3,7874,51.6,2555,16.7,4835,31.7
02,03,04,02,11118,100.0,5548,49.9,7495,67.4,5570,50.1,1925,17.3,3623,32.6
02,04,05,01,5397,100.0,1361,25.2,4621,85.6,4036,74.8,585,10.8,776,14.4
02,04,05,02,7269,100.0,2002,27.5,5994,82.5,5267,72.5,727,10.0,1275,17.5
02,04,05,03,11101,100.0,2743,24.7,9303,83.8,8358,75.3,945,8.5,1798,16.2
02,04,07,01,12528,100.0,4752,37.9,9405,75.1,7776,62.1,1629,13.0,3123,24.9
02,04,07,02,10764,100.0,2686,25.0,8936,83.0,8078,75.0,858,8.0,1828,17.0
02,04,07,03,1170,100.0,800,68.4,473,40.4,370,31.6,103,8.8,697,59.6
02,05,06,01,8948,100.0,2643,29.5,7071,79.0,6305,70.5,766,8.6,1877,21.0
02,05,06,02,21484,100.0,6183,28.8,17189,80.0,15301,71.2,1888,8.8,4295,20.0
02,05,08,01,19292,100.0,6298,32.6,14683,76.1,12994,67.4,1689,8.8,4609,23.9
02,05,08,02,20813,100.0,6313,30.3,16174,77.7,14500,69.7,1674,8.0,4639,22.3
02,05,08,03,7208,100.0,2225,30.9,5649,78.4,4983,69.1,666,9.2,1559,21.6
02,05,08,04,4470,100.0,1015,22.7,3903,87.3,3455,77.3,448,10.0,567,12.7
03,01,01,01,4036,100.0,483,12.0,3709,91.9,3553,88.0,156,3.9,327,8.1
03,01,01,02,12319,100.0,2229,18.1,10558,85.7,10090,81.9,468,3.8,1761,14.3
03,01,01,04,229,100.0,52,22.7,199,86.9,177,77.3,22,9.6,30,13.1
03,02,02,03,2169,100.0,208,9.6,2035,93.8,1961,90.4,74,3.4,134,6.2
03,02,02,09,14963,100.0,2220,14.8,13629,91.1,12743,85.2,886,5.9,1334,8.9
03,02,02,10,11290,100.0,1479,13.1,10442,92.5,9811,86.9,631,5.6,848,7.5
03,02,03,07,18246,100.0,2204,12.1,17355,95.1,16042,87.9,1313,7.2,891,4.9
03,03,04,05,11426,100.0,1746,15.3,10406,91.1,9680,84.7,726,6.4,1020,8.9
03,03,04,06,8185,100.0,608,7.4,7910,96.6,7577,92.6,333,4.1,275,3.4
03,03,07,11,6855,100.0,404,5.9,6671,97.3,6451,94.1,220,3.2,184,2.7
03,03,07,15,7509,100.0,1287,17.1,6594,87.8,6222,82.9,372,5.0,915,12.2
03,03,07,16,1123,100.0,31,2.8,1107,98.6,1092,97.2,15,1.3,16,1.4
03,04,05,08,4611,100.0,902,19.6,4331,93.9,3709,80.4,622,13.5,280,6.1
03,04,05,12,9826,100.0,1388,14.1,9171,93.3,8438,85.9,733,7.5,655,6.7
03,04,05,13,3386,100.0,453,13.4,3165,93.5,2933,86.6,232,6.9,221,6.5
03,04,06,14,35951,100.0,4905,13.6,33203,92.4,31046,86.4,2157,6.0,2748,7.6
03,04,08,18,34461,100.0,5269,15.3,31019,90.0,29192,84.7,1827,5.3,3442,10.0
03,05,09,19,5583,100.0,1037,18.6,4749,85.1,4546,81.4,203,3.6,834,14.9
03,05,09,20,7383,100.0,990,13.4,6798,92.1,6393,86.6,405,5.5,585,7.9
03,05,09,23,9385,100.0,1845,19.7,8140,86.7,7540,80.3,600,6.4,1245,13.3
03,05,09,24,6091,100.0,1399,23.0,5081,83.4,4692,77.0,389,6.4,1010,16.6
03,05,09,25,9692,100.0,1657,17.1,8630,89.0,8035,82.9,595,6.1,1062,11.0
03,05,10,17,4236,100.0,794,18.7,3659,86.4,3442,81.3,217,5.1,577,13.6
03,05,10,21,6506,100.0,683,10.5,6026,92.6,5823,89.5,203,3.1,480,7.4
03,05,10,22,4561,100.0,319,7.0,4379,96.0,4242,93.0,137,3.0,182,4.0
03,06,11,26,15220,100.0,4078,26.8,12429,81.7,11142,73.2,1287,8.5,2791,18.3
03,06,11,31,10691,100.0,3490,32.6,8221,76.9,7201,67.4,1020,9.5,2470,23.1
03,06,12,27,14581,100.0,3591,24.6,12234,83.9,10990,75.4,1244,8.5,2347,16.1
03,06,12,28,12640,100.0,2758,21.8,10751,85.1,9882,78.2,869,6.9,1889,14.9
03,06,13,32,22670,100.0,6819,30.1,18140,80.0,15851,69.9,2289,10.1,4530,20.0
03,06,14,29,10058,100.0,1393,13.8,9166,91.1,8665,86.2,501,5.0,892,8.9
03,06,14,30,3871,100.0,1423,36.8,2654,68.6,2448,63.2,206,5.3,1217,31.4
03,06,14,34,6317,100.0,1541,24.4,5238,82.9,4776,75.6,462,7.3,1079,17.1
03,06,14,35,3898,100.0,1057,27.1,3185,81.7,2841,72.9,344,8.8,713,18.3
03,06,14,41,2589,100.0,668,25.8,2237,86.4,1921,74.2,316,12.2,352,13.6
03,07,15,36,10864,100.0,3808,35.1,8282,76.2,7056,64.9,1226,11.3,2582,23.8
03,07,15,37,15674,100.0,5224,33.3,12022,76.7,10450,66.7,1572,10.0,3652,23.3
03,07,16,33,3188,100.0,895,28.1,2599,81.5,2293,71.9,306,9.6,589,18.5
03,07,16,38,17526,100.0,5328,30.4,13974,79.7,12198,69.6,1776,10.1,3552,20.3
03,07,16,39,12480,100.0,3169,25.4,10480,84.0,9311,74.6,1169,9.4,2000,16.0
04,01,01,01,10656,100.0,4879,45.8,7881,74.0,5777,54.2,2104,19.7,2775,26.0
04,01,01,02,919,100.0,412,44.8,562,61.2,507,55.2,55,6.0,357,38.8
04,01,01,03,7876,100.0,4170,52.9,5819,73.9,3706,47.1,2113,26.8,2057,26.1
04,02,02,04,187,100.0,65,34.8,151,80.7,122,65.2,29,15.5,36,19.3
04,02,02,05,1347,100.0,355,26.4,1123,83.4,992,73.6,131,9.7,224,16.6
04,02,02,06,2800,100.0,695,24.8,2370,84.6,2105,75.2,265,9.5,430,15.4
04,02,02,07,2558,100.0,734,28.7,2136,83.5,1824,71.3,312,12.2,422,16.5
04,02,02,08,2912,100.0,771,26.5,2492,85.6,2141,73.5,351,12.1,420,14.4
04,02,02,09,3195,100.0,1218,38.1,2270,71.0,1977,61.9,293,9.2,925,29.0
04,02,03,10,624,100.0,331,53.0,350,56.1,293,47.0,57,9.1,274,43.9
04,02,03,11,14969,100.0,4767,31.8,12071,80.6,10202,68.2,1869,12.5,2898,19.4
04,02,03,12,5498,100.0,1710,31.1,4422,80.4,3788,68.9,634,11.5,1076,19.6
04,02,03,13,7620,100.0,3023,39.7,5664,74.3,4597,60.3,1067,14.0,1956,25.7
04,02,03,14,8,100.0,8,100.0,0,0.0,0,0.0,0,0.0,8,100.0
04,03,04,15,2975,100.0,1534,51.6,1824,61.3,1441,48.4,383,12.9,1151,38.7
04,03,04,16,10570,100.0,5061,47.9,7724,73.1,5509,52.1,2215,21.0,2846,26.9
04,03,04,17,10947,100.0,4159,38.0,8429,77.0,6788,62.0,1641,15.0,2518,23.0
04,03,05,18,9473,100.0,4165,44.0,6996,73.9,5308,56.0,1688,17.8,2477,26.1
04,03,05,19,5825,100.0,2588,44.4,4252,73.0,3237,55.6,1015,17.4,1573,27.0
04,03,06,20,8778,100.0,3852,43.9,6520,74.3,4926,56.1,1594,18.2,2258,25.7
04,03,06,21,3008,100.0,1664,55.3,1977,65.7,1344,44.7,633,21.0,1031,34.3
04,03,06,22,10709,100.0,4921,46.0,7820,73.0,5788,54.0,2032,19.0,2889,27.0
04,03,06,23,5012,100.0,2775,55.4,3403,67.9,2237,44.6,1166,23.3,1609,32.1
04,03,07,24,6569,100.0,2406,36.6,5101,77.7,4163,63.4,938,14.3,1468,22.3
04,03,07,25,12287,100.0,4976,40.5,9017,73.4,7311,59.5,1706,13.9,3270,26.6
04,03,07,26,5695,100.0,2505,44.0,4101,72.0,3190,56.0,911,16.0,1594,28.0
04,03,08,27,12360,100.0,6526,52.8,8081,65.4,5834,47.2,2247,18.2,4279,34.6
04,03,08,28,9595,100.0,4237,44.2,6847,71.4,5358,55.8,1489,15.5,2748,28.6
04,03,09,29,6079,100.0,2626,43.2,4423,72.8,3453,56.8,970,16.0,1656,27.2
04,03,09,30,5553,100.0,2440,43.9,4002,72.1,3113,56.1,889,16.0,1551,27.9
04,03,09,31,3791,100.0,2136,56.3,2320,61.2,1655,43.7,665,17.5,1471,38.8
04,03,10,32,15346,100.0,6245,40.7,11635,75.8,9101,59.3,2534,16.5,3711,24.2
04,04,11,33,40,100.0,9,22.5,34,85.0,31,77.5,3,7.5,6,15.0
04,04,11,34,5277,100.0,2072,39.3,4088,77.5,3205,60.7,883,16.7,1189,22.5
04,04,11,35,2792,100.0,953,34.1,2256,80.8,1839,65.9,417,14.9,536,19.2
04,04,11,36,3045,100.0,1004,33.0,2477,81.3,2041,67.0,436,14.3,568,18.7
04,04,11,37,8149,100.0,2990,36.7,6501,79.8,5159,63.3,1342,16.5,1648,20.2
04,04,12,38,6010,100.0,2018,33.6,5042,83.9,3992,66.4,1050,17.5,968,16.1
04,04,12,39,198,100.0,117,59.1,103,52.0,81,40.9,22,11.1,95,48.0
04,04,12,40,1512,100.0,400,26.5,1294,85.6,1112,73.5,182,12.0,218,14.4
04,04,12,41,7008,100.0,1671,23.8,6086,86.8,5337,76.2,749,10.7,922,13.2
04,04,13,42,4132,100.0,1347,32.6,3410,82.5,2785,67.4,625,15.1,722,17.5
04,04,13,43,3541,100.0,1049,29.6,3001,84.8,2492,70.4,509,14.4,540,15.2
04,04,13,44,10703,100.0,2841,26.5,9005,84.1,7862,73.5,1143,10.7,1698,15.9
04,05,14,45,6221,100.0,2583,41.5,4792,77.0,3638,58.5,1154,18.6,1429,23.0
04,05,14,46,10663,100.0,4469,41.9,8069,75.7,6194,58.1,1875,17.6,2594,24.3
04,05,14,47,5272,100.0,2115,40.1,4002,75.9,3157,59.9,845,16.0,1270,24.1
04,05,14,48,9241,100.0,4248,46.0,6528,70.6,4993,54.0,1535,16.6,2713,29.4
04,05,15,49,4678,100.0,2027,43.3,3352,71.7,2651,56.7,701,15.0,1326,28.3
04,05,15,50,5617,100.0,2266,40.3,4263,75.9,3351,59.7,912,16.2,1354,24.1
04,05,15,51,4470,100.0,1850,41.4,3410,76.3,2620,58.6,790,17.7,1060,23.7
04,05,16,52,9755,100.0,3719,38.1,7434,76.2,6036,61.9,1398,14.3,2321,23.8
04,05,16,53,6951,100.0,2859,41.1,5200,74.8,4092,58.9,1108,15.9,1751,25.2
04,05,16,54,3048,100.0,1081,35.5,2374,77.9,1967,64.5,407,13.4,674,22.1
04,05,16,55,7081,100.0,2962,41.8,5332,75.3,4119,58.2,1213,17.1,1749,24.7
04,05,16,56,7608,100.0,2394,31.5,6202,81.5,5214,68.5,988,13.0,1406,18.5
04,06,17,57,78,100.0,18,23.1,63,80.8,60,76.9,3,3.8,15,19.2
05,01,01,01,10901,100.0,3349,30.7,8954,82.1,7552,69.3,1402,12.9,1947,17.9
05,01,01,02,5999,100.0,1401,23.4,5155,85.9,4598,76.6,557,9.3,844,14.1
05,01,01,03,7716,100.0,1326,17.2,7096,92.0,6390,82.8,706,9.1,620,8.0
05,01,02,04,3605,100.0,1524,42.3,2755,76.4,2081,57.7,674,18.7,850,23.6
05,01,02,05,1926,100.0,538,27.9,1728,89.7,1388,72.1,340,17.7,198,10.3
05,01,02,06,10484,100.0,3914,37.3,8549,81.5,6570,62.7,1979,18.9,1935,18.5
05,01,02,07,11548,100.0,5734,49.7,9068,78.5,5814,50.3,3254,28.2,2480,21.5
05,01,02,08,7714,100.0,2580,33.4,6199,80.4,5134,66.6,1065,13.8,1515,19.6
05,01,02,09,6122,100.0,1848,30.2,5291,86.4,4274,69.8,1017,16.6,831,13.6
05,01,03,10,3931,100.0,1371,34.9,3136,79.8,2560,65.1,576,14.7,795,20.2
05,01,03,11,5658,100.0,2892,51.1,4188,74.0,2766,48.9,1422,25.1,1470,26.0
05,01,03,12,7212,100.0,3866,53.6,4433,61.5,3346,46.4,1087,15.1,2779,38.5
05,01,03,13,6772,100.0,2729,40.3,5106,75.4,4043,59.7,1063,15.7,1666,24.6
05,01,03,14,12281,100.0,4754,38.7,9566,77.9,7527,61.3,2039,16.6,2715,22.1
05,01,03,39,980,100.0,655,66.8,377,38.5,325,33.2,52,5.3,603,61.5
05,02,04,15,3889,100.0,774,19.9,3670,94.4,3115,80.1,555,14.3,219,5.6
05,02,04,16,1708,100.0,96,5.6,1684,98.6,1612,94.4,72,4.2,24,1.4
05,02,04,17,5936,100.0,1755,29.6,5059,85.2,4181,70.4,878,14.8,877,14.8
05,02,04,18,4123,100.0,814,19.7,3726,90.4,3309,80.3,417,10.1,397,9.6
05,02,04,19,7074,100.0,1809,25.6,6173,87.3,5265,74.4,908,12.8,901,12.7
05,02,04,20,981,100.0,187,19.1,887,90.4,794,80.9,93,9.5,94,9.6
05,02,05,21,3179,100.0,837,26.3,2882,90.7,2342,73.7,540,17.0,297,9.3
05,02,05,22,7416,100.0,3409,46.0,5238,70.6,4007,54.0,1231,16.6,2178,29.4
05,02,05,23,12660,100.0,7098,56.1,9066,71.6,5562,43.9,3504,27.7,3594,28.4
05,02,05,24,6254,100.0,1200,19.2,5719,91.4,5054,80.8,665,10.6,535,8.6
05,02,06,25,7621,100.0,2578,33.8,6166,80.9,5043,66.2,1123,14.7,1455,19.1
05,02,06,26,19239,100.0,6954,36.1,14676,76.3,12285,63.9,2391,12.4,4563,23.7
05,02,06,27,4349,100.0,1861,42.8,3207,73.7,2488,57.2,719,16.5,1142,26.3
05,02,06,28,2031,100.0,476,23.4,1810,89.1,1555,76.6,255,12.6,221,10.9
05,02,06,29,4484,100.0,690,15.4,4135,92.2,3794,84.6,341,7.6,349,7.8
05,03,07,30,4002,100.0,2133,53.3,3293,82.3,1869,46.7,1424,35.6,709,17.7
05,03,07,31,11725,100.0,4846,41.3,9443,80.5,6879,58.7,2564,21.9,2282,19.5
05,03,08,32,11928,100.0,5202,43.6,9016,75.6,6726,56.4,2290,19.2,2912,24.4
05,03,08,33,699,100.0,415,59.4,388,55.5,284,40.6,104,14.9,311,44.5
05,04,09,34,3732,100.0,1026,27.5,3041,81.5,2706,72.5,335,9.0,691,18.5
05,04,09,35,448,100.0,110,24.6,375,83.7,338,75.4,37,8.3,73,16.3
05,04,09,36,9962,100.0,1632,16.4,9433,94.7,8330,83.6,1103,11.1,529,5.3
05,04,09,37,2193,100.0,311,14.2,2086,95.1,1882,85.8,204,9.3,107,4.9
05,04,09,38,3661,100.0,497,13.6,3463,94.6,3164,86.4,299,8.2,198,5.4
06,01,01,01,6915,100.0,1674,24.2,6028,87.2,5241,75.8,787,11.4,887,12.8
06,01,01,02,8763,100.0,3039,34.7,7111,81.1,5724,65.3,1387,15.8,1652,18.9
06,01,01,03,6343,100.0,1916,30.2,5374,84.7,4427,69.8,947,14.9,969,15.3
06,01,02,04,6953,100.0,2254,32.4,5837,83.9,4699,67.6,1138,16.4,1116,16.1
06,01,02,05,9682,100.0,2871,29.7,8203,84.7,6811,70.3,1392,14.4,1479,15.3
06,01,02,06,7759,100.0,2138,27.6,6616,85.3,5621,72.4,995,12.8,1143,14.7
06,01,02,07,7798,100.0,2436,31.2,6519,83.6,5362,68.8,1157,14.8,1279,16.4
06,01,02,08,6746,100.0,1950,28.9,5719,84.8,4796,71.1,923,13.7,1027,15.2
06,01,02,09,9197,100.0,2892,31.4,7650,83.2,6305,68.6,1345,14.6,1547,16.8
06,01,02,10,4935,100.0,1342,27.2,4235,85.8,3593,72.8,642,13.0,700,14.2
06,02,03,01,5015,100.0,1062,21.2,4509,89.9,3953,78.8,556,11.1,506,10.1
06,02,03,02,5544,100.0,1282,23.1,4918,88.7,4262,76.9,656,11.8,626,11.3
06,02,03,03,7432,100.0,2113,28.4,6332,85.2,5319,71.6,1013,13.6,1100,14.8
06,02,03,04,6915,100.0,1874,27.1,5960,86.2,5041,72.9,919,13.3,955,13.8
06,02,03,05,11521,100.0,3727,32.3,9588,83.2,7794,67.7,1794,15.6,1933,16.8
06,02,03,06,6485,100.0,1204,18.6,5966,92.0,5281,81.4,685,10.6,519,8.0
06,02,04,07,4641,100.0,2231,48.1,3541,76.3,2410,51.9,1131,24.4,1100,23.7
06,02,04,08,6859,100.0,1781,26.0,5866,85.5,5078,74.0,788,11.5,993,14.5
06,02,04,09,8277,100.0,2015,24.3,7165,86.6,6262,75.7,903,10.9,1112,13.4
06,02,04,10,7141,100.0,1315,18.4,6382,89.4,5826,81.6,556,7.8,759,10.6
06,02,04,11,8586,100.0,2023,23.6,7676,89.4,6563,76.4,1113,13.0,910,10.6
06,03,05,01,5858,100.0,1335,22.8,4994,85.3,4523,77.2,471,8.0,864,14.7
06,03,05,02,5678,100.0,1319,23.2,4981,87.7,4359,76.8,622,11.0,697,12.3
06,03,05,03,11865,100.0,3206,27.0,10184,85.8,8659,73.0,1525,12.9,1681,14.2
06,03,05,04,11097,100.0,2320,20.9,9908,89.3,8777,79.1,1131,10.2,1189,10.7
06,03,06,05,6983,100.0,1908,27.3,5923,84.8,5075,72.7,848,12.1,1060,15.2
06,03,06,06,5270,100.0,1660,31.5,4332,82.2,3610,68.5,722,13.7,938,17.8
06,03,06,07,3004,100.0,1036,34.5,2297,76.5,1968,65.5,329,11.0,707,23.5
06,03,06,08,13583,100.0,3617,26.6,11821,87.0,9966,73.4,1855,13.7,1762,13.0
06,03,06,09,12101,100.0,2898,23.9,10514,86.9,9203,76.1,1311,10.8,1587,13.1
06,03,06,10,8397,100.0,1837,21.9,7376,87.8,6560,78.1,816,9.7,1021,12.2
06,04,07,01,10260,100.0,2145,20.9,9054,88.2,8115,79.1,939,9.2,1206,11.8
06,04,07,02,5501,100.0,1240,22.5,4880,88.7,4261,77.5,619,11.3,621,11.3
06,04,07,03,11152,100.0,3065,27.5,8999,80.7,8087,72.5,912,8.2,2153,19.3
06,04,08,04,7566,100.0,1316,17.4,6877,90.9,6250,82.6,627,8.3,689,9.1
06,04,08,05,5366,100.0,1109,20.7,4801,89.5,4257,79.3,544,10.1,565,10.5
06,04,08,06,7326,100.0,1129,15.4,6741,92.0,6197,84.6,544,7.4,585,8.0
06,04,08,07,5828,100.0,1281,22.0,5144,88.3,4547,78.0,597,10.2,684,11.7
06,04,08,08,4612,100.0,1720,37.3,3924,85.1,2892,62.7,1032,22.4,688,14.9
06,04,08,09,5080,100.0,1573,31.0,4061,79.9,3507,69.0,554,10.9,1019,20.1
06,04,08,10,7042,100.0,2039,29.0,5928,84.2,5003,71.0,925,13.1,1114,15.8
07,01,01,01,9964,100.0,4820,48.4,6988,70.1,5144,51.6,1844,18.5,2976,29.9
07,01,01,02,16505,100.0,9234,55.9,10721,65.0,7271,44.1,3450,20.9,5784,35.0
07,01,01,03,10489,100.0,3959,37.7,8077,77.0,6530,62.3,1547,14.7,2412,23.0
07,01,01,04,13682,100.0,7812,57.1,8915,65.2,5870,42.9,3045,22.3,4767,34.8
07,02,02,01,10608,100.0,3652,34.4,8620,81.3,6956,65.6,1664,15.7,1988,18.7
07,02,02,02,10264,100.0,4335,42.2,7667,74.7,5929,57.8,1738,16.9,2597,25.3
07,02,02,03,17935,100.0,7807,43.5,13340,74.4,10128,56.5,3212,17.9,4595,25.6
07,02,02,04,12032,100.0,4322,35.9,9467,78.7,7710,64.1,1757,14.6,2565,21.3
07,03,03,01,24768,100.0,6612,26.7,21123,85.3,18156,73.3,2967,12.0,3645,14.7
07,03,03,02,9446,100.0,2888,30.6,7912,83.8,6558,69.4,1354,14.3,1534,16.2
07,03,03,03,12430,100.0,5304,42.7,9692,78.0,7126,57.3,2566,20.6,2738,22.0
07,04,04,01,18077,100.0,6897,38.2,14464,80.0,11180,61.8,3284,18.2,3613,20.0
07,04,04,02,2356,100.0,502,21.3,2147,91.1,1854,78.7,293,12.4,209,8.9
07,04,04,03,24044,100.0,8695,36.2,19283,80.2,15349,63.8,3934,16.4,4761,19.8
07,04,04,04,5129,100.0,1300,25.3,4514,88.0,3829,74.7,685,13.4,615,12.0
07,04,04,05,10925,100.0,4504,41.2,8417,77.0,6421,58.8,1996,18.3,2508,23.0
07,04,04,06,4041,100.0,2229,55.2,2641,65.4,1812,44.8,829,20.5,1400,34.6
07,05,05,01,16367,100.0,6304,38.5,13130,80.2,10063,61.5,3067,18.7,3237,19.8
07,05,05,02,8262,100.0,3048,36.9,6525,79.0,5214,63.1,1311,15.9,1737,21.0
07,05,05,03,9180,100.0,2843,31.0,7790,84.9,6337,69.0,1453,15.8,1390,15.1
07,05,05,04,5632,100.0,1771,31.4,4831,85.8,3861,68.6,970,17.2,801,14.2
07,05,05,05,10663,100.0,2922,27.4,9337,87.6,7741,72.6,1596,15.0,1326,12.4
07,05,05,06,2275,100.0,526,23.1,2051,90.2,1749,76.9,302,13.3,224,9.8
07,06,06,01,10145,100.0,4042,39.8,7927,78.1,6103,60.2,1824,18.0,2218,21.9
07,06,06,02,4687,100.0,1036,22.1,4238,90.4,3651,77.9,587,12.5,449,9.6
07,06,06,03,3089,100.0,1266,41.0,2386,77.2,1823,59.0,563,18.2,703,22.8
07,06,06,04,14494,100.0,5261,36.3,12492,86.2,9233,63.7,3259,22.5,2002,13.8
07,07,07,01,10559,100.0,2150,20.4,9581,90.7,8409,79.6,1172,11.1,978,9.3
07,07,07,02,10835,100.0,2068,19.1,10043,92.7,8767,80.9,1276,11.8,792,7.3
07,07,07,03,7424,100.0,1767,23.8,6619,89.2,5657,76.2,962,13.0,805,10.8
07,07,07,04,8521,100.0,3240,38.0,6732,79.0,5281,62.0,1451,17.0,1789,21.0
07,07,07,05,7012,100.0,1162,16.6,6514,92.9,5850,83.4,664,9.5,498,7.1
07,07,07,06,3946,100.0,837,21.2,3423,86.7,3109,78.8,314,8.0,523,13.3
07,07,07,07,2953,100.0,465,15.7,2735,92.6,2488,84.3,247,8.4,218,7.4
08,01,01,15,860,100.0,365,42.4,620,72.1,495,57.6,125,14.5,240,27.9
08,01,01,16,3582,100.0,2002,55.9,2263,63.2,1580,44.1,683,19.1,1319,36.8
08,01,01,17,16152,100.0,8114,50.2,10691,66.2,8038,49.8,2653,16.4,5461,33.8
08,01,01,18,11895,100.0,7148,60.1,7488,63.0,4747,39.9,2741,23.0,4407,37.0
08,01,02,11,10007,100.0,5858,58.5,6044,60.4,4149,41.5,1895,18.9,3963,39.6
08,01,02,12,7441,100.0,4942,66.4,4952,66.6,2499,33.6,2453,33.0,2489,33.4
08,01,02,13,12673,100.0,6861,54.1,8222,64.9,5812,45.9,2410,19.0,4451,35.1
08,01,02,14,8041,100.0,4507,56.1,5169,64.3,3534,43.9,1635,20.3,2872,35.7
08,01,03,01,27832,100.0,13460,48.4,19122,68.7,14372,51.6,4750,17.1,8710,31.3
08,01,03,02,3734,100.0,1365,36.6,2925,78.3,2369,63.4,556,14.9,809,21.7
08,01,03,03,8555,100.0,5219,61.0,5074,59.3,3336,39.0,1738,20.3,3481,40.7
08,01,04,04,23936,100.0,12622,52.7,15582,65.1,11314,47.3,4268,17.8,8354,34.9
08,01,04,05,9048,100.0,4190,46.3,6240,69.0,4858,53.7,1382,15.3,2808,31.0
08,01,04,06,7172,100.0,4141,57.7,4462,62.2,3031,42.3,1431,20.0,2710,37.8
08,01,04,07,787,100.0,348,44.2,546,69.4,439,55.8,107,13.6,241,30.6
08,01,05,08,5653,100.0,3970,70.2,3792,67.1,1683,29.8,2109,37.3,1861,32.9
08,01,05,09,9532,100.0,6201,65.1,6736,70.7,3331,34.9,3405,35.7,2796,29.3
08,01,05,10,481,100.0,324,67.4,231,48.0,157,32.6,74,15.4,250,52.0
08,02,06,19,11006,100.0,5845,53.1,7557,68.7,5161,46.9,2396,21.8,3449,31.3
08,02,06,20,9266,100.0,4008,43.3,7321,79.0,5258,56.7,2063,22.3,1945,21.0
08,02,06,21,2324,100.0,579,24.9,2136,91.9,1745,75.1,391,16.8,188,8.1
08,02,06,22,14238,100.0,3904,27.4,12394,87.0,10334,72.6,2060,14.5,1844,13.0
08,02,06,23,1279,100.0,376,29.4,1116,87.3,903,70.6,213,16.7,163,12.7
08,02,06,24,1395,100.0,496,35.6,1223,87.7,899,64.4,324,23.2,172,12.3
08,02,06,25,3349,100.0,965,28.8,2835,84.7,2384,71.2,451,13.5,514,15.3
08,02,07,26,8356,100.0,2005,24.0,7495,89.7,6351,76.0,1144,13.7,861,10.3
08,02,07,27,11966,100.0,3516,29.4,10298,86.1,8450,70.6,1848,15.4,1668,13.9
08,02,07,28,8576,100.0,3453,40.3,6806,79.4,5123,59.7,1683,19.6,1770,20.6
08,03,08,29,12523,100.0,6180,49.3,9989,79.8,6343,50.7,3646,29.1,2534,20.2
08,03,08,30,7398,100.0,2890,39.1,6260,84.6,4508,60.9,1752,23.7,1138,15.4
08,03,08,31,17102,100.0,8385,49.0,13731,80.3,8717,51.0,5014,29.3,3371,19.7
08,04,09,32,2846,100.0,875,30.7,2497,87.7,1971,69.3,526,18.5,349,12.3
08,04,09,33,4202,100.0,1299,30.9,3627,86.3,2903,69.1,724,17.2,575,13.7
08,04,09,34,2678,100.0,808,30.2,2355,87.9,1870,69.8,485,18.1,323,12.1
08,04,10,35,8187,100.0,2528,30.9,7115,86.9,5659,69.1,1456,17.8,1072,13.1
08,04,10,36,6860,100.0,1532,22.3,6210,90.5,5328,77.7,882,12.9,650,9.5
08,04,10,37,9677,100.0,2338,24.2,8620,89.1,7339,75.8,1281,13.2,1057,10.9
08,04,10,38,6945,100.0,1542,22.2,6423,92.5,5403,77.8,1020,14.7,522,7.5
08,04,10,39,3863,100.0,1127,29.2,3499,90.6,2736,70.8,763,19.8,364,9.4
08,04,10,40,7970,100.0,1801,22.6,7276,91.3,6169,77.4,1107,13.9,694,8.7
09,01,01,01,12265,100.0,3647,29.7,10016,81.7,8618,70.3,1398,11.4,2249,18.3
09,01,01,02,73,100.0,19,26.0,63,86.3,54,74.0,9,12.3,10,13.7
09,01,02,01,4320,100.0,702,16.3,3942,91.3,3618,83.8,324,7.5,378,8.8
09,01,02,02,6851,100.0,956,14.0,6223,90.8,5895,86.0,328,4.8,628,9.2
09,01,03,01,15577,100.0,2144,13.8,14291,91.7,13433,86.2,858,5.5,1286,8.3
09,01,03,02,2927,100.0,634,21.7,2655,90.7,2293,78.3,362,12.4,272,9.3
09,01,04,01,8451,100.0,699,8.3,8055,95.3,7752,91.7,303,3.6,396,4.7
09,01,04,02,11454,100.0,1865,16.3,10334,90.2,9589,83.7,745,6.5,1120,9.8
09,02,05,01,6874,100.0,1766,25.7,5551,80.8,5108,74.3,443,6.4,1323,19.2
09,02,05,02,15422,100.0,2876,18.6,13499,87.5,12546,81.4,953,6.2,1923,12.5
09,02,06,01,8318,100.0,1898,22.8,6909,83.1,6420,77.2,489,5.9,1409,16.9
09,02,06,02,3543,100.0,212,6.0,3446,97.3,3331,94.0,115,3.2,97,2.7
09,02,07,01,2279,100.0,940,41.2,1514,66.4,1339,58.8,175,7.7,765,33.6
09,02,07,02,16446,100.0,2235,13.6,14875,90.4,14211,86.4,664,4.0,1571,9.6
09,02,08,01,2920,100.0,233,8.0,2774,95.0,2687,92.0,87,3.0,146,5.0
09,02,08,02,7861,100.0,1323,16.8,6940,88.3,6538,83.2,402,5.1,921,11.7
09,03,09,01,13241,100.0,1775,13.4,12356,93.3,11466,86.6,890,6.7,885,6.7
09,03,09,02,5745,100.0,685,11.9,5400,94.0,5060,88.1,340,5.9,345,6.0
09,03,09,03,8036,100.0,1345,16.7,7419,92.3,6691,83.3,728,9.1,617,7.7
09,03,10,01,12851,100.0,1442,11.2,11942,92.9,11409,88.8,533,4.1,909,7.1
09,03,11,01,6317,100.0,731,11.6,5789,91.6,5586,88.4,203,3.2,528,8.4
09,03,12,01,1822,100.0,155,8.5,1754,96.3,1667,91.5,87,4.8,68,3.7
09,03,12,02,2538,100.0,217,8.6,2417,95.2,2321,91.4,96,3.8,121,4.8
09,04,13,01,14556,100.0,1153,7.9,13760,94.5,13403,92.1,357,2.5,796,5.5
09,04,13,02,1891,100.0,177,9.4,1801,95.2,1714,90.6,87,4.6,90,4.8
09,04,14,01,4720,100.0,284,6.0,4570,96.8,4436,94.0,134,2.8,150,3.2
09,04,14,02,1498,100.0,162,10.8,1435,95.8,1336,89.2,99,6.6,63,4.2
09,04,15,01,7646,100.0,1259,16.5,6832,89.4,6387,83.5,445,5.8,814,10.6
09,04,16,01,6691,100.0,406,6.1,6511,97.3,6285,93.9,226,3.4,180,2.7
09,05,17,01,3716,100.0,301,8.1,3504,94.3,3415,91.9,89,2.4,212,5.7
09,05,17,02,14823,100.0,996,6.7,14312,96.6,13827,93.3,485,3.3,511,3.4
09,05,18,01,9499,100.0,823,8.7,8982,94.6,8676,91.3,306,3.2,517,5.4
09,05,19,01,11002,100.0,1083,9.8,10352,94.1,9919,90.2,433,3.9,650,5.9
09,05,20,01,12826,100.0,825,6.4,12364,96.4,12001,93.6,363,2.8,462,3.6
10,01,01,01,5706,100.0,1479,25.9,4944,86.6,4227,74.1,717,12.6,762,13.4
10,01,01,02,18425,100.0,4620,25.1,16246,88.2,13805,74.9,2441,13.2,2179,11.8
10,01,02,03,1590,100.0,1126,70.8,520,32.7,464,29.2,56,3.5,1070,67.3
10,01,02,04,10675,100.0,2381,22.3,9618,90.1,8294,77.7,1324,12.4,1057,9.9
10,01,02,05,8167,100.0,1170,14.3,7534,92.2,6997,85.7,537,6.6,633,7.8
10,01,02,06,17609,100.0,4174,23.7,15045,85.4,13435,76.3,1610,9.1,2564,14.6
10,01,02,07,10759,100.0,2398,22.3,9648,89.7,8361,77.7,1287,12.0,1111,10.3
10,01,03,08,2270,100.0,633,27.9,1839,81.0,1637,72.1,202,8.9,431,19.0
10,01,03,09,14391,100.0,2948,20.5,13178,91.6,11443,79.5,1735,12.1,1213,8.4
10,01,03,10,18267,100.0,3813,20.9,16381,89.7,14454,79.1,1927,10.5,1886,10.3
10,01,03,11,3266,100.0,414,12.7,3123,95.6,2852,87.3,271,8.3,143,4.4
10,02,04,12,6810,100.0,1924,28.3,5824,85.5,4886,71.7,938,13.8,986,14.5
10,02,04,13,15797,100.0,2967,18.8,13888,87.9,12830,81.2,1058,6.7,1909,12.1
10,02,04,14,1680,100.0,676,40.2,1442,85.8,1004,59.8,438,26.1,238,14.2
10,02,04,15,5694,100.0,1537,27.0,4558,80.0,4157,73.0,401,7.0,1136,20.0
10,02,04,16,5587,100.0,1427,25.5,4639,83.0,4160,74.5,479,8.6,948,17.0
10,02,05,17,9181,100.0,1200,13.1,8450,92.0,7981,86.9,469,5.1,731,8.0
10,02,05,18,5214,100.0,838,16.1,4674,89.6,4376,83.9,298,5.7,540,10.4
10,02,05,19,6180,100.0,1801,29.1,4896,79.2,4379,70.9,517,8.4,1284,20.8
10,02,06,20,3376,100.0,528,15.6,3123,92.5,2848,84.4,275,8.1,253,7.5
10,02,06,21,6224,100.0,1041,16.7,5592,89.8,5183,83.3,409,6.6,632,10.2
10,02,06,22,8668,100.0,1086,12.5,8159,94.1,7582,87.5,577,6.7,509,5.9
10,02,06,23,6538,100.0,687,10.5,6263,95.8,5851,89.5,412,6.3,275,4.2
10,03,07,24,7782,100.0,1195,15.4,6955,89.4,6587,84.6,368,4.7,827,10.6
10,03,07,25,6250,100.0,1146,18.3,5534,88.5,5104,81.7,430,6.9,716,11.5
10,03,07,26,3299,100.0,561,17.0,2935,89.0,2738,83.0,197,6.0,364,11.0
10,03,07,27,9425,100.0,861,9.1,9089,96.4,8564,90.9,525,5.6,336,3.6
10,04,08,28,7787,100.0,586,7.5,7506,96.4,7201,92.5,305,3.9,281,3.6
10,04,08,29,3846,100.0,317,8.2,3632,94.4,3529,91.8,103,2.7,214,5.6
10,04,08,30,7624,100.0,434,5.7,7442,97.6,7190,94.3,252,3.3,182,2.4
10,04,09,31,9565,100.0,695,7.3,9262,96.8,8870,92.7,392,4.1,303,3.2
10,04,09,32,4046,100.0,350,8.7,3864,95.5,3696,91.3,168,4.2,182,4.5
10,04,09,33,14986,100.0,878,5.9,14624,97.6,14108,94.1,516,3.4,362,2.4
11,01,01,01,603,100.0,56,9.3,570,94.5,547,90.7,23,3.8,33,5.5
11,01,01,02,2560,100.0,122,4.8,2515,98.2,2438,95.2,77,3.0,45,1.8
11,01,01,03,1557,100.0,369,23.7,1260,80.9,1188,76.3,72,4.6,297,19.1
11,01,02,04,8975,100.0,2496,27.8,7559,84.2,6479,72.2,1080,12.0,1416,15.8
11,01,02,05,6679,100.0,1706,25.5,5820,87.1,4973,74.5,847,12.7,859,12.9
11,01,02,06,6064,100.0,1283,21.2,5299,87.4,4781,78.8,518,8.5,765,12.6
11,01,02,07,7474,100.0,1694,22.7,6337,84.8,5780,77.3,557,7.5,1137,15.2
11,01,03,08,11789,100.0,3133,26.6,10035,85.1,8656,73.4,1379,11.7,1754,14.9
11,01,03,09,9740,100.0,2439,25.0,8279,85.0,7301,75.0,978,10.0,1461,15.0
11,01,03,10,5338,100.0,623,11.7,5028,94.2,4715,88.3,313,5.9,310,5.8
11,02,04,11,9414,100.0,2340,24.9,7701,81.8,7074,75.1,627,6.7,1713,18.2
11,02,04,12,6823,100.0,1342,19.7,5986,87.7,5481,80.3,505,7.4,837,12.3
11,02,05,13,3958,100.0,751,19.0,3336,84.3,3207,81.0,129,3.3,622,15.7
11,02,05,14,9444,100.0,2023,21.4,7860,83.2,7421,78.6,439,4.6,1584,16.8
11,02,05,15,14669,100.0,3373,23.0,12713,86.7,11296,77.0,1417,9.7,1956,13.3
11,02,05,16,3843,100.0,471,12.3,3625,94.3,3372,87.7,253,6.6,218,5.7
11,03,06,17,6252,100.0,2060,32.9,4919,78.7,4192,67.1,727,11.6,1333,21.3
11,03,06,18,16233,100.0,3948,24.3,13890,85.6,12285,75.7,1605,9.9,2343,14.4
11,03,06,19,10855,100.0,3152,29.0,8985,82.8,7703,71.0,1282,11.8,1870,17.2
11,03,07,20,5456,100.0,3319,60.8,2440,44.7,2137,39.2,303,5.6,3016,55.3
11,03,07,21,24712,100.0,6034,24.4,20484,82.9,18678,75.6,1806,7.3,4228,17.1
11,03,08,24,10063,100.0,3353,33.3,8042,79.9,6710,66.7,1332,13.2,2021,20.1
11,04,09,25,4138,100.0,902,21.8,3567,86.2,3236,78.2,331,8.0,571,13.8
11,04,09,26,28454,100.0,5526,19.4,24799,87.2,22928,80.6,1871,6.6,3655,12.8
11,04,10,22,5532,100.0,1768,32.0,4262,77.0,3764,68.0,498,9.0,1270,23.0
11,04,10,23,6544,100.0,1997,30.5,5423,82.9,4547,69.5,876,13.4,1121,17.1
11,04,10,27,2973,100.0,743,25.0,2507,84.3,2230,75.0,277,9.3,466,15.7
11,04,11,28,25140,100.0,5216,20.7,22034,87.6,19924,79.3,2110,8.4,3106,12.4
11,05,12,29,3766,100.0,641,17.0,3413,90.6,3125,83.0,288,7.6,353,9.4
11,05,13,30,9513,100.0,1677,17.6,8317,87.4,7836,82.4,481,5.1,1196,12.6
11,05,13,31,10788,100.0,1509,14.0,9840,91.2,9279,86.0,561,5.2,948,8.8
11,05,13,32,6897,100.0,787,11.4,6530,94.7,6110,88.6,420,6.1,367,5.3
12,10,31,15,7638,100.0,3152,41.3,5862,76.7,4486,58.7,1376,18.0,1776,23.3
12,10,31,16,9603,100.0,4308,44.9,7112,74.1,5295,55.1,1817,18.9,2491,25.9
12,10,31,17,10864,100.0,5548,51.1,7498,69.0,5316,48.9,2182,20.1,3366,31.0
12,10,32,18,13694,100.0,5744,41.9,10511,76.8,7950,58.1,2561,18.7,3183,23.2
12,10,32,19,8817,100.0,3725,42.2,6790,77.0,5092,57.8,1698,19.3,2027,23.0
12,10,32,20,4638,100.0,1270,27.4,3985,85.9,3368,72.6,617,13.3,653,14.1
12,21,41,25,7439,100.0,2163,29.1,6288,84.5,5276,70.9,1012,13.6,1151,15.5
12,21,41,26,8026,100.0,2930,36.5,6494,80.9,5096,63.5,1398,17.4,1532,19.1
12,21,44,21,2716,100.0,940,34.6,2142,78.9,1776,65.4,366,13.5,574,21.1
12,21,44,22,8238,100.0,4676,56.8,5597,67.9,3562,43.2,2035,24.7,2641,32.1
12,21,44,23,5657,100.0,2201,38.9,4582,81.0,3456,61.1,1126,19.9,1075,19.0
12,21,44,24,10828,100.0,5371,49.6,7520,69.4,5457,50.4,2063,19.1,3308,30.6
12,21,45,27,10829,100.0,2187,20.2,9628,88.9,8642,79.8,986,9.1,1201,11.1
12,21,45,28,263,100.0,93,35.4,207,78.7,170,64.6,37,14.1,56,21.3
12,22,42,29,6040,100.0,770,12.7,5740,95.0,5270,87.3,470,7.8,300,5.0
12,22,42,30,17951,100.0,2158,12.0,17080,95.1,15793,88.0,1287,7.2,871,4.9
12,23,11,01,16603,100.0,2118,12.8,15579,93.8,14485,87.2,1094,6.6,1024,6.2
12,23,11,02,16874,100.0,2067,12.2,16020,94.9,14807,87.8,1213,7.2,854,5.1
12,30,12,03,15054,100.0,4417,29.3,12274,81.5,10637,70.7,1637,10.9,2780,18.5
12,30,12,04,6246,100.0,1357,21.7,5608,89.8,4889,78.3,719,11.5,638,10.2
12,30,12,05,4958,100.0,865,17.4,4570,92.2,4093,82.6,477,9.6,388,7.8
12,30,12,06,5135,100.0,794,15.5,4866,94.8,4341,84.5,525,10.2,269,5.2
12,30,21,07,3063,100.0,1210,39.5,2568,83.8,1853,60.5,715,23.3,495,16.2
12,30,21,08,14499,100.0,5972,41.2,11710,80.8,8527,58.8,3183,22.0,2789,19.2
12,30,21,09,11653,100.0,5874,50.4,8731,74.9,5779,49.6,2952,25.3,2922,25.1
12,30,21,10,10539,100.0,5686,54.0,7631,72.4,4853,46.0,2778,26.4,2908,27.6
12,30,22,11,3315,100.0,855,25.8,2957,89.2,2460,74.2,497,15.0,358,10.8
12,30,22,12,5975,100.0,2714,45.4,4287,71.7,3261,54.6,1026,17.2,1688,28.3
12,30,43,13,6711,100.0,1504,22.4,5767,85.9,5207,77.6,560,8.3,944,14.1
12,30,43,14,9731,100.0,1314,13.5,9106,93.6,8417,86.5,689,7.1,625,6.4
