district_id,forecast_area_id,district_region_id,planning_area_id,inhabitants,inhabitants_percentage,inhabitants_with_migration_background,inhabitants_with_migration_background_percentage,inhabitants_germans,inhabitants_germans_percentage,inhabitants_germans_without_migration_background,inhabitants_germans_without_migration_background_percentage,inhabitants_germans_with_migration_background,inhabitants_germans_with_migration_background_percentage,inhabitants_foreigners,inhabitants_foreigners_percentage
01,01,11,01,3187,100.0,1841,57.8,1911,60.0,1346,42.2,565,17.7,1276,40.0
01,01,11,02,188,100.0,76,40.4,124,66.0,112,59.6,12,6.4,64,34.0
01,01,11,03,5192,100.0,2924,56.3,3358,64.7,2268,43.7,1090,21.0,1834,35.3
01,01,11,04,4685,100.0,3000,64.0,2892,61.7,1685,36.0,1207,25.8,1793,38.3
01,01,11,05,1180,100.0,707,59.9,688,58.3,473,40.1,215,18.2,492,41.7
01,01,12,01,2236,100.0,1212,54.2,1435,64.2,1024,45.8,411,18.4,801,35.8
01,01,12,02,620,100.0,300,48.4,385,62.1,320,51.6,65,10.5,235,37.9
01,01,12,03,1039,100.0,541,52.1,646,62.2,498,47.9,148,14.2,393,37.8
01,01,12,04,7707,100.0,3515,45.6,5381,69.8,4192,54.4,1189,15.4,2326,30.2
01,01,13,01,6611,100.0,2702,40.9,4671,70.7,3909,59.1,762,11.5,1940,29.3
01,01,13,02,12604,100.0,4780,37.9,9308,73.8,7824,62.1,1484,11.8,3296,26.2
01,01,13,03,9580,100.0,4252,44.4,6457,67.4,5328,55.6,1129,11.8,3123,32.6
01,01,13,04,8598,100.0,3140,36.5,6604,76.8,5458,63.5,1146,13.3,1994,23.2
01,01,13,05,7752,100.0,2744,35.4,5941,76.6,5008,64.6,933,12.0,1811,23.4
01,01,13,06,9983,100.0,4101,41.1,7178,71.9,5882,58.9,1296,13.0,2805,28.1
01,01,14,01,16720,100.0,6633,39.7,11919,71.3,10087,60.3,1832,11.0,4801,28.7
01,01,14,02,13423,100.0,5026,37.4,9954,74.2,8397,62.6,1557,11.6,3469,25.8
01,02,21,01,3577,100.0,1876,52.4,2294,64.1,1701,47.6,593,16.6,1283,35.9
01,02,21,02,6446,100.0,3801,59.0,3829,59.4,2645,41.0,1184,18.4,2617,40.6
01,02,21,03,252,100.0,180,71.4,124,49.2,72,28.6,52,20.6,128,50.8
01,02,21,04,18617,100.0,9065,48.7,12742,68.4,9552,51.3,3190,17.1,5875,31.6
01,02,21,05,5361,100.0,3097,57.8,3393,63.3,2264,42.2,1129,21.1,1968,36.7
01,02,21,06,11788,100.0,4222,35.8,9183,77.9,7566,64.2,1617,13.7,2605,22.1
01,02,22,01,11200,100.0,5572,49.8,7691,68.7,5628,50.3,2063,18.4,3509,31.3
01,02,22,02,1517,100.0,975,64.3,1017,67.0,542,35.7,475,31.3,500,33.0
01,02,22,03,7022,100.0,4102,58.4,4665,66.4,2920,41.6,1745,24.9,2357,33.6
01,02,22,04,5896,100.0,2397,40.7,4405,74.7,3499,59.3,906,15.4,1491,25.3
01,02,22,05,3296,100.0,1972,59.8,2273,69.0,1324,40.2,949,28.8,1023,31.0
01,02,22,06,3016,100.0,1198,39.7,2366,78.4,1818,60.3,548,18.2,650,21.6
01,02,22,07,5673,100.0,2497,44.0,3898,68.7,3176,56.0,722,12.7,1775,31.3
01,03,31,01,26804,100.0,16527,61.7,15882,59.3,10277,38.3,5605,20.9,10922,40.7
01,03,31,02,12061,100.0,7337,60.8,7374,61.1,4724,39.2,2650,22.0,4687,38.9
01,03,32,01,13275,100.0,8765,66.0,9244,69.6,4510,34.0,4734,35.7,4031,30.4
01,03,32,02,9766,100.0,5404,55.3,7155,73.3,4362,44.7,2793,28.6,2611,26.7
01,03,32,03,14478,100.0,9108,62.9,8783,60.7,5370,37.1,3413,23.6,5695,39.3
01,04,41,01,20653,100.0,9705,47.0,14427,69.9,10948,53.0,3479,16.8,6226,30.1
01,04,41,02,16322,100.0,6263,38.4,12561,77.0,10059,61.6,2502,15.3,3761,23.0
01,04,41,03,8575,100.0,4435,51.7,5489,64.0,4140,48.3,1349,15.7,3086,36.0
01,04,42,01,23791,100.0,16034,67.4,13531,56.9,7757,32.6,5774,24.3,10260,43.1
01,04,42,02,16719,100.0,9582,57.3,10021,59.9,7137,42.7,2884,17.2,6698,40.1
01,04,42,03,16534,100.0,9602,58.1,10064,60.9,6932,41.9,3132,18.9,6470,39.1
02,01,01,01,6291,100.0,4406,70.0,3655,58.1,1885,30.0,1770,28.1,2636,41.9
02,01,01,02,13323,100.0,8967,67.3,9009,67.6,4356,32.7,4653,34.9,4314,32.4
02,01,01,03,15477,100.0,10704,69.2,10024,64.8,4773,30.8,5251,33.9,5453,35.2
02,01,01,04,5068,100.0,3271,64.5,3419,67.5,1797,35.5,1622,32.0,1649,32.5
02,02,02,01,953,100.0,471,49.4,677,71.0,482,50.6,195,20.5,276,29.0
02,02,02,02,5939,100.0,2513,42.3,4299,72.4,3426,57.7,873,14.7,1640,27.6
02,02,02,03,10895,100.0,4137,38.0,8354,76.7,6758,62.0,1596,14.6,2541,23.3
02,02,02,04,12377,100.0,5091,41.1,9147,73.9,7286,58.9,1861,15.0,3230,26.1
02,02,02,05,14834,100.0,5795,39.1,11319,76.3,9039,60.9,2280,15.4,3515,23.7
02,02,02,06,18943,100.0,8472,44.7,13807,72.9,10471,55.3,3336,17.6,5136,27.1
02,03,03,01,9075,100.0,5651,62.3,5645,62.2,3424,37.7,2221,24.5,3430,37.8
02,03,03,02,13162,100.0,6963,52.9,8889,67.5,6199,47.1,2690,20.4,4273,32.5
02,03,04,01,15161,100.0,7205,47.5,10407,68.6,7956,52.5,2451,16.2,4754,31.4
02,03,04,02,11081,100.0,5445,49.1,7517,67.8,5636,50.9,1881,17.0,3564,32.2
02,04,05,01,5428,100.0,1345,24.8,4651,85.7,4083,75.2,568,10.5,777,14.3
02,04,05,02,7209,100.0,1884,26.1,6017,83.5,5325,73.9,692,9.6,1192,16.5
02,04,05,03,11003,100.0,2601,23.6,9271,84.3,8402,76.4,869,7.9,1732,15.7
02,04,07,01,12374,100.0,4483,36.2,9439,76.3,7891,63.8,1548,12.5,2935,23.7
02,04,07,02,10709,100.0,2506,23.4,9022,84.2,8203,76.6,819,7.6,1687,15.8
02,04,07,03,1165,100.0,788,67.6,479,41.1,377,32.4,102,8.8,686,58.9
02,05,06,01,8955,100.0,2579,28.8,7120,79.5,6376,71.2,744,8.3,1835,20.5
02,05,06,02,21272,100.0,5859,27.5,17177,80.7,15413,72.5,1764,8.3,4095,19.3
02,05,08,01,19214,100.0,6028,31.4,14800,77.0,13186,68.6,1614,8.4,4414,23.0
02,05,08,02,20487,100.0,5886,28.7,16148,78.8,14601,71.3,1547,7.6,4339,21.2
02,05,08,03,7142,100.0,2110,29.5,5668,79.4,5032,70.5,636,8.9,1474,20.6
02,05,08,04,4323,100.0,953,22.0,3776,87.3,3370,78.0,406,9.4,547,12.7
03,01,01,01,3971,100.0,463,11.7,3670,92.4,3508,88.3,162,4.1,301,7.6
03,01,01,02,11774,100.0,1594,13.5,10622,90.2,10180,86.5,442,3.8,1152,9.8
03,01,01,04,231,100.0,46,19.9,200,86.6,185,80.1,15,6.5,31,13.4
03,02,02,03,2086,100.0,91,4.4,2055,98.5,1995,95.6,60,2.9,31,1.5
03,02,02,09,14849,100.0,2094,14.1,13597,91.6,12755,85.9,842,5.7,1252,8.4
03,02,02,10,11157,100.0,1368,12.3,10389,93.1,9789,87.7,600,5.4,768,6.9
03,02,03,07,18157,100.0,2106,11.6,17331,95.5,16051,88.4,1280,7.0,826,4.5
03,03,04,05,11240,100.0,1591,14.2,10326,91.9,9649,85.8,677,6.0,914,8.1
03,03,04,06,8231,100.0,582,7.1,7962,96.7,7649,92.9,313,3.8,269,3.3
03,03,07,11,6825,100.0,379,5.6,6656,97.5,6446,94.4,210,3.1,169,2.5
03,03,07,15,7408,100.0,1212,16.4,6555,88.5,6196,83.6,359,4.8,853,11.5
03,03,07,16,1142,100.0,36,3.2,1120,98.1,1106,96.8,14,1.2,22,1.9
03,04,05,08,4597,100.0,887,19.3,4316,93.9,3710,80.7,606,13.2,281,6.1
03,04,05,12,9791,100.0,1300,13.3,9203,94.0,8491,86.7,712,7.3,588,6.0
03,04,05,13,3413,100.0,455,13.3,3189,93.4,2958,86.7,231,6.8,224,6.6
03,04,06,14,35544,100.0,4544,12.8,32961,92.7,31000,87.2,1961,5.5,2583,7.3
03,04,08,18,34281,100.0,4922,14.4,31057,90.6,29359,85.6,1698,5.0,3224,9.4
03,05,09,19,5451,100.0,938,17.2,4683,85.9,4513,82.8,170,3.1,768,14.1
03,05,09,20,7404,100.0,960,13.0,6831,92.3,6444,87.0,387,5.2,573,7.7
03,05,09,23,9227,100.0,1721,18.7,8059,87.3,7506,81.3,553,6.0,1168,12.7
03,05,09,24,5869,100.0,1206,20.5,4996,85.1,4663,79.5,333,5.7,873,14.9
03,05,09,25,9635,100.0,1543,16.0,8628,89.5,8092,84.0,536,5.6,1007,10.5
03,05,10,17,4244,100.0,781,18.4,3671,86.5,3463,81.6,208,4.9,573,13.5
03,05,10,21,6477,100.0,661,10.2,5998,92.6,5816,89.8,182,2.8,479,7.4
03,05,10,22,4536,100.0,285,6.3,4375,96.5,4251,93.7,124,2.7,161,3.5
03,06,11,26,15167,100.0,3962,26.1,12414,81.8,11205,73.9,1209,8.0,2753,18.2
03,06,11,31,10543,100.0,3346,31.7,8190,77.7,7197,68.3,993,9.4,2353,22.3
03,06,12,27,14534,100.0,3427,23.6,12246,84.3,11107,76.4,1139,7.8,2288,15.7
03,06,12,28,12592,100.0,2636,20.9,10793,85.7,9956,79.1,837,6.6,1799,14.3
03,06,13,32,22619,100.0,6557,29.0,18237,80.6,16062,71.0,2175,9.6,4382,19.4
03,06,14,29,10047,100.0,1336,13.3,9192,91.5,8711,86.7,481,4.8,855,8.5
03,06,14,30,3840,100.0,1372,35.7,2668,69.5,2468,64.3,200,5.2,1172,30.5
03,06,14,34,6301,100.0,1477,23.4,5286,83.9,4824,76.6,462,7.3,1015,16.1
03,06,14,35,3893,100.0,978,25.1,3215,82.6,2915,74.9,300,7.7,678,17.4
03,06,14,41,2545,100.0,619,24.3,2232,87.7,1926,75.7,306,12.0,313,12.3
03,07,15,36,10701,100.0,3616,33.8,8246,77.1,7085,66.2,1161,10.8,2455,22.9
03,07,15,37,15606,100.0,5124,32.8,12010,77.0,10482,67.2,1528,9.8,3596,23.0
03,07,16,33,3086,100.0,805,26.1,2570,83.3,2281,73.9,289,9.4,516,16.7
03,07,16,38,17336,100.0,5117,29.5,13922,80.3,12219,70.5,1703,9.8,3414,19.7
03,07,16,39,12382,100.0,3075,24.8,10408,84.1,9307,75.2,1101,8.9,1974,15.9
04,01,01,01,10598,100.0,4706,44.4,7939,74.9,5892,55.6,2047,19.3,2659,25.1
04,01,01,02,1055,100.0,513,48.6,591,56.0,542,51.4,49,4.6,464,44.0
04,01,01,03,7846,100.0,4074,51.9,5834,74.4,3772,48.1,2062,26.3,2012,25.6
04,02,02,04,179,100.0,64,35.8,138,77.1,115,64.2,23,12.8,41,22.9
04,02,02,05,1342,100.0,349,26.0,1133,84.4,993,74.0,140,10.4,209,15.6
04,02,02,06,2778,100.0,646,23.3,2396,86.2,2132,76.7,264,9.5,382,13.8
04,02,02,07,2553,100.0,711,27.8,2141,83.9,1842,72.2,299,11.7,412,16.1
04,02,02,08,2916,100.0,752,25.8,2502,85.8,2164,74.2,338,11.6,414,14.2
04,02,02,09,3207,100.0,1178,36.7,2318,72.3,2029,63.3,289,9.0,889,27.7
04,02,03,10,621,100.0,318,51.2,353,56.8,303,48.8,50,8.1,268,43.2
04,02,03,11,14848,100.0,4609,31.0,12042,81.1,10239,69.0,1803,12.1,2806,18.9
04,02,03,12,5516,100.0,1717,31.1,4431,80.3,3799,68.9,632,11.5,1085,19.7
04,02,03,13,7596,100.0,3001,39.5,5634,74.2,4595,60.5,1039,13.7,1962,25.8
04,02,03,14,329,100.0,329,100.0,3,0.9,0,0.0,3,0.9,326,99.1
04,03,04,15,2932,100.0,1491,50.9,1813,61.8,1441,49.1,372,12.7,1119,38.2
04,03,04,16,10670,100.0,5121,48.0,7708,72.2,5549,52.0,2159,20.2,2962,27.8
04,03,04,17,10950,100.0,4068,37.2,8476,77.4,6882,62.8,1594,14.6,2474,22.6
04,03,05,18,9411,100.0,4052,43.1,6979,74.2,5359,56.9,1620,17.2,2432,25.8
04,03,05,19,5759,100.0,2530,43.9,4238,73.6,3229,56.1,1009,17.5,1521,26.4
04,03,06,20,8714,100.0,3772,43.3,6511,74.7,4942,56.7,1569,18.0,2203,25.3
04,03,06,21,3029,100.0,1637,54.0,2008,66.3,1392,46.0,616,20.3,1021,33.7
04,03,06,22,10588,100.0,4835,45.7,7732,73.0,5753,54.3,1979,18.7,2856,27.0
04,03,06,23,4890,100.0,2688,55.0,3332,68.1,2202,45.0,1130,23.1,1558,31.9
04,03,07,24,6509,100.0,2344,36.0,5071,77.9,4165,64.0,906,13.9,1438,22.1
04,03,07,25,12258,100.0,4852,39.6,9045,73.8,7406,60.4,1639,13.4,3213,26.2
04,03,07,26,5560,100.0,2360,42.4,4109,73.9,3200,57.6,909,16.3,1451,26.1
04,03,08,27,12311,100.0,6459,52.5,8052,65.4,5852,47.5,2200,17.9,4259,34.6
04,03,08,28,9577,100.0,4187,43.7,6859,71.6,5390,56.3,1469,15.3,2718,28.4
04,03,09,29,6027,100.0,2571,42.7,4388,72.8,3456,57.3,932,15.5,1639,27.2
04,03,09,30,5619,100.0,2472,44.0,4026,71.6,3147,56.0,879,15.6,1593,28.4
04,03,09,31,4014,100.0,2349,58.5,2331,58.1,1665,41.5,666,16.6,1683,41.9
04,03,10,32,15076,100.0,6032,40.0,11530,76.5,9044,60.0,2486,16.5,3546,23.5
04,04,11,33,39,100.0,12,30.8,36,92.3,27,69.2,9,23.1,3,7.7
04,04,11,34,5235,100.0,2032,38.8,4072,77.8,3203,61.2,869,16.6,1163,22.2
04,04,11,35,2762,100.0,908,32.9,2251,81.5,1854,67.1,397,14.4,511,18.5
04,04,11,36,3038,100.0,979,32.2,2480,81.6,2059,67.8,421,13.9,558,18.4
04,04,11,37,8053,100.0,2826,35.1,6508,80.8,5227,64.9,1281,15.9,1545,19.2
04,04,12,38,5972,100.0,1940,32.5,5015,84.0,4032,67.5,983,16.5,957,16.0
04,04,12,39,195,100.0,101,51.8,116,59.5,94,48.2,22,11.3,79,40.5
04,04,12,40,1511,100.0,385,25.5,1311,86.8,1126,74.5,185,12.2,200,13.2
04,04,12,41,6976,100.0,1630,23.4,6083,87.2,5346,76.6,737,10.6,893,12.8
04,04,13,42,4132,100.0,1313,31.8,3409,82.5,2819,68.2,590,14.3,723,17.5
04,04,13,43,3524,100.0,1043,29.6,2977,84.5,2481,70.4,496,14.1,547,15.5
04,04,13,44,10683,100.0,2780,26.0,9019,84.4,7903,74.0,1116,10.4,1664,15.6
04,05,14,45,6279,100.0,2585,41.2,4830,76.9,3694,58.8,1136,18.1,1449,23.1
04,05,14,46,10630,100.0,4427,41.6,8065,75.9,6203,58.4,1862,17.5,2565,24.1
04,05,14,47,5268,100.0,2083,39.5,4001,75.9,3185,60.5,816,15.5,1267,24.1
04,05,14,48,9146,100.0,4122,45.1,6540,71.5,5024,54.9,1516,16.6,2606,28.5
04,05,15,49,5312,100.0,2651,49.9,3371,63.5,2661,50.1,710,13.4,1941,36.5
04,05,15,50,5569,100.0,2159,38.8,4291,77.1,3410,61.2,881,15.8,1278,22.9
04,05,15,51,4444,100.0,1808,40.7,3388,76.2,2636,59.3,752,16.9,1056,23.8
04,05,16,52,9736,100.0,3651,37.5,7441,76.4,6085,62.5,1356,13.9,2295,23.6
04,05,16,53,6851,100.0,2770,40.4,5161,75.3,4081,59.6,1080,15.8,1690,24.7
04,05,16,54,3035,100.0,1078,35.5,2379,78.4,1957,64.5,422,13.9,656,21.6
04,05,16,55,7016,100.0,2901,41.3,5296,75.5,4115,58.7,1181,16.8,1720,24.5
04,05,16,56,7648,100.0,2376,31.1,6237,81.6,5272,68.9,965,12.6,1411,18.4
04,06,17,57,73,100.0,19,26.0,57,78.1,54,74.0,3,4.1,16,21.9
05,01,01,01,10826,100.0,3255,30.1,8937,82.6,7571,69.9,1366,12.6,1889,17.4
05,01,01,02,5915,100.0,1303,22.0,5149,87.0,4612,78.0,537,9.1,766,13.0
05,01,01,03,7654,100.0,1255,16.4,7058,92.2,6399,83.6,659,8.6,596,7.8
05,01,02,04,3339,100.0,1270,38.0,2731,81.8,2069,62.0,662,19.8,608,18.2
05,01,02,05,1925,100.0,523,27.2,1731,89.9,1402,72.8,329,17.1,194,10.1
05,01,02,06,10395,100.0,3705,35.6,8608,82.8,6690,64.4,1918,18.5,1787,17.2
05,01,02,07,11508,100.0,5642,49.0,9064,78.8,5866,51.0,3198,27.8,2444,21.2
05,01,02,08,7675,100.0,2470,32.2,6251,81.4,5205,67.8,1046,13.6,1424,18.6
05,01,02,09,6102,100.0,1769,29.0,5314,87.1,4333,71.0,981,16.1,788,12.9
05,01,03,10,3927,100.0,1329,33.8,3149,80.2,2598,66.2,551,14.0,778,19.8
05,01,03,11,5655,100.0,2876,50.9,4165,73.7,2779,49.1,1386,24.5,1490,26.3
05,01,03,12,7147,100.0,3715,52.0,4546,63.6,3432,48.0,1114,15.6,2601,36.4
05,01,03,13,6734,100.0,2611,38.8,5144,76.4,4123,61.2,1021,15.2,1590,23.6
05,01,03,14,12098,100.0,4507,37.3,9609,79.4,7591,62.7,2018,16.7,2489,20.6
05,01,03,39,1014,100.0,685,67.6,388,38.3,329,32.4,59,5.8,626,61.7
05,02,04,15,3906,100.0,736,18.8,3707,94.9,3170,81.2,537,13.7,199,5.1
05,02,04,16,1710,100.0,94,5.5,1677,98.1,1616,94.5,61,3.6,33,1.9
05,02,04,17,5930,100.0,1716,28.9,5053,85.2,4214,71.1,839,14.1,877,14.8
05,02,04,18,4066,100.0,760,18.7,3707,91.2,3306,81.3,401,9.9,359,8.8
05,02,04,19,7051,100.0,1723,24.4,6205,88.0,5328,75.6,877,12.4,846,12.0
05,02,04,20,949,100.0,172,18.1,885,93.3,777,81.9,108,11.4,64,6.7
05,02,05,21,3174,100.0,828,26.1,2880,90.7,2346,73.9,534,16.8,294,9.3
05,02,05,22,7412,100.0,3306,44.6,5327,71.9,4106,55.4,1221,16.5,2085,28.1
05,02,05,23,12513,100.0,6862,54.8,9152,73.1,5651,45.2,3501,28.0,3361,26.9
05,02,05,24,6122,100.0,1063,17.4,5650,92.3,5059,82.6,591,9.7,472,7.7
05,02,06,25,7545,100.0,2439,32.3,6202,82.2,5106,67.7,1096,14.5,1343,17.8
05,02,06,26,19249,100.0,6879,35.7,14700,76.4,12370,64.3,2330,12.1,4549,23.6
05,02,06,27,4226,100.0,1697,40.2,3242,76.7,2529,59.8,713,16.9,984,23.3
05,02,06,28,1999,100.0,443,22.2,1794,89.7,1556,77.8,238,11.9,205,10.3
05,02,06,29,4450,100.0,653,14.7,4117,92.5,3797,85.3,320,7.2,333,7.5
05,03,07,30,3983,100.0,2104,52.8,3281,82.4,1879,47.2,1402,35.2,702,17.6
05,03,07,31,11697,100.0,4777,40.8,9459,80.9,6920,59.2,2539,21.7,2238,19.1
05,03,08,32,11796,100.0,5051,42.8,8947,75.8,6745,57.2,2202,18.7,2849,24.2
05,03,08,33,1331,100.0,1045,78.5,394,29.6,286,21.5,108,8.1,937,70.4
05,04,09,34,3782,100.0,1069,28.3,3016,79.7,2713,71.7,303,8.0,766,20.3
05,04,09,35,435,100.0,104,23.9,368,84.6,331,76.1,37,8.5,67,15.4
05,04,09,36,9918,100.0,1585,16.0,9374,94.5,8333,84.0,1041,10.5,544,5.5
05,04,09,37,2159,100.0,301,13.9,2049,94.9,1858,86.1,191,8.8,110,5.1
05,04,09,38,3681,100.0,490,13.3,3481,94.6,3191,86.7,290,7.9,200,5.4
06,01,01,01,6859,100.0,1604,23.4,6006,87.6,5255,76.6,751,10.9,853,12.4
06,01,01,02,8764,100.0,2982,34.0,7111,81.1,5782,66.0,1329,15.2,1653,18.9
06,01,01,03,6365,100.0,1885,29.6,5396,84.8,4480,70.4,916,14.4,969,15.2
06,01,02,04,6930,100.0,2213,31.9,5841,84.3,4717,68.1,1124,16.2,1089,15.7
06,01,02,05,9613,100.0,2735,28.5,8244,85.8,6878,71.5,1366,14.2,1369,14.2
06,01,02,06,7686,100.0,2105,27.4,6559,85.3,5581,72.6,978,12.7,1127,14.7
06,01,02,07,7819,100.0,2393,30.6,6566,84.0,5426,69.4,1140,14.6,1253,16.0
06,01,02,08,6715,100.0,1907,28.4,5715,85.1,4808,71.6,907,13.5,1000,14.9
06,01,02,09,9150,100.0,2807,30.7,7657,83.7,6343,69.3,1314,14.4,1493,16.3
06,01,02,10,4923,100.0,1313,26.7,4223,85.8,3610,73.3,613,12.5,700,14.2
06,02,03,01,5004,100.0,1058,21.1,4507,90.1,3946,78.9,561,11.2,497,9.9
06,02,03,02,5524,100.0,1254,22.7,4914,89.0,4270,77.3,644,11.7,610,11.0
06,02,03,03,7405,100.0,2041,27.6,6359,85.9,5364,72.4,995,13.4,1046,14.1
06,02,03,04,6743,100.0,1770,26.2,5840,86.6,4973,73.8,867,12.9,903,13.4
06,02,03,05,11666,100.0,3825,32.8,9588,82.2,7841,67.2,1747,15.0,2078,17.8
06,02,03,06,6455,100.0,1182,18.3,5963,92.4,5273,81.7,690,10.7,492,7.6
06,02,04,07,4606,100.0,2151,46.7,3543,76.9,2455,53.3,1088,23.6,1063,23.1
06,02,04,08,6864,100.0,1761,25.7,5863,85.4,5103,74.3,760,11.1,1001,14.6
06,02,04,09,8251,100.0,2023,24.5,7133,86.5,6228,75.5,905,11.0,1118,13.5
06,02,04,10,7075,100.0,1255,17.7,6380,90.2,5820,82.3,560,7.9,695,9.8
06,02,04,11,8546,100.0,1930,22.6,7679,89.9,6616,77.4,1063,12.4,867,10.1
06,03,05,01,5834,100.0,1324,22.7,4956,85.0,4510,77.3,446,7.6,878,15.0
06,03,05,02,5649,100.0,1265,22.4,4968,87.9,4384,77.6,584,10.3,681,12.1
06,03,05,03,11720,100.0,3094,26.4,10122,86.4,8626,73.6,1496,12.8,1598,13.6
06,03,05,04,11042,100.0,2249,20.4,9880,89.5,8793,79.6,1087,9.8,1162,10.5
06,03,06,05,6913,100.0,1823,26.4,5896,85.3,5090,73.6,806,11.7,1017,14.7
06,03,06,06,5232,100.0,1634,31.2,4313,82.4,3598,68.8,715,13.7,919,17.6
06,03,06,07,2968,100.0,977,32.9,2317,78.1,1991,67.1,326,11.0,651,21.9
06,03,06,08,13364,100.0,3408,25.5,11730,87.8,9956,74.5,1774,13.3,1634,12.2
06,03,06,09,12105,100.0,2815,23.3,10562,87.3,9290,76.7,1272,10.5,1543,12.7
06,03,06,10,8329,100.0,1756,21.1,7363,88.4,6573,78.9,790,9.5,966,11.6
06,04,07,01,10200,100.0,2122,20.8,9005,88.3,8078,79.2,927,9.1,1195,11.7
06,04,07,02,5301,100.0,1012,19.1,4871,91.9,4289,80.9,582,11.0,430,8.1
06,04,07,03,11013,100.0,2919,26.5,8954,81.3,8094,73.5,860,7.8,2059,18.7
06,04,08,04,7576,100.0,1275,16.8,6904,91.1,6301,83.2,603,8.0,672,8.9
06,04,08,05,5405,100.0,1135,21.0,4831,89.4,4270,79.0,561,10.4,574,10.6
06,04,08,06,7283,100.0,1086,14.9,6713,92.2,6197,85.1,516,7.1,570,7.8
06,04,08,07,5753,100.0,1217,21.2,5111,88.8,4536,78.8,575,10.0,642,11.2
06,04,08,08,4594,100.0,1708,37.2,3912,85.2,2886,62.8,1026,22.3,682,14.8
06,04,08,09,5120,100.0,1627,31.8,4029,78.7,3493,68.2,536,10.5,1091,21.3
06,04,08,10,7066,100.0,2006,28.4,5933,84.0,5060,71.6,873,12.4,1133,16.0
07,01,01,01,10163,100.0,4931,48.5,7018,69.1,5232,51.5,1786,17.6,3145,30.9
07,01,01,02,16427,100.0,9074,55.2,10740,65.4,7353,44.8,3387,20.6,5687,34.6
07,01,01,03,10427,100.0,3855,37.0,8101,77.7,6572,63.0,1529,14.7,2326,22.3
07,01,01,04,13722,100.0,7818,57.0,8909,64.9,5904,43.0,3005,21.9,4813,35.1
07,02,02,01,10522,100.0,3552,33.8,8562,81.4,6970,66.2,1592,15.1,1960,18.6
07,02,02,02,10214,100.0,4255,41.7,7659,75.0,5959,58.3,1700,16.6,2555,25.0
07,02,02,03,17892,100.0,7660,42.8,13361,74.7,10232,57.2,3129,17.5,4531,25.3
07,02,02,04,11867,100.0,4168,35.1,9391,79.1,7699,64.9,1692,14.3,2476,20.9
07,03,03,01,24781,100.0,6551,26.4,21144,85.3,18230,73.6,2914,11.8,3637,14.7
07,03,03,02,9333,100.0,2813,30.1,7850,84.1,6520,69.9,1330,14.3,1483,15.9
07,03,03,03,12400,100.0,5214,42.0,9716,78.4,7186,58.0,2530,20.4,2684,21.6
07,04,04,01,18153,100.0,6927,38.2,14478,79.8,11226,61.8,3252,17.9,3675,20.2
07,04,04,02,2338,100.0,472,20.2,2147,91.8,1866,79.8,281,12.0,191,8.2
07,04,04,03,23954,100.0,8509,35.5,19293,80.5,15445,64.5,3848,16.1,4661,19.5
07,04,04,04,5112,100.0,1260,24.6,4501,88.0,3852,75.4,649,12.7,611,12.0
07,04,04,05,11000,100.0,4513,41.0,8464,76.9,6487,59.0,1977,18.0,2536,23.1
07,04,04,06,4040,100.0,2162,53.5,2686,66.5,1878,46.5,808,20.0,1354,33.5
07,05,05,01,16131,100.0,6061,37.6,13051,80.9,10070,62.4,2981,18.5,3080,19.1
07,05,05,02,8240,100.0,3007,36.5,6499,78.9,5233,63.5,1266,15.4,1741,21.1
07,05,05,03,9176,100.0,2762,30.1,7822,85.2,6414,69.9,1408,15.3,1354,14.8
07,05,05,04,5602,100.0,1721,30.7,4845,86.5,3881,69.3,964,17.2,757,13.5
07,05,05,05,10628,100.0,2820,26.5,9379,88.2,7808,73.5,1571,14.8,1249,11.8
07,05,05,06,2272,100.0,537,23.6,2027,89.2,1735,76.4,292,12.9,245,10.8
07,06,06,01,10174,100.0,3990,39.2,7990,78.5,6184,60.8,1806,17.8,2184,21.5
07,06,06,02,4703,100.0,1045,22.2,4242,90.2,3658,77.8,584,12.4,461,9.8
07,06,06,03,3208,100.0,1371,42.7,2388,74.4,1837,57.3,551,17.2,820,25.6
07,06,06,04,14349,100.0,5089,35.5,12430,86.6,9260,64.5,3170,22.1,1919,13.4
07,07,07,01,10571,100.0,2106,19.9,9620,91.0,8465,80.1,1155,10.9,951,9.0
07,07,07,02,10822,100.0,1978,18.3,10085,93.2,8844,81.7,1241,11.5,737,6.8
07,07,07,03,7351,100.0,1708,23.2,6583,89.6,5643,76.8,940,12.8,768,10.4
07,07,07,04,8463,100.0,3098,36.6,6843,80.9,5365,63.4,1478,17.5,1620,19.1
07,07,07,05,7033,100.0,1120,15.9,6553,93.2,5913,84.1,640,9.1,480,6.8
07,07,07,06,3904,100.0,770,19.7,3404,87.2,3134,80.3,270,6.9,500,12.8
07,07,07,07,2955,100.0,455,15.4,2716,91.9,2500,84.6,216,7.3,239,8.1
08,01,01,15,880,100.0,365,41.5,634,72.0,515,58.5,119,13.5,246,28.0
08,01,01,16,3573,100.0,2002,56.0,2250,63.0,1571,44.0,679,19.0,1323,37.0
08,01,01,17,16067,100.0,7930,49.4,10701,66.6,8137,50.6,2564,16.0,5366,33.4
08,01,01,18,11833,100.0,7002,59.2,7511,63.5,4831,40.8,2680,22.6,4322,36.5
08,01,02,11,9981,100.0,5793,58.0,6056,60.7,4188,42.0,1868,18.7,3925,39.3
08,01,02,12,7437,100.0,4894,65.8,4957,66.7,2543,34.2,2414,32.5,2480,33.3
08,01,02,13,12669,100.0,6785,53.6,8225,64.9,5884,46.4,2341,18.5,4444,35.1
08,01,02,14,8043,100.0,4457,55.4,5212,64.8,3586,44.6,1626,20.2,2831,35.2
08,01,03,01,27811,100.0,13227,47.6,19237,69.2,14584,52.4,4653,16.7,8574,30.8
08,01,03,02,3709,100.0,1301,35.1,2921,78.8,2408,64.9,513,13.8,788,21.2
08,01,03,03,8580,100.0,5243,61.1,5055,58.9,3337,38.9,1718,20.0,3525,41.1
08,01,04,04,23888,100.0,12649,53.0,15451,64.7,11239,47.0,4212,17.6,8437,35.3
08,01,04,05,9086,100.0,4222,46.5,6226,68.5,4864,53.5,1362,15.0,2860,31.5
08,01,04,06,7159,100.0,4090,57.1,4479,62.6,3069,42.9,1410,19.7,2680,37.4
08,01,04,07,804,100.0,347,43.2,572,71.1,457,56.8,115,14.3,232,28.9
08,01,05,08,5653,100.0,3957,70.0,3791,67.1,1696,30.0,2095,37.1,1862,32.9
08,01,05,09,9553,100.0,6179,64.7,6748,70.6,3374,35.3,3374,35.3,2805,29.4
08,01,05,10,480,100.0,334,69.6,215,44.8,146,30.4,69,14.4,265,55.2
08,02,06,19,11002,100.0,5791,52.6,7573,68.8,5211,47.4,2362,21.5,3429,31.2
08,02,06,20,9298,100.0,3939,42.4,7375,79.3,5359,57.6,2016,21.7,1923,20.7
08,02,06,21,2309,100.0,563,24.4,2116,91.6,1746,75.6,370,16.0,193,8.4
08,02,06,22,14205,100.0,3793,26.7,12426,87.5,10412,73.3,2014,14.2,1779,12.5
08,02,06,23,1274,100.0,362,28.4,1112,87.3,912,71.6,200,15.7,162,12.7
08,02,06,24,1314,100.0,424,32.3,1154,87.8,890,67.7,264,20.1,160,12.2
08,02,06,25,3377,100.0,957,28.3,2868,84.9,2420,71.7,448,13.3,509,15.1
08,02,07,26,8346,100.0,1926,23.1,7515,90.0,6420,76.9,1095,13.1,831,10.0
08,02,07,27,11959,100.0,3399,28.4,10351,86.6,8560,71.6,1791,15.0,1608,13.4
08,02,07,28,8564,100.0,3382,39.5,6833,79.8,5182,60.5,1651,19.3,1731,20.2
08,03,08,29,12494,100.0,6076,48.6,10046,80.4,6418,51.4,3628,29.0,2448,19.6
08,03,08,30,7387,100.0,2831,38.3,6282,85.0,4556,61.7,1726,23.4,1105,15.0
08,03,08,31,16999,100.0,8150,47.9,13735,80.8,8849,52.1,4886,28.7,3264,19.2
08,04,09,32,2857,100.0,860,30.1,2516,88.1,1997,69.9,519,18.2,341,11.9
08,04,09,33,4151,100.0,1248,30.1,3604,86.8,2903,69.9,701,16.9,547,13.2
08,04,09,34,2663,100.0,776,29.1,2361,88.7,1887,70.9,474,17.8,302,11.3
08,04,10,35,8108,100.0,2430,30.0,7100,87.6,5678,70.0,1422,17.5,1008,12.4
08,04,10,36,6813,100.0,1437,21.1,6252,91.8,5376,78.9,876,12.9,561,8.2
08,04,10,37,9688,100.0,2234,23.1,8688,89.7,7454,76.9,1234,12.7,1000,10.3
08,04,10,38,6842,100.0,1449,21.2,6342,92.7,5393,78.8,949,13.9,500,7.3
08,04,10,39,3853,100.0,1081,28.1,3502,90.9,2772,71.9,730,18.9,351,9.1
08,04,10,40,7950,100.0,1753,22.1,7285,91.6,6197,77.9,1088,13.7,665,8.4
09,01,01,01,12103,100.0,3492,28.9,9916,81.9,8611,71.1,1305,10.8,2187,18.1
09,01,01,02,72,100.0,15,20.8,60,83.3,57,79.2,3,4.2,12,16.7
09,01,02,01,4320,100.0,669,15.5,3973,92.0,3651,84.5,322,7.5,347,8.0
09,01,02,02,6872,100.0,936,13.6,6254,91.0,5936,86.4,318,4.6,618,9.0
09,01,03,01,15512,100.0,2035,13.1,14297,92.2,13477,86.9,820,5.3,1215,7.8
09,01,03,02,2906,100.0,606,20.9,2647,91.1,2300,79.1,347,11.9,259,8.9
09,01,04,01,8294,100.0,623,7.5,7941,95.7,7671,92.5,270,3.3,353,4.3
09,01,04,02,11469,100.0,1860,16.2,10311,89.9,9609,83.8,702,6.1,1158,10.1
09,02,05,01,6820,100.0,1725,25.3,5520,80.9,5095,74.7,425,6.2,1300,19.1
09,02,05,02,15072,100.0,2645,17.5,13318,88.4,12427,82.5,891,5.9,1754,11.6
09,02,06,01,8006,100.0,1649,20.6,6792,84.8,6357,79.4,435,5.4,1214,15.2
09,02,06,02,3513,100.0,187,5.3,3420,97.4,3326,94.7,94,2.7,93,2.6
09,02,07,01,1771,100.0,774,43.7,1124,63.5,997,56.3,127,7.2,647,36.5
09,02,07,02,16131,100.0,2005,12.4,14716,91.2,14126,87.6,590,3.7,1415,8.8
09,02,08,01,2946,100.0,228,7.7,2805,95.2,2718,92.3,87,3.0,141,4.8
09,02,08,02,7805,100.0,1234,15.8,6960,89.2,6571,84.2,389,5.0,845,10.8
09,03,09,01,13018,100.0,1579,12.1,12257,94.2,11439,87.9,818,6.3,761,5.8
09,03,09,02,5714,100.0,661,11.6,5395,94.4,5053,88.4,342,6.0,319,5.6
09,03,09,03,8091,100.0,1277,15.8,7507,92.8,6814,84.2,693,8.6,584,7.2
09,03,10,01,12892,100.0,1408,10.9,11991,93.0,11484,89.1,507,3.9,901,7.0
09,03,11,01,6131,100.0,696,11.4,5631,91.8,5435,88.6,196,3.2,500,8.2
09,03,12,01,1817,100.0,141,7.8,1750,96.3,1676,92.2,74,4.1,67,3.7
09,03,12,02,2527,100.0,223,8.8,2393,94.7,2304,91.2,89,3.5,134,5.3
09,04,13,01,14537,100.0,1127,7.8,13757,94.6,13410,92.2,347,2.4,780,5.4
09,04,13,02,1856,100.0,165,8.9,1778,95.8,1691,91.1,87,4.7,78,4.2
09,04,14,01,5016,100.0,567,11.3,4575,91.2,4449,88.7,126,2.5,441,8.8
09,04,14,02,1501,100.0,154,10.3,1438,95.8,1347,89.7,91,6.1,63,4.2
09,04,15,01,7615,100.0,1163,15.3,6854,90.0,6452,84.7,402,5.3,761,10.0
09,04,16,01,6619,100.0,371,5.6,6455,97.5,6248,94.4,207,3.1,164,2.5
09,05,17,01,3659,100.0,254,6.9,3482,95.2,3405,93.1,77,2.1,177,4.8
09,05,17,02,14749,100.0,918,6.2,14260,96.7,13831,93.8,429,2.9,489,3.3
09,05,18,01,9438,100.0,803,8.5,8914,94.4,8635,91.5,279,3.0,524,5.6
09,05,19,01,10895,100.0,997,9.2,10292,94.5,9898,90.8,394,3.6,603,5.5
09,05,20,01,12856,100.0,758,5.9,12427,96.7,12098,94.1,329,2.6,429,3.3
10,01,01,01,5685,100.0,1452,25.5,4954,87.1,4233,74.5,721,12.7,731,12.9
10,01,01,02,18367,100.0,4499,24.5,16278,88.6,13868,75.5,2410,13.1,2089,11.4
10,01,02,03,1517,100.0,1054,69.5,510,33.6,463,30.5,47,3.1,1007,66.4
10,01,02,04,10582,100.0,2254,21.3,9598,90.7,8328,78.7,1270,12.0,984,9.3
10,01,02,05,8150,100.0,1096,13.4,7589,93.1,7054,86.6,535,6.6,561,6.9
10,01,02,06,17141,100.0,3566,20.8,15148,88.4,13575,79.2,1573,9.2,1993,11.6
10,01,02,07,10793,100.0,2370,22.0,9725,90.1,8423,78.0,1302,12.1,1068,9.9
10,01,03,08,2528,100.0,858,33.9,1875,74.2,1670,66.1,205,8.1,653,25.8
10,01,03,09,14393,100.0,2890,20.1,13238,92.0,11503,79.9,1735,12.1,1155,8.0
10,01,03,10,18238,100.0,3628,19.9,16488,90.4,14610,80.1,1878,10.3,1750,9.6
10,01,03,11,2912,100.0,370,12.7,2804,96.3,2542,87.3,262,9.0,108,3.7
10,02,04,12,6790,100.0,1850,27.2,5859,86.3,4940,72.8,919,13.5,931,13.7
10,02,04,13,15590,100.0,2705,17.4,13927,89.3,12885,82.6,1042,6.7,1663,10.7
10,02,04,14,1687,100.0,655,38.8,1468,87.0,1032,61.2,436,25.8,219,13.0
10,02,04,15,5619,100.0,1413,25.1,4601,81.9,4206,74.9,395,7.0,1018,18.1
10,02,04,16,5608,100.0,1410,25.1,4679,83.4,4198,74.9,481,8.6,929,16.6
10,02,05,17,8832,100.0,801,9.1,8454,95.7,8031,90.9,423,4.8,378,4.3
10,02,05,18,5211,100.0,779,14.9,4734,90.8,4432,85.1,302,5.8,477,9.2
10,02,05,19,6135,100.0,1757,28.6,4847,79.0,4378,71.4,469,7.6,1288,21.0
10,02,06,20,3356,100.0,477,14.2,3141,93.6,2879,85.8,262,7.8,215,6.4
10,02,06,21,6180,100.0,962,15.6,5627,91.1,5218,84.4,409,6.6,553,8.9
10,02,06,22,8627,100.0,989,11.5,8202,95.1,7638,88.5,564,6.5,425,4.9
10,02,06,23,6559,100.0,664,10.1,6301,96.1,5895,89.9,406,6.2,258,3.9
10,03,07,24,7802,100.0,1142,14.6,7007,89.8,6660,85.4,347,4.4,795,10.2
10,03,07,25,6267,100.0,1148,18.3,5545,88.5,5119,81.7,426,6.8,722,11.5
10,03,07,26,3029,100.0,315,10.4,2895,95.6,2714,89.6,181,6.0,134,4.4
10,03,07,27,9373,100.0,824,8.8,9061,96.7,8549,91.2,512,5.5,312,3.3
10,04,08,28,7774,100.0,539,6.9,7531,96.9,7235,93.1,296,3.8,243,3.1
10,04,08,29,3780,100.0,281,7.4,3594,95.1,3499,92.6,95,2.5,186,4.9
10,04,08,30,7579,100.0,435,5.7,7403,97.7,7144,94.3,259,3.4,176,2.3
10,04,09,31,9494,100.0,650,6.8,9211,97.0,8844,93.2,367,3.9,283,3.0
10,04,09,32,4001,100.0,344,8.6,3818,95.4,3657,91.4,161,4.0,183,4.6
10,04,09,33,14862,100.0,820,5.5,14517,97.7,14042,94.5,475,3.2,345,2.3
11,01,01,01,602,100.0,57,9.5,572,95.0,545,90.5,27,4.5,30,5.0
11,01,01,02,2556,100.0,122,4.8,2505,98.0,2434,95.2,71,2.8,51,2.0
11,01,01,03,1557,100.0,365,23.4,1269,81.5,1192,76.6,77,4.9,288,18.5
11,01,02,04,8963,100.0,2438,27.2,7611,84.9,6525,72.8,1086,12.1,1352,15.1
11,01,02,05,6714,100.0,1671,24.9,5890,87.7,5043,75.1,847,12.6,824,12.3
11,01,02,06,6026,100.0,1208,20.0,5313,88.2,4818,80.0,495,8.2,713,11.8
11,01,02,07,7166,100.0,1300,18.1,6396,89.3,5866,81.9,530,7.4,770,10.7
11,01,03,08,11809,100.0,3065,26.0,10130,85.8,8744,74.0,1386,11.7,1679,14.2
11,01,03,09,9706,100.0,2299,23.7,8338,85.9,7407,76.3,931,9.6,1368,14.1
11,01,03,10,5336,100.0,591,11.1,5040,94.5,4745,88.9,295,5.5,296,5.5
11,02,04,11,9343,100.0,2186,23.4,7756,83.0,7157,76.6,599,6.4,1587,17.0
11,02,04,12,6697,100.0,1258,18.8,5923,88.4,5439,81.2,484,7.2,774,11.6
11,02,05,13,3990,100.0,748,18.7,3378,84.7,3242,81.3,136,3.4,612,15.3
11,02,05,14,9296,100.0,1871,20.1,7826,84.2,7425,79.9,401,4.3,1470,15.8
11,02,05,15,14620,100.0,3243,22.2,12741,87.1,11377,77.8,1364,9.3,1879,12.9
11,02,05,16,3710,100.0,385,10.4,3533,95.2,3325,89.6,208,5.6,177,4.8
11,03,06,17,6051,100.0,1757,29.0,4987,82.4,4294,71.0,693,11.5,1064,17.6
11,03,06,18,15970,100.0,3636,22.8,13871,86.9,12334,77.2,1537,9.6,2099,13.1
11,03,06,19,10802,100.0,2996,27.7,9060,83.9,7806,72.3,1254,11.6,1742,16.1
11,03,07,20,5549,100.0,3431,61.8,2396,43.2,2118,38.2,278,5.0,3153,56.8
11,03,07,21,24576,100.0,5860,23.8,20467,83.3,18716,76.2,1751,7.1,4109,16.7
11,03,08,24,9997,100.0,3222,32.2,8079,80.8,6775,67.8,1304,13.0,1918,19.2
11,04,09,25,4061,100.0,822,20.2,3541,87.2,3239,79.8,302,7.4,520,12.8
11,04,09,26,28123,100.0,5096,18.1,24785,88.1,23027,81.9,1758,6.3,3338,11.9
11,04,10,22,5451,100.0,1698,31.2,4228,77.6,3753,68.8,475,8.7,1223,22.4
11,04,10,23,6083,100.0,1835,30.2,5049,83.0,4248,69.8,801,13.2,1034,17.0
11,04,10,27,2860,100.0,714,25.0,2421,84.7,2146,75.0,275,9.6,439,15.3
11,04,11,28,25120,100.0,5024,20.0,22164,88.2,20096,80.0,2068,8.2,2956,11.8
11,05,12,29,3523,100.0,496,14.1,3283,93.2,3027,85.9,256,7.3,240,6.8
11,05,13,30,9389,100.0,1566,16.7,8267,88.0,7823,83.3,444,4.7,1122,12.0
11,05,13,31,10932,100.0,1704,15.6,9725,89.0,9228,84.4,497,4.5,1207,11.0
11,05,13,32,6756,100.0,687,10.2,6453,95.5,6069,89.8,384,5.7,303,4.5
12,10,31,15,7619,100.0,3063,40.2,5889,77.3,4556,59.8,1333,17.5,1730,22.7
12,10,31,16,9511,100.0,4182,44.0,7084,74.5,5329,56.0,1755,18.5,2427,25.5
12,10,31,17,10819,100.0,5396,49.9,7558,69.9,5423,50.1,2135,19.7,3261,30.1
12,10,32,18,13566,100.0,5517,40.7,10534,77.7,8049,59.3,2485,18.3,3032,22.3
12,10,32,19,8748,100.0,3585,41.0,6801,77.7,5163,59.0,1638,18.7,1947,22.3
12,10,32,20,4639,100.0,1238,26.7,4011,86.5,3401,73.3,610,13.1,628,13.5
12,21,41,25,7375,100.0,2035,27.6,6284,85.2,5340,72.4,944,12.8,1091,14.8
12,21,41,26,7970,100.0,2823,35.4,6531,81.9,5147,64.6,1384,17.4,1439,18.1
12,21,44,21,2661,100.0,899,33.8,2144,80.6,1762,66.2,382,14.4,517,19.4
12,21,44,22,8149,100.0,4546,55.8,5602,68.7,3603,44.2,1999,24.5,2547,31.3
12,21,44,23,5575,100.0,2080,37.3,4584,82.2,3495,62.7,1089,19.5,991,17.8
12,21,44,24,10719,100.0,5160,48.1,7563,70.6,5559,51.9,2004,18.7,3156,29.4
12,21,45,27,10769,100.0,2087,19.4,9628,89.4,8682,80.6,946,8.8,1141,10.6
12,21,45,28,254,100.0,80,31.5,204,80.3,174,68.5,30,11.8,50,19.7
12,22,42,29,6046,100.0,751,12.4,5743,95.0,5295,87.6,448,7.4,303,5.0
12,22,42,30,17976,100.0,2093,11.6,17126,95.3,15883,88.4,1243,6.9,850,4.7
12,23,11,01,16580,100.0,2022,12.2,15604,94.1,14558,87.8,1046,6.3,976,5.9
12,23,11,02,16836,100.0,1975,11.7,16010,95.1,14861,88.3,1149,6.8,826,4.9
12,30,12,03,15110,100.0,4345,28.8,12336,81.6,10765,71.2,1571,10.4,2774,18.4
12,30,12,04,6383,100.0,1473,23.1,5611,87.9,4910,76.9,701,11.0,772,12.1
12,30,12,05,4937,100.0,878,17.8,4532,91.8,4059,82.2,473,9.6,405,8.2
12,30,12,06,5098,100.0,754,14.8,4835,94.8,4344,85.2,491,9.6,263,5.2
12,30,21,07,3054,100.0,1175,38.5,2573,84.3,1879,61.5,694,22.7,481,15.7
12,30,21,08,14510,100.0,5854,40.3,11777,81.2,8656,59.7,3121,21.5,2733,18.8
12,30,21,09,11630,100.0,5765,49.6,8733,75.1,5865,50.4,2868,24.7,2897,24.9
12,30,21,10,10519,100.0,5576,53.0,7685,73.1,4943,47.0,2742,26.1,2834,26.9
12,30,22,11,3308,100.0,848,25.6,2942,88.9,2460,74.4,482,14.6,366,11.1
12,30,22,12,5940,100.0,2646,44.5,4273,71.9,3294,55.5,979,16.5,1667,28.1
12,30,43,13,6640,100.0,1407,21.2,5774,87.0,5233,78.8,541,8.1,866,13.0
12,30,43,14,9742,100.0,1276,13.1,9142,93.8,8466,86.9,676,6.9,600,6.2
