district_id,forecast_area_id,district_region_id,planning_area_id,inhabitants,inhabitants_percentage,inhabitants_with_migration_background,inhabitants_with_migration_background_percentage,inhabitants_germans,inhabitants_germans_percentage,inhabitants_germans_without_migration_background,inhabitants_germans_without_migration_background_percentage,inhabitants_germans_with_migration_background,inhabitants_germans_with_migration_background_percentage,inhabitants_foreigners,inhabitants_foreigners_percentage
01,01,11,01,3085,100.0,1710,55.4,1911,61.9,1375,44.6,536,17.4,1174,38.1
01,01,11,02,198,100.0,74,37.4,139,70.2,124,62.6,15,7.6,59,29.8
01,01,11,03,5537,100.0,3241,58.5,3389,61.2,2296,41.5,1093,19.7,2148,38.8
01,01,11,04,4622,100.0,2943,63.7,2911,63.0,1679,36.3,1232,26.7,1711,37.0
01,01,11,05,1150,100.0,660,57.4,678,59.0,490,42.6,188,16.3,472,41.0
01,01,12,01,2096,100.0,1044,49.8,1432,68.3,1052,50.2,380,18.1,664,31.7
01,01,12,02,568,100.0,244,43.0,383,67.4,324,57.0,59,10.4,185,32.6
01,01,12,03,961,100.0,496,51.6,592,61.6,465,48.4,127,13.2,369,38.4
01,01,12,04,7021,100.0,3006,42.8,5061,72.1,4015,57.2,1046,14.9,1960,27.9
01,01,13,01,6333,100.0,2446,38.6,4573,72.2,3887,61.4,686,10.8,1760,27.8
01,01,13,02,12484,100.0,4600,36.8,9301,74.5,7884,63.2,1417,11.4,3183,25.5
01,01,13,03,9143,100.0,3779,41.3,6411,70.1,5364,58.7,1047,11.5,2732,29.9
01,01,13,04,8554,100.0,2941,34.4,6714,78.5,5613,65.6,1101,12.9,1840,21.5
01,01,13,05,7479,100.0,2502,33.5,5850,78.2,4977,66.5,873,11.7,1629,21.8
01,01,13,06,9156,100.0,3357,36.7,6921,75.6,5799,63.3,1122,12.3,2235,24.4
01,01,14,01,16139,100.0,6118,37.9,11725,72.7,10021,62.1,1704,10.6,4414,27.3
01,01,14,02,13210,100.0,4662,35.3,9973,75.5,8548,64.7,1425,10.8,3237,24.5
01,02,21,01,3456,100.0,1767,51.1,2255,65.2,1689,48.9,566,16.4,1201,34.8
01,02,21,02,6303,100.0,3663,58.1,3779,60.0,2640,41.9,1139,18.1,2524,40.0
01,02,21,03,259,100.0,179,69.1,128,49.4,80,30.9,48,18.5,131,50.6
01,02,21,04,18375,100.0,8731,47.5,12780,69.6,9644,52.5,3136,17.1,5595,30.4
01,02,21,05,5281,100.0,2994,56.7,3407,64.5,2287,43.3,1120,21.2,1874,35.5
01,02,21,06,11811,100.0,4185,35.4,9252,78.3,7626,64.6,1626,13.8,2559,21.7
01,02,22,01,11205,100.0,5568,49.7,7692,68.6,5637,50.3,2055,18.3,3513,31.4
01,02,22,02,1486,100.0,972,65.4,1005,67.6,514,34.6,491,33.0,481,32.4
01,02,22,03,6895,100.0,3960,57.4,4654,67.5,2935,42.6,1719,24.9,2241,32.5
01,02,22,04,5904,100.0,2300,39.0,4461,75.6,3604,61.0,857,14.5,1443,24.4
01,02,22,05,3331,100.0,1969,59.1,2268,68.1,1362,40.9,906,27.2,1063,31.9
01,02,22,06,3038,100.0,1186,39.0,2400,79.0,1852,61.0,548,18.0,638,21.0
01,02,22,07,5609,100.0,2401,42.8,3920,69.9,3208,57.2,712,12.7,1689,30.1
01,03,31,01,26811,100.0,16273,60.7,16086,60.0,10538,39.3,5548,20.7,10725,40.0
01,03,31,02,11649,100.0,6909,59.3,7348,63.1,4740,40.7,2608,22.4,4301,36.9
01,03,32,01,13340,100.0,8835,66.2,9123,68.4,4505,33.8,4618,34.6,4217,31.6
01,03,32,02,9723,100.0,5298,54.5,7189,73.9,4425,45.5,2764,28.4,2534,26.1
01,03,32,03,14473,100.0,9081,62.7,8798,60.8,5392,37.3,3406,23.5,5675,39.2
01,04,41,01,20528,100.0,9435,46.0,14501,70.6,11093,54.0,3408,16.6,6027,29.4
01,04,41,02,16214,100.0,6053,37.3,12569,77.5,10161,62.7,2408,14.9,3645,22.5
01,04,41,03,8330,100.0,4200,50.4,5505,66.1,4130,49.6,1375,16.5,2825,33.9
01,04,42,01,23528,100.0,15807,67.2,13350,56.7,7721,32.8,5629,23.9,10178,43.3
01,04,42,02,16641,100.0,9418,56.6,10097,60.7,7223,43.4,2874,17.3,6544,39.3
01,04,42,03,16196,100.0,9193,56.8,10053,62.1,7003,43.2,3050,18.8,6143,37.9
02,01,01,01,6523,100.0,4628,70.9,3667,56.2,1895,29.1,1772,27.2,2856,43.8
02,01,01,02,13489,100.0,9057,67.1,9145,67.8,4432,32.9,4713,34.9,4344,32.2
02,01,01,03,15721,100.0,10851,69.0,10122,64.4,4870,31.0,5252,33.4,5599,35.6
02,01,01,04,5106,100.0,3303,64.7,3444,67.5,1803,35.3,1641,32.1,1662,32.5
02,02,02,01,828,100.0,392,47.3,595,71.9,436,52.7,159,19.2,233,28.1
02,02,02,02,6020,100.0,2579,42.8,4291,71.3,3441,57.2,850,14.1,1729,28.7
02,02,02,03,10824,100.0,4031,37.2,8346,77.1,6793,62.8,1553,14.3,2478,22.9
02,02,02,04,12301,100.0,5005,40.7,9141,74.3,7296,59.3,1845,15.0,3160,25.7
02,02,02,05,14976,100.0,5860,39.1,11358,75.8,9116,60.9,2242,15.0,3618,24.2
02,02,02,06,19308,100.0,8712,45.1,13928,72.1,10596,54.9,3332,17.3,5380,27.9
02,03,03,01,9177,100.0,5751,62.7,5638,61.4,3426,37.3,2212,24.1,3539,38.6
02,03,03,02,13369,100.0,7132,53.3,8915,66.7,6237,46.7,2678,20.0,4454,33.3
02,03,04,01,15067,100.0,7030,46.7,10473,69.5,8037,53.3,2436,16.2,4594,30.5
02,03,04,02,11178,100.0,5427,48.6,7596,68.0,5751,51.4,1845,16.5,3582,32.0
02,04,05,01,5416,100.0,1243,23.0,4688,86.6,4173,77.0,515,9.5,728,13.4
02,04,05,02,7163,100.0,1753,24.5,6073,84.8,5410,75.5,663,9.3,1090,15.2
02,04,05,03,10927,100.0,2456,22.5,9268,84.8,8471,77.5,797,7.3,1659,15.2
02,04,07,01,12220,100.0,4089,33.5,9562,78.2,8131,66.5,1431,11.7,2658,21.8
02,04,07,02,10764,100.0,2369,22.0,9182,85.3,8395,78.0,787,7.3,1582,14.7
02,04,07,03,1116,100.0,732,65.6,484,43.4,384,34.4,100,9.0,632,56.6
02,05,06,01,8840,100.0,2384,27.0,7159,81.0,6456,73.0,703,8.0,1681,19.0
02,05,06,02,20739,100.0,5330,25.7,17027,82.1,15409,74.3,1618,7.8,3712,17.9
02,05,08,01,19114,100.0,5547,29.0,15066,78.8,13567,71.0,1499,7.8,4048,21.2
02,05,08,02,20184,100.0,5490,27.2,16092,79.7,14694,72.8,1398,6.9,4092,20.3
02,05,08,03,6792,100.0,1774,26.1,5565,81.9,5018,73.9,547,8.1,1227,18.1
02,05,08,04,3914,100.0,812,20.7,3438,87.8,3102,79.3,336,8.6,476,12.2
03,01,01,01,3879,100.0,446,11.5,3582,92.3,3433,88.5,149,3.8,297,7.7
03,01,01,02,11825,100.0,1666,14.1,10562,89.3,10159,85.9,403,3.4,1263,10.7
03,01,01,04,225,100.0,47,20.9,197,87.6,178,79.1,19,8.4,28,12.4
03,02,02,03,2110,100.0,102,4.8,2074,98.3,2008,95.2,66,3.1,36,1.7
03,02,02,09,14498,100.0,1916,13.2,13361,92.2,12582,86.8,779,5.4,1137,7.8
03,02,02,10,11052,100.0,1332,12.1,10238,92.6,9720,87.9,518,4.7,814,7.4
03,02,03,07,17766,100.0,1892,10.6,17093,96.2,15874,89.4,1219,6.9,673,3.8
03,03,04,05,11016,100.0,1272,11.5,10326,93.7,9744,88.5,582,5.3,690,6.3
03,03,04,06,8210,100.0,526,6.4,7976,97.1,7684,93.6,292,3.6,234,2.9
03,03,07,11,6811,100.0,355,5.2,6666,97.9,6456,94.8,210,3.1,145,2.1
03,03,07,15,6800,100.0,605,8.9,6490,95.4,6195,91.1,295,4.3,310,4.6
03,03,07,16,1135,100.0,31,2.7,1122,98.9,1104,97.3,18,1.6,13,1.1
03,04,05,08,4578,100.0,829,18.1,4334,94.7,3749,81.9,585,12.8,244,5.3
03,04,05,12,9783,100.0,1186,12.1,9272,94.8,8597,87.9,675,6.9,511,5.2
03,04,05,13,3402,100.0,436,12.8,3194,93.9,2966,87.2,228,6.7,208,6.1
03,04,06,14,35188,100.0,4096,11.6,32899,93.5,31092,88.4,1807,5.1,2289,6.5
03,04,08,18,33983,100.0,4518,13.3,30994,91.2,29465,86.7,1529,4.5,2989,8.8
03,05,09,19,5584,100.0,1059,19.0,4667,83.6,4525,81.0,142,2.5,917,16.4
03,05,09,20,7379,100.0,1013,13.7,6742,91.4,6366,86.3,376,5.1,637,8.6
03,05,09,23,9089,100.0,1498,16.5,8078,88.9,7591,83.5,487,5.4,1011,11.1
03,05,09,24,5743,100.0,1054,18.4,4997,87.0,4689,81.6,308,5.4,746,13.0
03,05,09,25,9385,100.0,1473,15.7,8423,89.7,7912,84.3,511,5.4,962,10.3
03,05,10,17,4279,100.0,754,17.6,3734,87.3,3525,82.4,209,4.9,545,12.7
03,05,10,21,6468,100.0,628,9.7,6002,92.8,5840,90.3,162,2.5,466,7.2
03,05,10,22,4501,100.0,247,5.5,4375,97.2,4254,94.5,121,2.7,126,2.8
03,06,11,26,15175,100.0,3785,24.9,12513,82.5,11390,75.1,1123,7.4,2662,17.5
03,06,11,31,10420,100.0,3093,29.7,8235,79.0,7327,70.3,908,8.7,2185,21.0
03,06,12,27,14602,100.0,3384,23.2,12289,84.2,11218,76.8,1071,7.3,2313,15.8
03,06,12,28,12554,100.0,2406,19.2,10908,86.9,10148,80.8,760,6.1,1646,13.1
03,06,13,32,22374,100.0,6246,27.9,18209,81.4,16128,72.1,2081,9.3,4165,18.6
03,06,14,29,9998,100.0,1164,11.6,9281,92.8,8834,88.4,447,4.5,717,7.2
03,06,14,30,3505,100.0,999,28.5,2676,76.3,2506,71.5,170,4.9,829,23.7
03,06,14,34,6208,100.0,1320,21.3,5319,85.7,4888,78.7,431,6.9,889,14.3
03,06,14,35,3851,100.0,899,23.3,3231,83.9,2952,76.7,279,7.2,620,16.1
03,06,14,41,2589,100.0,688,26.6,2203,85.1,1901,73.4,302,11.7,386,14.9
03,07,15,36,10672,100.0,3524,33.0,8281,77.6,7148,67.0,1133,10.6,2391,22.4
03,07,15,37,15494,100.0,4949,31.9,11969,77.2,10545,68.1,1424,9.2,3525,22.8
03,07,16,33,2927,100.0,625,21.4,2557,87.4,2302,78.6,255,8.7,370,12.6
03,07,16,38,17387,100.0,5084,29.2,13908,80.0,12303,70.8,1605,9.2,3479,20.0
03,07,16,39,12371,100.0,2977,24.1,10457,84.5,9394,75.9,1063,8.6,1914,15.5
04,01,01,01,10925,100.0,4928,45.1,8000,73.2,5997,54.9,2003,18.3,2925,26.8
04,01,01,02,824,100.0,291,35.3,577,70.0,533,64.7,44,5.3,247,30.0
04,01,01,03,7708,100.0,3855,50.0,5847,75.9,3853,50.0,1994,25.9,1861,24.1
04,02,02,04,171,100.0,61,35.7,131,76.6,110,64.3,21,12.3,40,23.4
04,02,02,05,1293,100.0,297,23.0,1123,86.9,996,77.0,127,9.8,170,13.1
04,02,02,06,2679,100.0,574,21.4,2341,87.4,2105,78.6,236,8.8,338,12.6
04,02,02,07,2543,100.0,693,27.3,2154,84.7,1850,72.7,304,12.0,389,15.3
04,02,02,08,2860,100.0,686,24.0,2501,87.4,2174,76.0,327,11.4,359,12.6
04,02,02,09,3154,100.0,1134,36.0,2286,72.5,2020,64.0,266,8.4,868,27.5
04,02,03,10,608,100.0,303,49.8,347,57.1,305,50.2,42,6.9,261,42.9
04,02,03,11,14325,100.0,4017,28.0,12049,84.1,10308,72.0,1741,12.2,2276,15.9
04,02,03,12,5471,100.0,1667,30.5,4389,80.2,3804,69.5,585,10.7,1082,19.8
04,02,03,13,7455,100.0,2840,38.1,5596,75.1,4615,61.9,981,13.2,1859,24.9
04,02,03,14,793,100.0,793,100.0,0,0.0,0,0.0,0,0.0,793,100.0
04,03,04,15,2759,100.0,1399,50.7,1697,61.5,1360,49.3,337,12.2,1062,38.5
04,03,04,16,10612,100.0,4976,46.9,7744,73.0,5636,53.1,2108,19.9,2868,27.0
04,03,04,17,10869,100.0,4008,36.9,8441,77.7,6861,63.1,1580,14.5,2428,22.3
04,03,05,18,9393,100.0,3937,41.9,7048,75.0,5456,58.1,1592,16.9,2345,25.0
04,03,05,19,5689,100.0,2406,42.3,4287,75.4,3283,57.7,1004,17.6,1402,24.6
04,03,06,20,8552,100.0,3642,42.6,6425,75.1,4910,57.4,1515,17.7,2127,24.9
04,03,06,21,3011,100.0,1588,52.7,2046,68.0,1423,47.3,623,20.7,965,32.0
04,03,06,22,10429,100.0,4712,45.2,7649,73.3,5717,54.8,1932,18.5,2780,26.7
04,03,06,23,4700,100.0,2538,54.0,3219,68.5,2162,46.0,1057,22.5,1481,31.5
04,03,07,24,6397,100.0,2201,34.4,5065,79.2,4196,65.6,869,13.6,1332,20.8
04,03,07,25,11973,100.0,4613,38.5,8949,74.7,7360,61.5,1589,13.3,3024,25.3
04,03,07,26,5461,100.0,2233,40.9,4080,74.7,3228,59.1,852,15.6,1381,25.3
04,03,08,27,12131,100.0,6204,51.1,8073,66.5,5927,48.9,2146,17.7,4058,33.5
04,03,08,28,9386,100.0,3956,42.1,6873,73.2,5430,57.9,1443,15.4,2513,26.8
04,03,09,29,5906,100.0,2455,41.6,4364,73.9,3451,58.4,913,15.5,1542,26.1
04,03,09,30,5625,100.0,2454,43.6,4024,71.5,3171,56.4,853,15.2,1601,28.5
04,03,09,31,3920,100.0,2256,57.6,2278,58.1,1664,42.4,614,15.7,1642,41.9
04,03,10,32,14795,100.0,5665,38.3,11470,77.5,9130,61.7,2340,15.8,3325,22.5
04,04,11,33,36,100.0,6,16.7,33,91.7,30,83.3,3,8.3,3,8.3
04,04,11,34,5116,100.0,1873,36.6,4060,79.4,3243,63.4,817,16.0,1056,20.6
04,04,11,35,2718,100.0,887,32.6,2218,81.6,1831,67.4,387,14.2,500,18.4
04,04,11,36,3027,100.0,963,31.8,2473,81.7,2064,68.2,409,13.5,554,18.3
04,04,11,37,7922,100.0,2681,33.8,6467,81.6,5241,66.2,1226,15.5,1455,18.4
04,04,12,38,5749,100.0,1725,30.0,4901,85.2,4024,70.0,877,15.3,848,14.8
04,04,12,39,317,100.0,221,69.7,111,35.0,96,30.3,15,4.7,206,65.0
04,04,12,40,1508,100.0,392,26.0,1295,85.9,1116,74.0,179,11.9,213,14.1
04,04,12,41,6919,100.0,1585,22.9,6044,87.4,5334,77.1,710,10.3,875,12.6
04,04,13,42,4040,100.0,1208,29.9,3384,83.8,2832,70.1,552,13.7,656,16.2
04,04,13,43,3563,100.0,1050,29.5,3002,84.3,2513,70.5,489,13.7,561,15.7
04,04,13,44,10741,100.0,2716,25.3,9118,84.9,8025,74.7,1093,10.2,1623,15.1
04,05,14,45,6200,100.0,2504,40.4,4793,77.3,3696,59.6,1097,17.7,1407,22.7
04,05,14,46,10528,100.0,4293,40.8,8058,76.5,6235,59.2,1823,17.3,2470,23.5
04,05,14,47,5250,100.0,2063,39.3,3990,76.0,3187,60.7,803,15.3,1260,24.0
04,05,14,48,9117,100.0,4033,44.2,6559,71.9,5084,55.8,1475,16.2,2558,28.1
04,05,15,49,5239,100.0,2587,49.4,3293,62.9,2652,50.6,641,12.2,1946,37.1
04,05,15,50,5467,100.0,2036,37.2,4303,78.7,3431,62.8,872,16.0,1164,21.3
04,05,15,51,4364,100.0,1695,38.8,3398,77.9,2669,61.2,729,16.7,966,22.1
04,05,16,52,9662,100.0,3537,36.6,7430,76.9,6125,63.4,1305,13.5,2232,23.1
04,05,16,53,6635,100.0,2560,38.6,5110,77.0,4075,61.4,1035,15.6,1525,23.0
04,05,16,54,3028,100.0,1024,33.8,2398,79.2,2004,66.2,394,13.0,630,20.8
04,05,16,55,7075,100.0,2942,41.6,5276,74.6,4133,58.4,1143,16.2,1799,25.4
04,05,16,56,7621,100.0,2310,30.3,6271,82.3,5311,69.7,960,12.6,1350,17.7
04,06,17,57,92,100.0,30,32.6,65,70.7,62,67.4,3,3.3,27,29.3
05,01,01,01,10788,100.0,3148,29.2,8959,83.0,7640,70.8,1319,12.2,1829,17.0
05,01,01,02,5843,100.0,1159,19.8,5181,88.7,4684,80.2,497,8.5,662,11.3
05,01,01,03,7525,100.0,1158,15.4,7007,93.1,6367,84.6,640,8.5,518,6.9
05,01,02,04,3236,100.0,1202,37.1,2679,82.8,2034,62.9,645,19.9,557,17.2
05,01,02,05,1921,100.0,494,25.7,1738,90.5,1427,74.3,311,16.2,183,9.5
05,01,02,06,10186,100.0,3281,32.2,8778,86.2,6905,67.8,1873,18.4,1408,13.8
05,01,02,07,11395,100.0,5458,47.9,9176,80.5,5937,52.1,3239,28.4,2219,19.5
05,01,02,08,7547,100.0,2252,29.8,6278,83.2,5295,70.2,983,13.0,1269,16.8
05,01,02,09,6054,100.0,1659,27.4,5338,88.2,4395,72.6,943,15.6,716,11.8
05,01,03,10,3883,100.0,1246,32.1,3172,81.7,2637,67.9,535,13.8,711,18.3
05,01,03,11,5600,100.0,2851,50.9,4079,72.8,2749,49.1,1330,23.8,1521,27.2
05,01,03,12,7028,100.0,3539,50.4,4644,66.1,3489,49.6,1155,16.4,2384,33.9
05,01,03,13,6624,100.0,2471,37.3,5179,78.2,4153,62.7,1026,15.5,1445,21.8
05,01,03,14,11948,100.0,4181,35.0,9671,80.9,7767,65.0,1904,15.9,2277,19.1
05,01,03,39,1002,100.0,662,66.1,375,37.4,340,33.9,35,3.5,627,62.6
05,02,04,15,3964,100.0,750,18.9,3728,94.0,3214,81.1,514,13.0,236,6.0
05,02,04,16,1697,100.0,93,5.5,1673,98.6,1604,94.5,69,4.1,24,1.4
05,02,04,17,5890,100.0,1607,27.3,5117,86.9,4283,72.7,834,14.2,773,13.1
05,02,04,18,4047,100.0,753,18.6,3698,91.4,3294,81.4,404,10.0,349,8.6
05,02,04,19,6971,100.0,1625,23.3,6180,88.7,5346,76.7,834,12.0,791,11.3
05,02,04,20,926,100.0,152,16.4,872,94.2,774,83.6,98,10.6,54,5.8
05,02,05,21,3148,100.0,783,24.9,2875,91.3,2365,75.1,510,16.2,273,8.7
05,02,05,22,7289,100.0,3008,41.3,5474,75.1,4281,58.7,1193,16.4,1815,24.9
05,02,05,23,11882,100.0,6105,51.4,9265,78.0,5777,48.6,3488,29.4,2617,22.0
05,02,05,24,6113,100.0,970,15.9,5702,93.3,5143,84.1,559,9.1,411,6.7
05,02,06,25,7400,100.0,2233,30.2,6210,83.9,5167,69.8,1043,14.1,1190,16.1
05,02,06,26,19055,100.0,6558,34.4,14763,77.5,12497,65.6,2266,11.9,4292,22.5
05,02,06,27,4038,100.0,1458,36.1,3257,80.7,2580,63.9,677,16.8,781,19.3
05,02,06,28,1996,100.0,416,20.8,1809,90.6,1580,79.2,229,11.5,187,9.4
05,02,06,29,4373,100.0,584,13.4,4085,93.4,3789,86.6,296,6.8,288,6.6
05,03,07,30,3908,100.0,2042,52.3,3261,83.4,1866,47.7,1395,35.7,647,16.6
05,03,07,31,11831,100.0,4863,41.1,9490,80.2,6968,58.9,2522,21.3,2341,19.8
05,03,08,32,11518,100.0,4737,41.1,8897,77.2,6781,58.9,2116,18.4,2621,22.8
05,03,08,33,1625,100.0,1325,81.5,405,24.9,300,18.5,105,6.5,1220,75.1
05,04,09,34,4032,100.0,1277,31.7,3063,76.0,2755,68.3,308,7.6,969,24.0
05,04,09,35,412,100.0,94,22.8,340,82.5,318,77.2,22,5.3,72,17.5
05,04,09,36,9835,100.0,1624,16.5,9215,93.7,8211,83.5,1004,10.2,620,6.3
05,04,09,37,2127,100.0,274,12.9,2026,95.3,1853,87.1,173,8.1,101,4.7
05,04,09,38,3621,100.0,436,12.0,3454,95.4,3185,88.0,269,7.4,167,4.6
06,01,01,01,6805,100.0,1495,22.0,6004,88.2,5310,78.0,694,10.2,801,11.8
06,01,01,02,8756,100.0,2930,33.5,7117,81.3,5826,66.5,1291,14.7,1639,18.7
06,01,01,03,6278,100.0,1847,29.4,5354,85.3,4431,70.6,923,14.7,924,14.7
06,01,02,04,6877,100.0,2126,30.9,5850,85.1,4751,69.1,1099,16.0,1027,14.9
06,01,02,05,9560,100.0,2671,27.9,8252,86.3,6889,72.1,1363,14.3,1308,13.7
06,01,02,06,7660,100.0,1967,25.7,6620,86.4,5693,74.3,927,12.1,1040,13.6
06,01,02,07,7793,100.0,2302,29.5,6598,84.7,5491,70.5,1107,14.2,1195,15.3
06,01,02,08,6851,100.0,2077,30.3,5658,82.6,4774,69.7,884,12.9,1193,17.4
06,01,02,09,9081,100.0,2669,29.4,7666,84.4,6412,70.6,1254,13.8,1415,15.6
06,01,02,10,4872,100.0,1243,25.5,4229,86.8,3629,74.5,600,12.3,643,13.2
06,02,03,01,4964,100.0,988,19.9,4496,90.6,3976,80.1,520,10.5,468,9.4
06,02,03,02,5482,100.0,1174,21.4,4883,89.1,4308,78.6,575,10.5,599,10.9
06,02,03,03,7338,100.0,1958,26.7,6353,86.6,5380,73.3,973,13.3,985,13.4
06,02,03,04,6791,100.0,1689,24.9,5945,87.5,5102,75.1,843,12.4,846,12.5
06,02,03,05,11328,100.0,3463,30.6,9491,83.8,7865,69.4,1626,14.4,1837,16.2
06,02,03,06,6450,100.0,1143,17.7,5977,92.7,5307,82.3,670,10.4,473,7.3
06,02,04,07,4667,100.0,2235,47.9,3552,76.1,2432,52.1,1120,24.0,1115,23.9
06,02,04,08,6817,100.0,1668,24.5,5896,86.5,5149,75.5,747,11.0,921,13.5
06,02,04,09,8188,100.0,1889,23.1,7134,87.1,6299,76.9,835,10.2,1054,12.9
06,02,04,10,7060,100.0,1234,17.5,6338,89.8,5826,82.5,512,7.3,722,10.2
06,02,04,11,8389,100.0,1766,21.1,7658,91.3,6623,78.9,1035,12.3,731,8.7
06,03,05,01,5885,100.0,1326,22.5,5010,85.1,4559,77.5,451,7.7,875,14.9
06,03,05,02,5400,100.0,1082,20.0,4920,91.1,4318,80.0,602,11.1,480,8.9
06,03,05,03,11482,100.0,2822,24.6,10037,87.4,8660,75.4,1377,12.0,1445,12.6
06,03,05,04,11057,100.0,2224,20.1,9857,89.1,8833,79.9,1024,9.3,1200,10.9
06,03,06,05,6984,100.0,1798,25.7,5955,85.3,5186,74.3,769,11.0,1029,14.7
06,03,06,06,5225,100.0,1582,30.3,4329,82.9,3643,69.7,686,13.1,896,17.1
06,03,06,07,3097,100.0,1097,35.4,2318,74.8,2000,64.6,318,10.3,779,25.2
06,03,06,08,12761,100.0,3071,24.1,11287,88.4,9690,75.9,1597,12.5,1474,11.6
06,03,06,09,11973,100.0,2632,22.0,10549,88.1,9341,78.0,1208,10.1,1424,11.9
06,03,06,10,8132,100.0,1669,20.5,7209,88.6,6463,79.5,746,9.2,923,11.4
06,04,07,01,10005,100.0,2011,20.1,8844,88.4,7994,79.9,850,8.5,1161,11.6
06,04,07,02,5318,100.0,991,18.6,4899,92.1,4327,81.4,572,10.8,419,7.9
06,04,07,03,10623,100.0,2533,23.8,8922,84.0,8090,76.2,832,7.8,1701,16.0
06,04,08,04,7514,100.0,1208,16.1,6890,91.7,6306,83.9,584,7.8,624,8.3
06,04,08,05,5365,100.0,1088,20.3,4806,89.6,4277,79.7,529,9.9,559,10.4
06,04,08,06,7319,100.0,1071,14.6,6762,92.4,6248,85.4,514,7.0,557,7.6
06,04,08,07,5710,100.0,1155,20.2,5097,89.3,4555,79.8,542,9.5,613,10.7
06,04,08,08,4523,100.0,1830,40.5,3644,80.6,2693,59.5,951,21.0,879,19.4
06,04,08,09,5142,100.0,1598,31.1,4022,78.2,3544,68.9,478,9.3,1120,21.8
06,04,08,10,7013,100.0,1908,27.2,5943,84.7,5105,72.8,838,11.9,1070,15.3
07,01,01,01,9992,100.0,4753,47.6,6968,69.7,5239,52.4,1729,17.3,3024,30.3
07,01,01,02,15866,100.0,8447,53.2,10717,67.5,7419,46.8,3298,20.8,5149,32.5
07,01,01,03,10173,100.0,3689,36.3,7956,78.2,6484,63.7,1472,14.5,2217,21.8
07,01,01,04,13682,100.0,7791,56.9,8823,64.5,5891,43.1,2932,21.4,4859,35.5
07,02,02,01,10510,100.0,3487,33.2,8595,81.8,7023,66.8,1572,15.0,1915,18.2
07,02,02,02,10164,100.0,4136,40.7,7674,75.5,6028,59.3,1646,16.2,2490,24.5
07,02,02,03,17742,100.0,7454,42.0,13329,75.1,10288,58.0,3041,17.1,4413,24.9
07,02,02,04,11839,100.0,4149,35.0,9317,78.7,7690,65.0,1627,13.7,2522,21.3
07,03,03,01,24609,100.0,6325,25.7,21041,85.5,18284,74.3,2757,11.2,3568,14.5
07,03,03,02,9341,100.0,2754,29.5,7888,84.4,6587,70.5,1301,13.9,1453,15.6
07,03,03,03,12264,100.0,5042,41.1,9706,79.1,7222,58.9,2484,20.3,2558,20.9
07,04,04,01,18603,100.0,7347,39.5,14369,77.2,11256,60.5,3113,16.7,4234,22.8
07,04,04,02,2162,100.0,402,18.6,1992,92.1,1760,81.4,232,10.7,170,7.9
07,04,04,03,23785,100.0,8200,34.5,19344,81.3,15585,65.5,3759,15.8,4441,18.7
07,04,04,04,5051,100.0,1148,22.7,4510,89.3,3903,77.3,607,12.0,541,10.7
07,04,04,05,11176,100.0,4623,41.4,8518,76.2,6553,58.6,1965,17.6,2658,23.8
07,04,04,06,3800,100.0,1872,49.3,2642,69.5,1928,50.7,714,18.8,1158,30.5
07,05,05,01,15903,100.0,5735,36.1,13009,81.8,10168,63.9,2841,17.9,2894,18.2
07,05,05,02,8132,100.0,2813,34.6,6492,79.8,5319,65.4,1173,14.4,1640,20.2
07,05,05,03,9123,100.0,2610,28.6,7882,86.4,6513,71.4,1369,15.0,1241,13.6
07,05,05,04,5527,100.0,1615,29.2,4848,87.7,3912,70.8,936,16.9,679,12.3
07,05,05,05,10520,100.0,2640,25.1,9396,89.3,7880,74.9,1516,14.4,1124,10.7
07,05,05,06,2341,100.0,569,24.3,2069,88.4,1772,75.7,297,12.7,272,11.6
07,06,06,01,10001,100.0,3824,38.2,7977,79.8,6177,61.8,1800,18.0,2024,20.2
07,06,06,02,4641,100.0,961,20.7,4235,91.3,3680,79.3,555,12.0,406,8.7
07,06,06,03,3177,100.0,1316,41.4,2386,75.1,1861,58.6,525,16.5,791,24.9
07,06,06,04,14306,100.0,4922,34.4,12495,87.3,9384,65.6,3111,21.7,1811,12.7
07,07,07,01,10432,100.0,1898,18.2,9638,92.4,8534,81.8,1104,10.6,794,7.6
07,07,07,02,10746,100.0,1887,17.6,10039,93.4,8859,82.4,1180,11.0,707,6.6
07,07,07,03,7354,100.0,1614,21.9,6670,90.7,5740,78.1,930,12.6,684,9.3
07,07,07,04,8228,100.0,2690,32.7,6984,84.9,5538,67.3,1446,17.6,1244,15.1
07,07,07,05,6996,100.0,1044,14.9,6559,93.8,5952,85.1,607,8.7,437,6.2
07,07,07,06,3947,100.0,800,20.3,3400,86.1,3147,79.7,253,6.4,547,13.9
07,07,07,07,2891,100.0,406,14.0,2671,92.4,2485,86.0,186,6.4,220,7.6
08,01,01,15,858,100.0,343,40.0,643,74.9,515,60.0,128,14.9,215,25.1
08,01,01,16,3570,100.0,1939,54.3,2311,64.7,1631,45.7,680,19.0,1259,35.3
08,01,01,17,16208,100.0,7935,49.0,10801,66.6,8273,51.0,2528,15.6,5407,33.4
08,01,01,18,11866,100.0,6961,58.7,7543,63.6,4905,41.3,2638,22.2,4323,36.4
08,01,02,11,10048,100.0,5778,57.5,6109,60.8,4270,42.5,1839,18.3,3939,39.2
08,01,02,12,7504,100.0,4950,66.0,4926,65.6,2554,34.0,2372,31.6,2578,34.4
08,01,02,13,12731,100.0,6815,53.5,8243,64.7,5916,46.5,2327,18.3,4488,35.3
08,01,02,14,8059,100.0,4479,55.6,5228,64.9,3580,44.4,1648,20.4,2831,35.1
08,01,03,01,27660,100.0,13002,47.0,19212,69.5,14658,53.0,4554,16.5,8448,30.5
08,01,03,02,3698,100.0,1288,34.8,2933,79.3,2410,65.2,523,14.1,765,20.7
08,01,03,03,8493,100.0,5005,58.9,5160,60.8,3488,41.1,1672,19.7,3333,39.2
08,01,04,04,23833,100.0,12493,52.4,15493,65.0,11340,47.6,4153,17.4,8340,35.0
08,01,04,05,9174,100.0,4213,45.9,6339,69.1,4961,54.1,1378,15.0,2835,30.9
08,01,04,06,7127,100.0,4023,56.4,4527,63.5,3104,43.6,1423,20.0,2600,36.5
08,01,04,07,812,100.0,327,40.3,597,73.5,485,59.7,112,13.8,215,26.5
08,01,05,08,5613,100.0,3888,69.3,3761,67.0,1725,30.7,2036,36.3,1852,33.0
08,01,05,09,9523,100.0,6156,64.6,6659,69.9,3367,35.4,3292,34.6,2864,30.1
08,01,05,10,471,100.0,311,66.0,234,49.7,160,34.0,74,15.7,237,50.3
08,02,06,19,10979,100.0,5741,52.3,7577,69.0,5238,47.7,2339,21.3,3402,31.0
08,02,06,20,9305,100.0,3820,41.1,7400,79.5,5485,58.9,1915,20.6,1905,20.5
08,02,06,21,2294,100.0,555,24.2,2110,92.0,1739,75.8,371,16.2,184,8.0
08,02,06,22,14284,100.0,3679,25.8,12536,87.8,10605,74.2,1931,13.5,1748,12.2
08,02,06,23,1291,100.0,333,25.8,1140,88.3,958,74.2,182,14.1,151,11.7
08,02,06,24,1145,100.0,304,26.6,1018,88.9,841,73.4,177,15.5,127,11.1
08,02,06,25,3338,100.0,885,26.5,2890,86.6,2453,73.5,437,13.1,448,13.4
08,02,07,26,8343,100.0,1873,22.4,7531,90.3,6470,77.6,1061,12.7,812,9.7
08,02,07,27,11769,100.0,3023,25.7,10450,88.8,8746,74.3,1704,14.5,1319,11.2
08,02,07,28,8388,100.0,3083,36.8,6850,81.7,5305,63.2,1545,18.4,1538,18.3
08,03,08,29,12447,100.0,5912,47.5,10058,80.8,6535,52.5,3523,28.3,2389,19.2
08,03,08,30,7244,100.0,2675,36.9,6217,85.8,4569,63.1,1648,22.7,1027,14.2
08,03,08,31,17151,100.0,8202,47.8,13763,80.2,8949,52.2,4814,28.1,3388,19.8
08,04,09,32,2844,100.0,793,27.9,2536,89.2,2051,72.1,485,17.1,308,10.8
08,04,09,33,4051,100.0,1167,28.8,3556,87.8,2884,71.2,672,16.6,495,12.2
08,04,09,34,2686,100.0,747,27.8,2394,89.1,1939,72.2,455,16.9,292,10.9
08,04,10,35,8090,100.0,2271,28.1,7180,88.8,5819,71.9,1361,16.8,910,11.2
08,04,10,36,6788,100.0,1352,19.9,6277,92.5,5436,80.1,841,12.4,511,7.5
08,04,10,37,9637,100.0,2102,21.8,8696,90.2,7535,78.2,1161,12.0,941,9.8
08,04,10,38,6911,100.0,1441,20.9,6423,92.9,5470,79.1,953,13.8,488,7.1
08,04,10,39,3876,100.0,1095,28.3,3510,90.6,2781,71.7,729,18.8,366,9.4
08,04,10,40,7936,100.0,1619,20.4,7334,92.4,6317,79.6,1017,12.8,602,7.6
09,01,01,01,11862,100.0,3253,27.4,9853,83.1,8609,72.6,1244,10.5,2009,16.9
09,01,01,02,72,100.0,17,23.6,62,86.1,55,76.4,7,9.7,10,13.9
09,01,02,01,4304,100.0,623,14.5,3994,92.8,3681,85.5,313,7.3,310,7.2
09,01,02,02,6730,100.0,722,10.7,6289,93.4,6008,89.3,281,4.2,441,6.6
09,01,03,01,15281,100.0,1814,11.9,14223,93.1,13467,88.1,756,4.9,1058,6.9
09,01,03,02,2907,100.0,569,19.6,2647,91.1,2338,80.4,309,10.6,260,8.9
09,01,04,01,8028,100.0,499,6.2,7752,96.6,7529,93.8,223,2.8,276,3.4
09,01,04,02,11496,100.0,1802,15.7,10346,90.0,9694,84.3,652,5.7,1150,10.0
09,02,05,01,6470,100.0,1454,22.5,5373,83.0,5016,77.5,357,5.5,1097,17.0
09,02,05,02,14678,100.0,2230,15.2,13237,90.2,12448,84.8,789,5.4,1441,9.8
09,02,06,01,7426,100.0,1283,17.3,6484,87.3,6143,82.7,341,4.6,942,12.7
09,02,06,02,3554,100.0,193,5.4,3453,97.2,3361,94.6,92,2.6,101,2.8
09,02,07,01,1212,100.0,736,60.7,526,43.4,476,39.3,50,4.1,686,56.6
09,02,07,02,16072,100.0,1834,11.4,14805,92.1,14238,88.6,567,3.5,1267,7.9
09,02,08,01,2921,100.0,176,6.0,2827,96.8,2745,94.0,82,2.8,94,3.2
09,02,08,02,7819,100.0,1240,15.9,6938,88.7,6579,84.1,359,4.6,881,11.3
09,03,09,01,12950,100.0,1571,12.1,12119,93.6,11379,87.9,740,5.7,831,6.4
09,03,09,02,5819,100.0,639,11.0,5518,94.8,5180,89.0,338,5.8,301,5.2
09,03,09,03,7792,100.0,998,12.8,7483,96.0,6794,87.2,689,8.8,309,4.0
09,03,10,01,12849,100.0,1344,10.5,11949,93.0,11505,89.5,444,3.5,900,7.0
09,03,11,01,6032,100.0,692,11.5,5521,91.5,5340,88.5,181,3.0,511,8.5
09,03,12,01,1780,100.0,137,7.7,1717,96.5,1643,92.3,74,4.2,63,3.5
09,03,12,02,2438,100.0,165,6.8,2341,96.0,2273,93.2,68,2.8,97,4.0
09,04,13,01,14419,100.0,1102,7.6,13625,94.5,13317,92.4,308,2.1,794,5.5
09,04,13,02,1803,100.0,143,7.9,1750,97.1,1660,92.1,90,5.0,53,2.9
09,04,14,01,4816,100.0,567,11.8,4370,90.7,4249,88.2,121,2.5,446,9.3
09,04,14,02,1495,100.0,142,9.5,1454,97.3,1353,90.5,101,6.8,41,2.7
09,04,15,01,7304,100.0,896,12.3,6791,93.0,6408,87.7,383,5.2,513,7.0
09,04,16,01,6589,100.0,335,5.1,6447,97.8,6254,94.9,193,2.9,142,2.2
09,05,17,01,3590,100.0,213,5.9,3438,95.8,3377,94.1,61,1.7,152,4.2
09,05,17,02,14698,100.0,895,6.1,14197,96.6,13803,93.9,394,2.7,501,3.4
09,05,18,01,9375,100.0,775,8.3,8870,94.6,8600,91.7,270,2.9,505,5.4
09,05,19,01,10500,100.0,844,8.0,9987,95.1,9656,92.0,331,3.2,513,4.9
09,05,20,01,12701,100.0,671,5.3,12326,97.0,12030,94.7,296,2.3,375,3.0
10,01,01,01,5669,100.0,1376,24.3,5013,88.4,4293,75.7,720,12.7,656,11.6
10,01,01,02,17929,100.0,3885,21.7,16380,91.4,14044,78.3,2336,13.0,1549,8.6
10,01,02,03,1526,100.0,1100,72.1,463,30.3,426,27.9,37,2.4,1063,69.7
10,01,02,04,10464,100.0,2084,19.9,9636,92.1,8380,80.1,1256,12.0,828,7.9
10,01,02,05,8422,100.0,1278,15.2,7681,91.2,7144,84.8,537,6.4,741,8.8
10,01,02,06,17167,100.0,3494,20.4,15206,88.6,13673,79.6,1533,8.9,1961,11.4
10,01,02,07,10786,100.0,2275,21.1,9802,90.9,8511,78.9,1291,12.0,984,9.1
10,01,03,08,2413,100.0,773,32.0,1817,75.3,1640,68.0,177,7.3,596,24.7
10,01,03,09,14410,100.0,2739,19.0,13383,92.9,11671,81.0,1712,11.9,1027,7.1
10,01,03,10,17804,100.0,3038,17.1,16584,93.1,14766,82.9,1818,10.2,1220,6.9
10,01,03,11,2953,100.0,364,12.3,2867,97.1,2589,87.7,278,9.4,86,2.9
10,02,04,12,6787,100.0,1748,25.8,5944,87.6,5039,74.2,905,13.3,843,12.4
10,02,04,13,15163,100.0,2095,13.8,14077,92.8,13068,86.2,1009,6.7,1086,7.2
10,02,04,14,1653,100.0,626,37.9,1484,89.8,1027,62.1,457,27.6,169,10.2
10,02,04,15,5532,100.0,1182,21.4,4725,85.4,4350,78.6,375,6.8,807,14.6
10,02,04,16,5661,100.0,1374,24.3,4796,84.7,4287,75.7,509,9.0,865,15.3
10,02,05,17,8775,100.0,716,8.2,8462,96.4,8059,91.8,403,4.6,313,3.6
10,02,05,18,5058,100.0,621,12.3,4687,92.7,4437,87.7,250,4.9,371,7.3
10,02,05,19,6003,100.0,1597,26.6,4800,80.0,4406,73.4,394,6.6,1203,20.0
10,02,06,20,3308,100.0,435,13.1,3125,94.5,2873,86.9,252,7.6,183,5.5
10,02,06,21,6051,100.0,764,12.6,5633,93.1,5287,87.4,346,5.7,418,6.9
10,02,06,22,8684,100.0,980,11.3,8258,95.1,7704,88.7,554,6.4,426,4.9
10,02,06,23,6558,100.0,614,9.4,6340,96.7,5944,90.6,396,6.0,218,3.3
10,03,07,24,7835,100.0,1157,14.8,7031,89.7,6678,85.2,353,4.5,804,10.3
10,03,07,25,6244,100.0,1113,17.8,5510,88.2,5131,82.2,379,6.1,734,11.8
10,03,07,26,2982,100.0,257,8.6,2870,96.2,2725,91.4,145,4.9,112,3.8
10,03,07,27,9251,100.0,741,8.0,8983,97.1,8510,92.0,473,5.1,268,2.9
10,04,08,28,7661,100.0,450,5.9,7482,97.7,7211,94.1,271,3.5,179,2.3
10,04,08,29,3704,100.0,271,7.3,3532,95.4,3433,92.7,99,2.7,172,4.6
10,04,08,30,7556,100.0,401,5.3,7402,98.0,7155,94.7,247,3.3,154,2.0
10,04,09,31,9298,100.0,570,6.1,9076,97.6,8728,93.9,348,3.7,222,2.4
10,04,09,32,3986,100.0,311,7.8,3812,95.6,3675,92.2,137,3.4,174,4.4
10,04,09,33,14661,100.0,731,5.0,14329,97.7,13930,95.0,399,2.7,332,2.3
11,01,01,01,557,100.0,44,7.9,525,94.3,513,92.1,12,2.2,32,5.7
11,01,01,02,2558,100.0,122,4.8,2509,98.1,2436,95.2,73,2.9,49,1.9
11,01,01,03,1599,100.0,410,25.6,1259,78.7,1189,74.4,70,4.4,340,21.3
11,01,02,04,8903,100.0,2231,25.1,7729,86.8,6672,74.9,1057,11.9,1174,13.2
11,01,02,05,6737,100.0,1612,23.9,5959,88.5,5125,76.1,834,12.4,778,11.5
11,01,02,06,5925,100.0,1022,17.2,5374,90.7,4903,82.8,471,7.9,551,9.3
11,01,02,07,7039,100.0,1083,15.4,6468,91.9,5956,84.6,512,7.3,571,8.1
11,01,03,08,11583,100.0,2730,23.6,10191,88.0,8853,76.4,1338,11.6,1392,12.0
11,01,03,09,9881,100.0,2316,23.4,8467,85.7,7565,76.6,902,9.1,1414,14.3
11,01,03,10,5172,100.0,482,9.3,4954,95.8,4690,90.7,264,5.1,218,4.2
11,02,04,11,8755,100.0,1645,18.8,7597,86.8,7110,81.2,487,5.6,1158,13.2
11,02,04,12,6303,100.0,987,15.7,5770,91.5,5316,84.3,454,7.2,533,8.5
11,02,05,13,3991,100.0,747,18.7,3373,84.5,3244,81.3,129,3.2,618,15.5
11,02,05,14,8936,100.0,1452,16.2,7799,87.3,7484,83.8,315,3.5,1137,12.7
11,02,05,15,14418,100.0,2955,20.5,12755,88.5,11463,79.5,1292,9.0,1663,11.5
11,02,05,16,3736,100.0,345,9.2,3595,96.2,3391,90.8,204,5.5,141,3.8
11,03,06,17,6042,100.0,1681,27.8,5067,83.9,4361,72.2,706,11.7,975,16.1
11,03,06,18,15803,100.0,3393,21.5,13873,87.8,12410,78.5,1463,9.3,1930,12.2
11,03,06,19,10700,100.0,2788,26.1,9132,85.3,7912,73.9,1220,11.4,1568,14.7
11,03,07,20,5953,100.0,3893,65.4,2325,39.1,2060,34.6,265,4.5,3628,60.9
11,03,07,21,25130,100.0,6485,25.8,20235,80.5,18645,74.2,1590,6.3,4895,19.5
11,03,08,24,9996,100.0,3062,30.6,8212,82.2,6934,69.4,1278,12.8,1784,17.8
11,04,09,25,3705,100.0,694,18.7,3246,87.6,3011,81.3,235,6.3,459,12.4
11,04,09,26,27949,100.0,4762,17.0,24873,89.0,23187,83.0,1686,6.0,3076,11.0
11,04,10,22,5416,100.0,1544,28.5,4357,80.4,3872,71.5,485,9.0,1059,19.6
11,04,10,23,5882,100.0,1600,27.2,4997,85.0,4282,72.8,715,12.2,885,15.0
11,04,10,27,2766,100.0,606,21.9,2390,86.4,2160,78.1,230,8.3,376,13.6
11,04,11,28,25013,100.0,4703,18.8,22207,88.8,20310,81.2,1897,7.6,2806,11.2
11,05,12,29,3469,100.0,464,13.4,3257,93.9,3005,86.6,252,7.3,212,6.1
11,05,13,30,9329,100.0,1635,17.5,8121,87.1,7694,82.5,427,4.6,1208,12.9
11,05,13,31,10783,100.0,1881,17.4,9313,86.4,8902,82.6,411,3.8,1470,13.6
11,05,13,32,6692,100.0,675,10.1,6394,95.5,6017,89.9,377,5.6,298,4.5
12,10,31,15,7501,100.0,2892,38.6,5865,78.2,4609,61.4,1256,16.7,1636,21.8
12,10,31,16,9348,100.0,3935,42.1,7135,76.3,5413,57.9,1722,18.4,2213,23.7
12,10,31,17,10567,100.0,5169,48.9,7446,70.5,5398,51.1,2048,19.4,3121,29.5
12,10,32,18,13314,100.0,5177,38.9,10574,79.4,8137,61.1,2437,18.3,2740,20.6
12,10,32,19,8659,100.0,3382,39.1,6857,79.2,5277,60.9,1580,18.2,1802,20.8
12,10,32,20,4571,100.0,1134,24.8,4028,88.1,3437,75.2,591,12.9,543,11.9
12,21,41,25,7262,100.0,1846,25.4,6318,87.0,5416,74.6,902,12.4,944,13.0
12,21,41,26,7674,100.0,2466,32.1,6564,85.5,5208,67.9,1356,17.7,1110,14.5
12,21,44,21,2600,100.0,851,32.7,2136,82.2,1749,67.3,387,14.9,464,17.8
12,21,44,22,7876,100.0,4278,54.3,5557,70.6,3598,45.7,1959,24.9,2319,29.4
12,21,44,23,5547,100.0,1967,35.5,4625,83.4,3580,64.5,1045,18.8,922,16.6
12,21,44,24,10704,100.0,5051,47.2,7590,70.9,5653,52.8,1937,18.1,3114,29.1
12,21,45,27,10610,100.0,1942,18.3,9551,90.0,8668,81.7,883,8.3,1059,10.0
12,21,45,28,285,100.0,88,30.9,237,83.2,197,69.1,40,14.0,48,16.8
12,22,42,29,5999,100.0,726,12.1,5703,95.1,5273,87.9,430,7.2,296,4.9
12,22,42,30,18123,100.0,2145,11.8,17183,94.8,15978,88.2,1205,6.6,940,5.2
12,23,11,01,16440,100.0,1858,11.3,15559,94.6,14582,88.7,977,5.9,881,5.4
12,23,11,02,16782,100.0,1830,10.9,16074,95.8,14952,89.1,1122,6.7,708,4.2
12,30,12,03,15201,100.0,4368,28.7,12345,81.2,10833,71.3,1512,9.9,2856,18.8
12,30,12,04,6678,100.0,1760,26.4,5574,83.5,4918,73.6,656,9.8,1104,16.5
12,30,12,05,4887,100.0,799,16.3,4538,92.9,4088,83.7,450,9.2,349,7.1
12,30,12,06,5088,100.0,733,14.4,4842,95.2,4355,85.6,487,9.6,246,4.8
12,30,21,07,3031,100.0,1109,36.6,2571,84.8,1922,63.4,649,21.4,460,15.2
12,30,21,08,14302,100.0,5709,39.9,11556,80.8,8593,60.1,2963,20.7,2746,19.2
12,30,21,09,11523,100.0,5593,48.5,8705,75.5,5930,51.5,2775,24.1,2818,24.5
12,30,21,10,10405,100.0,5381,51.7,7719,74.2,5024,48.3,2695,25.9,2686,25.8
12,30,22,11,3260,100.0,788,24.2,2934,90.0,2472,75.8,462,14.2,326,10.0
12,30,22,12,5781,100.0,2280,39.4,4506,77.9,3501,60.6,1005,17.4,1275,22.1
12,30,43,13,6592,100.0,1279,19.4,5854,88.8,5313,80.6,541,8.2,738,11.2
12,30,43,14,9643,100.0,1160,12.0,9120,94.6,8483,88.0,637,6.6,523,5.4
