district_id,forecast_area_id,district_region_id,planning_area_id,inhabitants,inhabitants_percentage,inhabitants_with_migration_background,inhabitants_with_migration_background_percentage,inhabitants_germans,inhabitants_germans_percentage,inhabitants_germans_without_migration_background,inhabitants_germans_without_migration_background_percentage,inhabitants_germans_with_migration_background,inhabitants_germans_with_migration_background_percentage,inhabitants_foreigners,inhabitants_foreigners_percentage
01,01,11,01,3114,100.0,1747,56.1,1907,61.2,1367,43.9,540,17.3,1207,38.8
01,01,11,02,192,100.0,71,37.0,140,72.9,121,63.0,19,9.9,52,27.1
01,01,11,03,5518,100.0,3248,58.9,3370,61.1,2270,41.1,1100,19.9,2148,38.9
01,01,11,04,4704,100.0,3030,64.4,2904,61.7,1674,35.6,1230,26.1,1800,38.3
01,01,11,05,1135,100.0,657,57.9,677,59.6,478,42.1,199,17.5,458,40.4
01,01,12,01,2190,100.0,1171,53.5,1418,64.7,1019,46.5,399,18.2,772,35.3
01,01,12,02,608,100.0,288,47.4,387,63.7,320,52.6,67,11.0,221,36.3
01,01,12,03,1004,100.0,512,51.0,629,62.6,492,49.0,137,13.6,375,37.4
01,01,12,04,7463,100.0,3303,44.3,5287,70.8,4160,55.7,1127,15.1,2176,29.2
01,01,13,01,6431,100.0,2538,39.5,4616,71.8,3893,60.5,723,11.2,1815,28.2
01,01,13,02,12535,100.0,4699,37.5,9289,74.1,7836,62.5,1453,11.6,3246,25.9
01,01,13,03,9536,100.0,4169,43.7,6457,67.7,5367,56.3,1090,11.4,3079,32.3
01,01,13,04,8607,100.0,3084,35.8,6683,77.6,5523,64.2,1160,13.5,1924,22.4
01,01,13,05,7617,100.0,2653,34.8,5878,77.2,4964,65.2,914,12.0,1739,22.8
01,01,13,06,9530,100.0,3726,39.1,6981,73.3,5804,60.9,1177,12.4,2549,26.7
01,01,14,01,16331,100.0,6296,38.6,11787,72.2,10035,61.4,1752,10.7,4544,27.8
01,01,14,02,13341,100.0,4877,36.6,9962,74.7,8464,63.4,1498,11.2,3379,25.3
01,02,21,01,3522,100.0,1825,51.8,2266,64.3,1697,48.2,569,16.2,1256,35.7
01,02,21,02,6374,100.0,3719,58.3,3821,59.9,2655,41.7,1166,18.3,2553,40.1
01,02,21,03,258,100.0,186,72.1,126,48.8,72,27.9,54,20.9,132,51.2
01,02,21,04,18377,100.0,8842,48.1,12699,69.1,9535,51.9,3164,17.2,5678,30.9
01,02,21,05,5299,100.0,3064,57.8,3368,63.6,2235,42.2,1133,21.4,1931,36.4
01,02,21,06,11799,100.0,4232,35.9,9209,78.0,7567,64.1,1642,13.9,2590,22.0
01,02,22,01,11292,100.0,5663,50.2,7701,68.2,5629,49.8,2072,18.3,3591,31.8
01,02,22,02,1488,100.0,972,65.3,1006,67.6,516,34.7,490,32.9,482,32.4
01,02,22,03,6969,100.0,4057,58.2,4647,66.7,2912,41.8,1735,24.9,2322,33.3
01,02,22,04,5824,100.0,2334,40.1,4363,74.9,3490,59.9,873,15.0,1461,25.1
01,02,22,05,3311,100.0,1969,59.5,2278,68.8,1342,40.5,936,28.3,1033,31.2
01,02,22,06,3027,100.0,1195,39.5,2379,78.6,1832,60.5,547,18.1,648,21.4
01,02,22,07,5630,100.0,2468,43.8,3885,69.0,3162,56.2,723,12.8,1745,31.0
01,03,31,01,26841,100.0,16504,61.5,15890,59.2,10337,38.5,5553,20.7,10951,40.8
01,03,31,02,11837,100.0,7182,60.7,7328,61.9,4655,39.3,2673,22.6,4509,38.1
01,03,32,01,13361,100.0,8873,66.4,9177,68.7,4488,33.6,4689,35.1,4184,31.3
01,03,32,02,9726,100.0,5343,54.9,7171,73.7,4383,45.1,2788,28.7,2555,26.3
01,03,32,03,14478,100.0,9098,62.8,8835,61.0,5380,37.2,3455,23.9,5643,39.0
01,04,41,01,20722,100.0,9735,47.0,14432,69.6,10987,53.0,3445,16.6,6290,30.4
01,04,41,02,16238,100.0,6159,37.9,12565,77.4,10079,62.1,2486,15.3,3673,22.6
01,04,41,03,8589,100.0,4451,51.8,5498,64.0,4138,48.2,1360,15.8,3091,36.0
01,04,42,01,23424,100.0,15744,67.2,13375,57.1,7680,32.8,5695,24.3,10049,42.9
01,04,42,02,16703,100.0,9539,57.1,10058,60.2,7164,42.9,2894,17.3,6645,39.8
01,04,42,03,16462,100.0,9510,57.8,10027,60.9,6952,42.2,3075,18.7,6435,39.1
02,01,01,01,6481,100.0,4617,71.2,3635,56.1,1864,28.8,1771,27.3,2846,43.9
02,01,01,02,13278,100.0,8933,67.3,9025,68.0,4345,32.7,4680,35.2,4253,32.0
02,01,01,03,15593,100.0,10842,69.5,10009,64.2,4751,30.5,5258,33.7,5584,35.8
02,01,01,04,5044,100.0,3252,64.5,3410,67.6,1792,35.5,1618,32.1,1634,32.4
02,02,02,01,911,100.0,443,48.6,642,70.5,468,51.4,174,19.1,269,29.5
02,02,02,02,5990,100.0,2535,42.3,4317,72.1,3455,57.7,862,14.4,1673,27.9
02,02,02,03,10886,100.0,4126,37.9,8343,76.6,6760,62.1,1583,14.5,2543,23.4
02,02,02,04,12326,100.0,5016,40.7,9152,74.2,7310,59.3,1842,14.9,3174,25.8
02,02,02,05,14892,100.0,5900,39.6,11271,75.7,8992,60.4,2279,15.3,3621,24.3
02,02,02,06,19052,100.0,8587,45.1,13829,72.6,10465,54.9,3364,17.7,5223,27.4
02,03,03,01,9092,100.0,5684,62.5,5624,61.9,3408,37.5,2216,24.4,3468,38.1
02,03,03,02,13166,100.0,6974,53.0,8845,67.2,6192,47.0,2653,20.2,4321,32.8
02,03,04,01,15156,100.0,7197,47.5,10405,68.7,7959,52.5,2446,16.1,4751,31.3
02,03,04,02,11083,100.0,5413,48.8,7536,68.0,5670,51.2,1866,16.8,3547,32.0
02,04,05,01,5381,100.0,1263,23.5,4647,86.4,4118,76.5,529,9.8,734,13.6
02,04,05,02,7181,100.0,1831,25.5,6022,83.9,5350,74.5,672,9.4,1159,16.1
02,04,05,03,10976,100.0,2596,23.7,9223,84.0,8380,76.3,843,7.7,1753,16.0
02,04,07,01,12331,100.0,4341,35.2,9493,77.0,7990,64.8,1503,12.2,2838,23.0
02,04,07,02,10714,100.0,2446,22.8,9060,84.6,8268,77.2,792,7.4,1654,15.4
02,04,07,03,1145,100.0,762,66.6,485,42.4,383,33.4,102,8.9,660,57.6
02,05,06,01,8900,100.0,2452,27.6,7168,80.5,6448,72.4,720,8.1,1732,19.5
02,05,06,02,21064,100.0,5664,26.9,17100,81.2,15400,73.1,1700,8.1,3964,18.8
02,05,08,01,19093,100.0,5805,30.4,14833,77.7,13288,69.6,1545,8.1,4260,22.3
02,05,08,02,20431,100.0,5809,28.4,16096,78.8,14622,71.6,1474,7.2,4335,21.2
02,05,08,03,6986,100.0,1987,28.4,5571,79.7,4999,71.6,572,8.2,1415,20.3
02,05,08,04,4171,100.0,895,21.5,3650,87.5,3276,78.5,374,9.0,521,12.5
03,01,01,01,3928,100.0,469,11.9,3620,92.2,3459,88.1,161,4.1,308,7.8
03,01,01,02,11685,100.0,1530,13.1,10582,90.6,10155,86.9,427,3.7,1103,9.4
03,01,01,04,227,100.0,52,22.9,197,86.8,175,77.1,22,9.7,30,13.2
03,02,02,03,2116,100.0,102,4.8,2083,98.4,2014,95.2,69,3.3,33,1.6
03,02,02,09,14726,100.0,2092,14.2,13457,91.4,12634,85.8,823,5.6,1269,8.6
03,02,02,10,11132,100.0,1372,12.3,10331,92.8,9760,87.7,571,5.1,801,7.2
03,02,03,07,17930,100.0,1972,11.0,17194,95.9,15958,89.0,1236,6.9,736,4.1
03,03,04,05,10986,100.0,1247,11.4,10359,94.3,9739,88.6,620,5.6,627,5.7
03,03,04,06,8245,100.0,602,7.3,7970,96.7,7643,92.7,327,4.0,275,3.3
03,03,07,11,6810,100.0,356,5.2,6651,97.7,6454,94.8,197,2.9,159,2.3
03,03,07,15,7388,100.0,1188,16.1,6536,88.5,6200,83.9,336,4.5,852,11.5
03,03,07,16,1138,100.0,36,3.2,1118,98.2,1102,96.8,16,1.4,20,1.8
03,04,05,08,4530,100.0,844,18.6,4287,94.6,3686,81.4,601,13.3,243,5.4
03,04,05,12,9783,100.0,1233,12.6,9224,94.3,8550,87.4,674,6.9,559,5.7
03,04,05,13,3412,100.0,452,13.2,3198,93.7,2960,86.8,238,7.0,214,6.3
03,04,06,14,35308,100.0,4326,12.3,32859,93.1,30982,87.7,1877,5.3,2449,6.9
03,04,08,18,34314,100.0,4831,14.1,31128,90.7,29483,85.9,1645,4.8,3186,9.3
03,05,09,19,5564,100.0,1032,18.5,4694,84.4,4532,81.5,162,2.9,870,15.6
03,05,09,20,7397,100.0,955,12.9,6824,92.3,6442,87.1,382,5.2,573,7.7
03,05,09,23,9098,100.0,1582,17.4,8034,88.3,7516,82.6,518,5.7,1064,11.7
03,05,09,24,5883,100.0,1223,20.8,4984,84.7,4660,79.2,324,5.5,899,15.3
03,05,09,25,9468,100.0,1464,15.5,8545,90.3,8004,84.5,541,5.7,923,9.7
03,05,10,17,4247,100.0,739,17.4,3709,87.3,3508,82.6,201,4.7,538,12.7
03,05,10,21,6503,100.0,649,10.0,6027,92.7,5854,90.0,173,2.7,476,7.3
03,05,10,22,4527,100.0,274,6.1,4383,96.8,4253,93.9,130,2.9,144,3.2
03,06,11,26,15187,100.0,3881,25.6,12486,82.2,11306,74.4,1180,7.8,2701,17.8
03,06,11,31,10521,100.0,3281,31.2,8182,77.8,7240,68.8,942,9.0,2339,22.2
03,06,12,27,14520,100.0,3412,23.5,12236,84.3,11108,76.5,1128,7.8,2284,15.7
03,06,12,28,12619,100.0,2497,19.8,10896,86.3,10122,80.2,774,6.1,1723,13.7
03,06,13,32,22519,100.0,6464,28.7,18187,80.8,16055,71.3,2132,9.5,4332,19.2
03,06,14,29,10082,100.0,1295,12.8,9265,91.9,8787,87.2,478,4.7,817,8.1
03,06,14,30,3921,100.0,1435,36.6,2675,68.2,2486,63.4,189,4.8,1246,31.8
03,06,14,34,6238,100.0,1396,22.4,5288,84.8,4842,77.6,446,7.1,950,15.2
03,06,14,35,3875,100.0,965,24.9,3209,82.8,2910,75.1,299,7.7,666,17.2
03,06,14,41,2560,100.0,648,25.3,2217,86.6,1912,74.7,305,11.9,343,13.4
03,07,15,36,10747,100.0,3628,33.8,8271,77.0,7119,66.2,1152,10.7,2476,23.0
03,07,15,37,15635,100.0,5114,32.7,11994,76.7,10521,67.3,1473,9.4,3641,23.3
03,07,16,33,3010,100.0,694,23.1,2583,85.8,2316,76.9,267,8.9,427,14.2
03,07,16,38,17260,100.0,5083,29.4,13831,80.1,12177,70.6,1654,9.6,3429,19.9
03,07,16,39,12367,100.0,3029,24.5,10409,84.2,9338,75.5,1071,8.7,1958,15.8
04,01,01,01,11043,100.0,5130,46.5,7925,71.8,5913,53.5,2012,18.2,3118,28.2
04,01,01,02,895,100.0,369,41.2,569,63.6,526,58.8,43,4.8,326,36.4
04,01,01,03,7771,100.0,3994,51.4,5823,74.9,3777,48.6,2046,26.3,1948,25.1
04,02,02,04,199,100.0,71,35.7,157,78.9,128,64.3,29,14.6,42,21.1
04,02,02,05,1329,100.0,333,25.1,1129,85.0,996,74.9,133,10.0,200,15.0
04,02,02,06,2754,100.0,628,22.8,2388,86.7,2126,77.2,262,9.5,366,13.3
04,02,02,07,2532,100.0,698,27.6,2128,84.0,1834,72.4,294,11.6,404,16.0
04,02,02,08,2878,100.0,727,25.3,2490,86.5,2151,74.7,339,11.8,388,13.5
04,02,02,09,3189,100.0,1166,36.6,2301,72.2,2023,63.4,278,8.7,888,27.8
04,02,03,10,602,100.0,297,49.3,344,57.1,305,50.7,39,6.5,258,42.9
04,02,03,11,14756,100.0,4529,30.7,11990,81.3,10227,69.3,1763,11.9,2766,18.7
04,02,03,12,5467,100.0,1681,30.7,4393,80.4,3786,69.3,607,11.1,1074,19.6
04,02,03,13,7530,100.0,2915,38.7,5622,74.7,4615,61.3,1007,13.4,1908,25.3
04,02,03,14,436,100.0,436,100.0,3,0.7,0,0.0,3,0.7,433,99.3
04,03,04,15,2837,100.0,1431,50.4,1762,62.1,1406,49.6,356,12.5,1075,37.9
04,03,04,16,10655,100.0,5103,47.9,7680,72.1,5552,52.1,2128,20.0,2975,27.9
04,03,04,17,10927,100.0,4051,37.1,8474,77.6,6876,62.9,1598,14.6,2453,22.4
04,03,05,18,9417,100.0,4021,42.7,7022,74.6,5396,57.3,1626,17.3,2395,25.4
04,03,05,19,5734,100.0,2464,43.0,4280,74.6,3270,57.0,1010,17.6,1454,25.4
04,03,06,20,8597,100.0,3699,43.0,6437,74.9,4898,57.0,1539,17.9,2160,25.1
04,03,06,21,3021,100.0,1609,53.3,2027,67.1,1412,46.7,615,20.4,994,32.9
04,03,06,22,10459,100.0,4759,45.5,7635,73.0,5700,54.5,1935,18.5,2824,27.0
04,03,06,23,4788,100.0,2617,54.7,3270,68.3,2171,45.3,1099,23.0,1518,31.7
04,03,07,24,6416,100.0,2236,34.9,5062,78.9,4180,65.1,882,13.7,1354,21.1
04,03,07,25,12128,100.0,4738,39.1,9021,74.4,7390,60.9,1631,13.4,3107,25.6
04,03,07,26,5426,100.0,2260,41.7,4038,74.4,3166,58.3,872,16.1,1388,25.6
04,03,08,27,12238,100.0,6345,51.8,8064,65.9,5893,48.2,2171,17.7,4174,34.1
04,03,08,28,9491,100.0,4110,43.3,6843,72.1,5381,56.7,1462,15.4,2648,27.9
04,03,09,29,5981,100.0,2514,42.0,4389,73.4,3467,58.0,922,15.4,1592,26.6
04,03,09,30,5600,100.0,2460,43.9,4001,71.4,3140,56.1,861,15.4,1599,28.6
04,03,09,31,3915,100.0,2259,57.7,2280,58.2,1656,42.3,624,15.9,1635,41.8
04,03,10,32,14931,100.0,5873,39.3,11474,76.8,9058,60.7,2416,16.2,3457,23.2
04,04,11,33,43,100.0,15,34.9,34,79.1,28,65.1,6,14.0,9,20.9
04,04,11,34,5156,100.0,1937,37.6,4040,78.4,3219,62.4,821,15.9,1116,21.6
04,04,11,35,2739,100.0,899,32.8,2248,82.1,1840,67.2,408,14.9,491,17.9
04,04,11,36,3033,100.0,980,32.3,2470,81.4,2053,67.7,417,13.7,563,18.6
04,04,11,37,7976,100.0,2748,34.5,6477,81.2,5228,65.5,1249,15.7,1499,18.8
04,04,12,38,5907,100.0,1854,31.4,5005,84.7,4053,68.6,952,16.1,902,15.3
04,04,12,39,213,100.0,125,58.7,106,49.8,88,41.3,18,8.5,107,50.2
04,04,12,40,1533,100.0,392,25.6,1330,86.8,1141,74.4,189,12.3,203,13.2
04,04,12,41,6904,100.0,1578,22.9,6026,87.3,5326,77.1,700,10.1,878,12.7
04,04,13,42,4115,100.0,1279,31.1,3414,83.0,2836,68.9,578,14.0,701,17.0
04,04,13,43,3547,100.0,1043,29.4,2995,84.4,2504,70.6,491,13.8,552,15.6
04,04,13,44,10642,100.0,2757,25.9,8999,84.6,7885,74.1,1114,10.5,1643,15.4
04,05,14,45,6220,100.0,2550,41.0,4797,77.1,3670,59.0,1127,18.1,1423,22.9
04,05,14,46,10591,100.0,4384,41.4,8048,76.0,6207,58.6,1841,17.4,2543,24.0
04,05,14,47,5228,100.0,2057,39.3,3978,76.1,3171,60.7,807,15.4,1250,23.9
04,05,14,48,9067,100.0,4025,44.4,6512,71.8,5042,55.6,1470,16.2,2555,28.2
04,05,15,49,5348,100.0,2669,49.9,3336,62.4,2679,50.1,657,12.3,2012,37.6
04,05,15,50,5512,100.0,2098,38.1,4297,78.0,3414,61.9,883,16.0,1215,22.0
04,05,15,51,4397,100.0,1772,40.3,3385,77.0,2625,59.7,760,17.3,1012,23.0
04,05,16,52,9700,100.0,3604,37.2,7441,76.7,6096,62.8,1345,13.9,2259,23.3
04,05,16,53,6684,100.0,2605,39.0,5141,76.9,4079,61.0,1062,15.9,1543,23.1
04,05,16,54,3038,100.0,1060,34.9,2378,78.3,1978,65.1,400,13.2,660,21.7
04,05,16,55,7063,100.0,2957,41.9,5255,74.4,4106,58.1,1149,16.3,1808,25.6
04,05,16,56,7568,100.0,2322,30.7,6210,82.1,5246,69.3,964,12.7,1358,17.9
04,06,17,57,83,100.0,24,28.9,65,78.3,59,71.1,6,7.2,18,21.7
05,01,01,01,10883,100.0,3264,30.0,8979,82.5,7619,70.0,1360,12.5,1904,17.5
05,01,01,02,5885,100.0,1247,21.2,5171,87.9,4638,78.8,533,9.1,714,12.1
05,01,01,03,7623,100.0,1226,16.1,7064,92.7,6397,83.9,667,8.7,559,7.3
05,01,02,04,3297,100.0,1257,38.1,2704,82.0,2040,61.9,664,20.1,593,18.0
05,01,02,05,1910,100.0,518,27.1,1727,90.4,1392,72.9,335,17.5,183,9.6
05,01,02,06,10246,100.0,3518,34.3,8620,84.1,6728,65.7,1892,18.5,1626,15.9
05,01,02,07,11492,100.0,5616,48.9,9108,79.3,5876,51.1,3232,28.1,2384,20.7
05,01,02,08,7627,100.0,2367,31.0,6265,82.1,5260,69.0,1005,13.2,1362,17.9
05,01,02,09,6098,100.0,1737,28.5,5345,87.7,4361,71.5,984,16.1,753,12.3
05,01,03,10,3880,100.0,1268,32.7,3142,81.0,2612,67.3,530,13.7,738,19.0
05,01,03,11,5670,100.0,2905,51.2,4126,72.8,2765,48.8,1361,24.0,1544,27.2
05,01,03,12,7117,100.0,3631,51.0,4632,65.1,3486,49.0,1146,16.1,2485,34.9
05,01,03,13,6704,100.0,2550,38.0,5185,77.3,4154,62.0,1031,15.4,1519,22.7
05,01,03,14,11968,100.0,4296,35.9,9630,80.5,7672,64.1,1958,16.4,2338,19.5
05,01,03,39,974,100.0,641,65.8,395,40.6,333,34.2,62,6.4,579,59.4
05,02,04,15,3885,100.0,708,18.2,3698,95.2,3177,81.8,521,13.4,187,4.8
05,02,04,16,1709,100.0,95,5.6,1681,98.4,1614,94.4,67,3.9,28,1.6
05,02,04,17,5847,100.0,1600,27.4,5084,87.0,4247,72.6,837,14.3,763,13.0
05,02,04,18,4010,100.0,738,18.4,3667,91.4,3272,81.6,395,9.9,343,8.6
05,02,04,19,7032,100.0,1673,23.8,6218,88.4,5359,76.2,859,12.2,814,11.6
05,02,04,20,929,100.0,154,16.6,871,93.8,775,83.4,96,10.3,58,6.2
05,02,05,21,3095,100.0,815,26.3,2814,90.9,2280,73.7,534,17.3,281,9.1
05,02,05,22,7364,100.0,3166,43.0,5407,73.4,4198,57.0,1209,16.4,1957,26.6
05,02,05,23,12413,100.0,6700,54.0,9207,74.2,5713,46.0,3494,28.1,3206,25.8
05,02,05,24,6134,100.0,997,16.3,5709,93.1,5137,83.7,572,9.3,425,6.9
05,02,06,25,7482,100.0,2382,31.8,6172,82.5,5100,68.2,1072,14.3,1310,17.5
05,02,06,26,19359,100.0,6961,36.0,14723,76.1,12398,64.0,2325,12.0,4636,23.9
05,02,06,27,4059,100.0,1514,37.3,3247,80.0,2545,62.7,702,17.3,812,20.0
05,02,06,28,1984,100.0,425,21.4,1790,90.2,1559,78.6,231,11.6,194,9.8
05,02,06,29,4413,100.0,611,13.8,4108,93.1,3802,86.2,306,6.9,305,6.9
05,03,07,30,3938,100.0,2083,52.9,3275,83.2,1855,47.1,1420,36.1,663,16.8
05,03,07,31,11622,100.0,4693,40.4,9449,81.3,6929,59.6,2520,21.7,2173,18.7
05,03,08,32,11692,100.0,4926,42.1,8961,76.6,6766,57.9,2195,18.8,2731,23.4
05,03,08,33,1545,100.0,1249,80.8,407,26.3,296,19.2,111,7.2,1138,73.7
05,04,09,34,3965,100.0,1227,30.9,3056,77.1,2738,69.1,318,8.0,909,22.9
05,04,09,35,415,100.0,97,23.4,342,82.4,318,76.6,24,5.8,73,17.6
05,04,09,36,9855,100.0,1582,16.1,9314,94.5,8273,83.9,1041,10.6,541,5.5
05,04,09,37,2151,100.0,294,13.7,2033,94.5,1857,86.3,176,8.2,118,5.5
05,04,09,38,3670,100.0,480,13.1,3472,94.6,3190,86.9,282,7.7,198,5.4
06,01,01,01,6829,100.0,1562,22.9,5989,87.7,5267,77.1,722,10.6,840,12.3
06,01,01,02,8788,100.0,2961,33.7,7130,81.1,5827,66.3,1303,14.8,1658,18.9
06,01,01,03,6300,100.0,1867,29.6,5356,85.0,4433,70.4,923,14.7,944,15.0
06,01,02,04,6914,100.0,2199,31.8,5834,84.4,4715,68.2,1119,16.2,1080,15.6
06,01,02,05,9560,100.0,2727,28.5,8217,86.0,6833,71.5,1384,14.5,1343,14.0
06,01,02,06,7685,100.0,2059,26.8,6580,85.6,5626,73.2,954,12.4,1105,14.4
06,01,02,07,7771,100.0,2347,30.2,6543,84.2,5424,69.8,1119,14.4,1228,15.8
06,01,02,08,6798,100.0,2033,29.9,5676,83.5,4765,70.1,911,13.4,1122,16.5
06,01,02,09,9026,100.0,2712,30.0,7598,84.2,6314,70.0,1284,14.2,1428,15.8
06,01,02,10,4874,100.0,1256,25.8,4226,86.7,3618,74.2,608,12.5,648,13.3
06,02,03,01,4994,100.0,1014,20.3,4514,90.4,3980,79.7,534,10.7,480,9.6
06,02,03,02,5542,100.0,1215,21.9,4942,89.2,4327,78.1,615,11.1,600,10.8
06,02,03,03,7395,100.0,2017,27.3,6377,86.2,5378,72.7,999,13.5,1018,13.8
06,02,03,04,6744,100.0,1742,25.8,5864,87.0,5002,74.2,862,12.8,880,13.0
06,02,03,05,11433,100.0,3617,31.6,9497,83.1,7816,68.4,1681,14.7,1936,16.9
06,02,03,06,6450,100.0,1161,18.0,5975,92.6,5289,82.0,686,10.6,475,7.4
06,02,04,07,4593,100.0,2157,47.0,3553,77.4,2436,53.0,1117,24.3,1040,22.6
06,02,04,08,6827,100.0,1735,25.4,5845,85.6,5092,74.6,753,11.0,982,14.4
06,02,04,09,8200,100.0,1947,23.7,7114,86.8,6253,76.3,861,10.5,1086,13.2
06,02,04,10,7119,100.0,1261,17.7,6392,89.8,5858,82.3,534,7.5,727,10.2
06,02,04,11,8494,100.0,1862,21.9,7681,90.4,6632,78.1,1049,12.3,813,9.6
06,03,05,01,5898,100.0,1338,22.7,5017,85.1,4560,77.3,457,7.7,881,14.9
06,03,05,02,5555,100.0,1196,21.5,4957,89.2,4359,78.5,598,10.8,598,10.8
06,03,05,03,11600,100.0,2958,25.5,10083,86.9,8642,74.5,1441,12.4,1517,13.1
06,03,05,04,11122,100.0,2293,20.6,9898,89.0,8829,79.4,1069,9.6,1224,11.0
06,03,06,05,6935,100.0,1777,25.6,5922,85.4,5158,74.4,764,11.0,1013,14.6
06,03,06,06,5223,100.0,1586,30.4,4335,83.0,3637,69.6,698,13.4,888,17.0
06,03,06,07,3020,100.0,1008,33.4,2349,77.8,2012,66.6,337,11.2,671,22.2
06,03,06,08,13113,100.0,3260,24.9,11570,88.2,9853,75.1,1717,13.1,1543,11.8
06,03,06,09,12047,100.0,2725,22.6,10555,87.6,9322,77.4,1233,10.2,1492,12.4
06,03,06,10,8103,100.0,1701,21.0,7170,88.5,6402,79.0,768,9.5,933,11.5
06,04,07,01,10113,100.0,2084,20.6,8931,88.3,8029,79.4,902,8.9,1182,11.7
06,04,07,02,5292,100.0,1004,19.0,4855,91.7,4288,81.0,567,10.7,437,8.3
06,04,07,03,10851,100.0,2748,25.3,8957,82.5,8103,74.7,854,7.9,1894,17.5
06,04,08,04,7585,100.0,1272,16.8,6918,91.2,6313,83.2,605,8.0,667,8.8
06,04,08,05,5405,100.0,1112,20.6,4834,89.4,4293,79.4,541,10.0,571,10.6
06,04,08,06,7299,100.0,1051,14.4,6755,92.5,6248,85.6,507,6.9,544,7.5
06,04,08,07,5770,100.0,1222,21.2,5121,88.8,4548,78.8,573,9.9,649,11.2
06,04,08,08,4592,100.0,1785,38.9,3799,82.7,2807,61.1,992,21.6,793,17.3
06,04,08,09,5136,100.0,1635,31.8,4033,78.5,3501,68.2,532,10.4,1103,21.5
06,04,08,10,7091,100.0,2000,28.2,5961,84.1,5091,71.8,870,12.3,1130,15.9
07,01,01,01,10130,100.0,4905,48.4,6988,69.0,5225,51.6,1763,17.4,3142,31.0
07,01,01,02,15907,100.0,8557,53.8,10694,67.2,7350,46.2,3344,21.0,5213,32.8
07,01,01,03,10257,100.0,3759,36.6,8004,78.0,6498,63.4,1506,14.7,2253,22.0
07,01,01,04,13701,100.0,7848,57.3,8848,64.6,5853,42.7,2995,21.9,4853,35.4
07,02,02,01,10496,100.0,3542,33.7,8554,81.5,6954,66.3,1600,15.2,1942,18.5
07,02,02,02,10237,100.0,4257,41.6,7668,74.9,5980,58.4,1688,16.5,2569,25.1
07,02,02,03,17768,100.0,7534,42.4,13329,75.0,10234,57.6,3095,17.4,4439,25.0
07,02,02,04,11779,100.0,4107,34.9,9312,79.1,7672,65.1,1640,13.9,2467,20.9
07,03,03,01,24695,100.0,6426,26.0,21132,85.6,18269,74.0,2863,11.6,3563,14.4
07,03,03,02,9351,100.0,2809,30.0,7872,84.2,6542,70.0,1330,14.2,1479,15.8
07,03,03,03,12334,100.0,5128,41.6,9722,78.8,7206,58.4,2516,20.4,2612,21.2
07,04,04,01,18419,100.0,7155,38.8,14462,78.5,11264,61.2,3198,17.4,3957,21.5
07,04,04,02,2293,100.0,453,19.8,2110,92.0,1840,80.2,270,11.8,183,8.0
07,04,04,03,23743,100.0,8251,34.8,19297,81.3,15492,65.2,3805,16.0,4446,18.7
07,04,04,04,5102,100.0,1225,24.0,4516,88.5,3877,76.0,639,12.5,586,11.5
07,04,04,05,11155,100.0,4616,41.4,8535,76.5,6539,58.6,1996,17.9,2620,23.5
07,04,04,06,3911,100.0,2012,51.4,2659,68.0,1899,48.6,760,19.4,1252,32.0
07,05,05,01,16062,100.0,6011,37.4,12957,80.7,10051,62.6,2906,18.1,3105,19.3
07,05,05,02,8120,100.0,2887,35.6,6441,79.3,5233,64.4,1208,14.9,1679,20.7
07,05,05,03,9145,100.0,2697,29.5,7841,85.7,6448,70.5,1393,15.2,1304,14.3
07,05,05,04,5588,100.0,1689,30.2,4864,87.0,3899,69.8,965,17.3,724,13.0
07,05,05,05,10586,100.0,2755,26.0,9388,88.7,7831,74.0,1557,14.7,1198,11.3
07,05,05,06,2305,100.0,571,24.8,2035,88.3,1734,75.2,301,13.1,270,11.7
07,06,06,01,10109,100.0,3926,38.8,7985,79.0,6183,61.2,1802,17.8,2124,21.0
07,06,06,02,4638,100.0,997,21.5,4201,90.6,3641,78.5,560,12.1,437,9.4
07,06,06,03,3176,100.0,1318,41.5,2402,75.6,1858,58.5,544,17.1,774,24.4
07,06,06,04,14304,100.0,4994,34.9,12479,87.2,9310,65.1,3169,22.2,1825,12.8
07,07,07,01,10474,100.0,2017,19.3,9572,91.4,8457,80.7,1115,10.6,902,8.6
07,07,07,02,10801,100.0,1949,18.0,10078,93.3,8852,82.0,1226,11.4,723,6.7
07,07,07,03,7304,100.0,1637,22.4,6590,90.2,5667,77.6,923,12.6,714,9.8
07,07,07,04,8390,100.0,2952,35.2,6916,82.4,5438,64.8,1478,17.6,1474,17.6
07,07,07,05,6973,100.0,1079,15.5,6518,93.5,5894,84.5,624,8.9,455,6.5
07,07,07,06,3919,100.0,774,19.7,3420,87.3,3145,80.3,275,7.0,499,12.7
07,07,07,07,2936,100.0,452,15.4,2705,92.1,2484,84.6,221,7.5,231,7.9
08,01,01,15,874,100.0,357,40.8,646,73.9,517,59.2,129,14.8,228,26.1
08,01,01,16,3576,100.0,1973,55.2,2289,64.0,1603,44.8,686,19.2,1287,36.0
08,01,01,17,15949,100.0,7815,49.0,10678,67.0,8134,51.0,2544,16.0,5271,33.0
08,01,01,18,11755,100.0,6902,58.7,7518,64.0,4853,41.3,2665,22.7,4237,36.0
08,01,02,11,9929,100.0,5725,57.7,6059,61.0,4204,42.3,1855,18.7,3870,39.0
08,01,02,12,7432,100.0,4917,66.2,4922,66.2,2515,33.8,2407,32.4,2510,33.8
08,01,02,13,12649,100.0,6726,53.2,8243,65.2,5923,46.8,2320,18.3,4406,34.8
08,01,02,14,8063,100.0,4445,55.1,5268,65.3,3618,44.9,1650,20.5,2795,34.7
08,01,03,01,27792,100.0,13202,47.5,19223,69.2,14590,52.5,4633,16.7,8569,30.8
08,01,03,02,3670,100.0,1278,34.8,2898,79.0,2392,65.2,506,13.8,772,21.0
08,01,03,03,8512,100.0,5123,60.2,5108,60.0,3389,39.8,1719,20.2,3404,40.0
08,01,04,04,23647,100.0,12428,52.6,15405,65.1,11219,47.4,4186,17.7,8242,34.9
08,01,04,05,9145,100.0,4254,46.5,6255,68.4,4891,53.5,1364,14.9,2890,31.6
08,01,04,06,7071,100.0,3996,56.5,4504,63.7,3075,43.5,1429,20.2,2567,36.3
08,01,04,07,835,100.0,354,42.4,592,70.9,481,57.6,111,13.3,243,29.1
08,01,05,08,5614,100.0,3914,69.7,3758,66.9,1700,30.3,2058,36.7,1856,33.1
08,01,05,09,9489,100.0,6132,64.6,6711,70.7,3357,35.4,3354,35.3,2778,29.3
08,01,05,10,502,100.0,345,68.7,236,47.0,157,31.3,79,15.7,266,53.0
08,02,06,19,10947,100.0,5749,52.5,7562,69.1,5198,47.5,2364,21.6,3385,30.9
08,02,06,20,9286,100.0,3885,41.8,7382,79.5,5401,58.2,1981,21.3,1904,20.5
08,02,06,21,2322,100.0,575,24.8,2121,91.3,1747,75.2,374,16.1,201,8.7
08,02,06,22,14255,100.0,3730,26.2,12492,87.6,10525,73.8,1967,13.8,1763,12.4
08,02,06,23,1289,100.0,352,27.3,1131,87.7,937,72.7,194,15.1,158,12.3
08,02,06,24,1265,100.0,398,31.5,1112,87.9,867,68.5,245,19.4,153,12.1
08,02,06,25,3337,100.0,895,26.8,2883,86.4,2442,73.2,441,13.2,454,13.6
08,02,07,26,8344,100.0,1907,22.9,7528,90.2,6437,77.1,1091,13.1,816,9.8
08,02,07,27,11651,100.0,3003,25.8,10408,89.3,8648,74.2,1760,15.1,1243,10.7
08,02,07,28,8444,100.0,3206,38.0,6832,80.9,5238,62.0,1594,18.9,1612,19.1
08,03,08,29,12454,100.0,5994,48.1,10020,80.5,6460,51.9,3560,28.6,2434,19.5
08,03,08,30,7321,100.0,2771,37.9,6259,85.5,4550,62.1,1709,23.3,1062,14.5
08,03,08,31,17099,100.0,8244,48.2,13732,80.3,8855,51.8,4877,28.5,3367,19.7
08,04,09,32,2879,100.0,842,29.2,2537,88.1,2037,70.8,500,17.4,342,11.9
08,04,09,33,4129,100.0,1211,29.3,3620,87.7,2918,70.7,702,17.0,509,12.3
08,04,09,34,2688,100.0,790,29.4,2373,88.3,1898,70.6,475,17.7,315,11.7
08,04,10,35,8103,100.0,2355,29.1,7149,88.2,5748,70.9,1401,17.3,954,11.8
08,04,10,36,6765,100.0,1369,20.2,6238,92.2,5396,79.8,842,12.4,527,7.8
08,04,10,37,9682,100.0,2175,22.5,8701,89.9,7507,77.5,1194,12.3,981,10.1
08,04,10,38,6913,100.0,1456,21.1,6417,92.8,5457,78.9,960,13.9,496,7.2
08,04,10,39,3858,100.0,1095,28.4,3493,90.5,2763,71.6,730,18.9,365,9.5
08,04,10,40,7987,100.0,1733,21.7,7323,91.7,6254,78.3,1069,13.4,664,8.3
09,01,01,01,11934,100.0,3376,28.3,9827,82.3,8558,71.7,1269,10.6,2107,17.7
09,01,01,02,70,100.0,12,17.1,61,87.1,58,82.9,3,4.3,9,12.9
09,01,02,01,4319,100.0,654,15.1,3980,92.2,3665,84.9,315,7.3,339,7.8
09,01,02,02,6823,100.0,838,12.3,6284,92.1,5985,87.7,299,4.4,539,7.9
09,01,03,01,15387,100.0,1909,12.4,14264,92.7,13478,87.6,786,5.1,1123,7.3
09,01,03,02,2906,100.0,583,20.1,2655,91.4,2323,79.9,332,11.4,251,8.6
09,01,04,01,8203,100.0,587,7.2,7876,96.0,7616,92.8,260,3.2,327,4.0
09,01,04,02,11480,100.0,1817,15.8,10346,90.1,9663,84.2,683,5.9,1134,9.9
09,02,05,01,6683,100.0,1619,24.2,5465,81.8,5064,75.8,401,6.0,1218,18.2
09,02,05,02,14865,100.0,2428,16.3,13254,89.2,12437,83.7,817,5.5,1611,10.8
09,02,06,01,7658,100.0,1449,18.9,6587,86.0,6209,81.1,378,4.9,1071,14.0
09,02,06,02,3512,100.0,187,5.3,3420,97.4,3325,94.7,95,2.7,92,2.6
09,02,07,01,1259,100.0,631,50.1,703,55.8,628,49.9,75,6.0,556,44.2
09,02,07,02,16091,100.0,1922,11.9,14755,91.7,14169,88.1,586,3.6,1336,8.3
09,02,08,01,2935,100.0,198,6.7,2822,96.1,2737,93.3,85,2.9,113,3.9
09,02,08,02,7737,100.0,1183,15.3,6913,89.3,6554,84.7,359,4.6,824,10.7
09,03,09,01,12998,100.0,1571,12.1,12201,93.9,11427,87.9,774,6.0,797,6.1
09,03,09,02,5667,100.0,649,11.5,5355,94.5,5018,88.5,337,5.9,312,5.5
09,03,09,03,8063,100.0,1283,15.9,7480,92.8,6780,84.1,700,8.7,583,7.2
09,03,10,01,12776,100.0,1333,10.4,11911,93.2,11443,89.6,468,3.7,865,6.8
09,03,11,01,6041,100.0,670,11.1,5546,91.8,5371,88.9,175,2.9,495,8.2
09,03,12,01,1799,100.0,137,7.6,1736,96.5,1662,92.4,74,4.1,63,3.5
09,03,12,02,2475,100.0,196,7.9,2356,95.2,2279,92.1,77,3.1,119,4.8
09,04,13,01,14437,100.0,1080,7.5,13702,94.9,13357,92.5,345,2.4,735,5.1
09,04,13,02,1812,100.0,146,8.1,1748,96.5,1666,91.9,82,4.5,64,3.5
09,04,14,01,4962,100.0,559,11.3,4527,91.2,4403,88.7,124,2.5,435,8.8
09,04,14,02,1485,100.0,145,9.8,1438,96.8,1340,90.2,98,6.6,47,3.2
09,04,15,01,7382,100.0,944,12.8,6834,92.6,6438,87.2,396,5.4,548,7.4
09,04,16,01,6582,100.0,362,5.5,6430,97.7,6220,94.5,210,3.2,152,2.3
09,05,17,01,3583,100.0,226,6.3,3425,95.6,3357,93.7,68,1.9,158,4.4
09,05,17,02,14685,100.0,858,5.8,14222,96.8,13827,94.2,395,2.7,463,3.2
09,05,18,01,9393,100.0,806,8.6,8868,94.4,8587,91.4,281,3.0,525,5.6
09,05,19,01,10747,100.0,923,8.6,10180,94.7,9824,91.4,356,3.3,567,5.3
09,05,20,01,12775,100.0,729,5.7,12372,96.8,12046,94.3,326,2.6,403,3.2
10,01,01,01,5671,100.0,1418,25.0,4968,87.6,4253,75.0,715,12.6,703,12.4
10,01,01,02,17831,100.0,3954,22.2,16237,91.1,13877,77.8,2360,13.2,1594,8.9
10,01,02,03,1379,100.0,977,70.8,457,33.1,402,29.2,55,4.0,922,66.9
10,01,02,04,10479,100.0,2167,20.7,9595,91.6,8312,79.3,1283,12.2,884,8.4
10,01,02,05,8319,100.0,1268,15.2,7591,91.2,7051,84.8,540,6.5,728,8.8
10,01,02,06,17015,100.0,3412,20.1,15161,89.1,13603,79.9,1558,9.2,1854,10.9
10,01,02,07,10762,100.0,2288,21.3,9759,90.7,8474,78.7,1285,11.9,1003,9.3
10,01,03,08,2329,100.0,691,29.7,1832,78.7,1638,70.3,194,8.3,497,21.3
10,01,03,09,14378,100.0,2787,19.4,13289,92.4,11591,80.6,1698,11.8,1089,7.6
10,01,03,10,17818,100.0,3159,17.7,16502,92.6,14659,82.3,1843,10.3,1316,7.4
10,01,03,11,2932,100.0,352,12.0,2845,97.0,2580,88.0,265,9.0,87,3.0
10,02,04,12,6736,100.0,1773,26.3,5873,87.2,4963,73.7,910,13.5,863,12.8
10,02,04,13,15530,100.0,2550,16.4,14020,90.3,12980,83.6,1040,6.7,1510,9.7
10,02,04,14,1660,100.0,640,38.6,1455,87.7,1020,61.4,435,26.2,205,12.3
10,02,04,15,5550,100.0,1321,23.8,4615,83.2,4229,76.2,386,7.0,935,16.8
10,02,04,16,5547,100.0,1322,23.8,4706,84.8,4225,76.2,481,8.7,841,15.2
10,02,05,17,8861,100.0,779,8.8,8514,96.1,8082,91.2,432,4.9,347,3.9
10,02,05,18,5167,100.0,727,14.1,4724,91.4,4440,85.9,284,5.5,443,8.6
10,02,05,19,6051,100.0,1704,28.2,4784,79.1,4347,71.8,437,7.2,1267,20.9
10,02,06,20,3299,100.0,429,13.0,3114,94.4,2870,87.0,244,7.4,185,5.6
10,02,06,21,6071,100.0,835,13.8,5623,92.6,5236,86.2,387,6.4,448,7.4
10,02,06,22,8631,100.0,976,11.3,8206,95.1,7655,88.7,551,6.4,425,4.9
10,02,06,23,6527,100.0,642,9.8,6293,96.4,5885,90.2,408,6.3,234,3.6
10,03,07,24,7799,100.0,1143,14.7,7015,89.9,6656,85.3,359,4.6,784,10.1
10,03,07,25,6297,100.0,1157,18.4,5529,87.8,5140,81.6,389,6.2,768,12.2
10,03,07,26,3009,100.0,291,9.7,2885,95.9,2718,90.3,167,5.6,124,4.1
10,03,07,27,9315,100.0,795,8.5,9026,96.9,8520,91.5,506,5.4,289,3.1
10,04,08,28,7719,100.0,521,6.7,7479,96.9,7198,93.3,281,3.6,240,3.1
10,04,08,29,3762,100.0,297,7.9,3573,95.0,3465,92.1,108,2.9,189,5.0
10,04,08,30,7545,100.0,402,5.3,7393,98.0,7143,94.7,250,3.3,152,2.0
10,04,09,31,9323,100.0,579,6.2,9093,97.5,8744,93.8,349,3.7,230,2.5
10,04,09,32,3956,100.0,324,8.2,3788,95.8,3632,91.8,156,3.9,168,4.2
10,04,09,33,14747,100.0,786,5.3,14396,97.6,13961,94.7,435,2.9,351,2.4
11,01,01,01,592,100.0,57,9.6,559,94.4,535,90.4,24,4.1,33,5.6
11,01,01,02,2557,100.0,117,4.6,2512,98.2,2440,95.4,72,2.8,45,1.8
11,01,01,03,1604,100.0,406,25.3,1276,79.6,1198,74.7,78,4.9,328,20.4
11,01,02,04,8907,100.0,2340,26.3,7637,85.7,6567,73.7,1070,12.0,1270,14.3
11,01,02,05,6713,100.0,1657,24.7,5903,87.9,5056,75.3,847,12.6,810,12.1
11,01,02,06,5997,100.0,1115,18.6,5361,89.4,4882,81.4,479,8.0,636,10.6
11,01,02,07,7113,100.0,1209,17.0,6435,90.5,5904,83.0,531,7.5,678,9.5
11,01,03,08,11771,100.0,2958,25.1,10176,86.4,8813,74.9,1363,11.6,1595,13.6
11,01,03,09,9670,100.0,2206,22.8,8376,86.6,7464,77.2,912,9.4,1294,13.4
11,01,03,10,5238,100.0,533,10.2,4975,95.0,4705,89.8,270,5.2,263,5.0
11,02,04,11,9242,100.0,2090,22.6,7731,83.7,7152,77.4,579,6.3,1511,16.3
11,02,04,12,6410,100.0,1081,16.9,5785,90.2,5329,83.1,456,7.1,625,9.8
11,02,05,13,4014,100.0,764,19.0,3389,84.4,3250,81.0,139,3.5,625,15.6
11,02,05,14,9074,100.0,1620,17.9,7828,86.3,7454,82.1,374,4.1,1246,13.7
11,02,05,15,14529,100.0,3120,21.5,12747,87.7,11409,78.5,1338,9.2,1782,12.3
11,02,05,16,3725,100.0,362,9.7,3569,95.8,3363,90.3,206,5.5,156,4.2
11,03,06,17,6044,100.0,1725,28.5,4990,82.6,4319,71.5,671,11.1,1054,17.4
11,03,06,18,15954,100.0,3574,22.4,13894,87.1,12380,77.6,1514,9.5,2060,12.9
11,03,06,19,10784,100.0,2925,27.1,9114,84.5,7859,72.9,1255,11.6,1670,15.5
11,03,07,20,5858,100.0,3715,63.4,2431,41.5,2143,36.6,288,4.9,3427,58.5
11,03,07,21,25327,100.0,6642,26.2,20339,80.3,18685,73.8,1654,6.5,4988,19.7
11,03,08,24,10019,100.0,3141,31.4,8162,81.5,6878,68.6,1284,12.8,1857,18.5
11,04,09,25,3817,100.0,730,19.1,3348,87.7,3087,80.9,261,6.8,469,12.3
11,04,09,26,28022,100.0,5045,18.0,24703,88.2,22977,82.0,1726,6.2,3319,11.8
11,04,10,22,5448,100.0,1652,30.3,4292,78.8,3796,69.7,496,9.1,1156,21.2
11,04,10,23,5980,100.0,1718,28.7,5032,84.1,4262,71.3,770,12.9,948,15.9
11,04,10,27,3033,100.0,877,28.9,2402,79.2,2156,71.1,246,8.1,631,20.8
11,04,11,28,25108,100.0,4922,19.6,22178,88.3,20186,80.4,1992,7.9,2930,11.7
11,05,12,29,3494,100.0,498,14.3,3257,93.2,2996,85.7,261,7.5,237,6.8
11,05,13,30,9336,100.0,1553,16.6,8226,88.1,7783,83.4,443,4.7,1110,11.9
11,05,13,31,11073,100.0,1951,17.6,9579,86.5,9122,82.4,457,4.1,1494,13.5
11,05,13,32,6668,100.0,676,10.1,6360,95.4,5992,89.9,368,5.5,308,4.6
12,10,31,15,7568,100.0,2962,39.1,5907,78.1,4606,60.9,1301,17.2,1661,21.9
12,10,31,16,9479,100.0,4128,43.5,7120,75.1,5351,56.5,1769,18.7,2359,24.9
12,10,31,17,10672,100.0,5284,49.5,7469,70.0,5388,50.5,2081,19.5,3203,30.0
12,10,32,18,13515,100.0,5406,40.0,10577,78.3,8109,60.0,2468,18.3,2938,21.7
12,10,32,19,8803,100.0,3557,40.4,6863,78.0,5246,59.6,1617,18.4,1940,22.0
12,10,32,20,4601,100.0,1167,25.4,4029,87.6,3434,74.6,595,12.9,572,12.4
12,21,41,25,7315,100.0,1939,26.5,6292,86.0,5376,73.5,916,12.5,1023,14.0
12,21,41,26,7651,100.0,2525,33.0,6494,84.9,5126,67.0,1368,17.9,1157,15.1
12,21,44,21,2598,100.0,842,32.4,2130,82.0,1756,67.6,374,14.4,468,18.0
12,21,44,22,7955,100.0,4389,55.2,5551,69.8,3566,44.8,1985,25.0,2404,30.2
12,21,44,23,5517,100.0,1995,36.2,4583,83.1,3522,63.8,1061,19.2,934,16.9
12,21,44,24,10663,100.0,5052,47.4,7588,71.2,5611,52.6,1977,18.5,3075,28.8
12,21,45,27,10698,100.0,2015,18.8,9611,89.8,8683,81.2,928,8.7,1087,10.2
12,21,45,28,252,100.0,78,31.0,211,83.7,174,69.0,37,14.7,41,16.3
12,22,42,29,6081,100.0,797,13.1,5745,94.5,5284,86.9,461,7.6,336,5.5
12,22,42,30,18043,100.0,2157,12.0,17106,94.8,15886,88.0,1220,6.8,937,5.2
12,23,11,01,16532,100.0,1956,11.8,15609,94.4,14576,88.2,1033,6.2,923,5.6
12,23,11,02,16886,100.0,1919,11.4,16095,95.3,14967,88.6,1128,6.7,791,4.7
12,30,12,03,15270,100.0,4415,28.9,12431,81.4,10855,71.1,1576,10.3,2839,18.6
12,30,12,04,6561,100.0,1678,25.6,5552,84.6,4883,74.4,669,10.2,1009,15.4
12,30,12,05,4924,100.0,845,17.2,4541,92.2,4079,82.8,462,9.4,383,7.8
12,30,12,06,5120,100.0,774,15.1,4860,94.9,4346,84.9,514,10.0,260,5.1
12,30,21,07,3054,100.0,1150,37.7,2572,84.2,1904,62.3,668,21.9,482,15.8
12,30,21,08,14505,100.0,5881,40.5,11726,80.8,8624,59.5,3102,21.4,2779,19.2
12,30,21,09,11666,100.0,5780,49.5,8764,75.1,5886,50.5,2878,24.7,2902,24.9
12,30,21,10,10481,100.0,5503,52.5,7725,73.7,4978,47.5,2747,26.2,2756,26.3
12,30,22,11,3301,100.0,830,25.1,2954,89.5,2471,74.9,483,14.6,347,10.5
12,30,22,12,5929,100.0,2559,43.2,4368,73.7,3370,56.8,998,16.8,1561,26.3
12,30,43,13,6619,100.0,1333,20.1,5823,88.0,5286,79.9,537,8.1,796,12.0
12,30,43,14,9660,100.0,1230,12.7,9097,94.2,8430,87.3,667,6.9,563,5.8
