district_id,forecast_area_id,district_region_id,planning_area_id,inhabitants,inhabitants_percentage,inhabitants_with_migration_background,inhabitants_with_migration_background_percentage,inhabitants_germans,inhabitants_germans_percentage,inhabitants_germans_without_migration_background,inhabitants_germans_without_migration_background_percentage,inhabitants_germans_with_migration_background,inhabitants_germans_with_migration_background_percentage,inhabitants_foreigners,inhabitants_foreigners_percentage
01,10,01,01,3648,100.0,2371,65.0,2021,55.4,1277,35.0,744,20.4,1627,44.6
01,10,01,02,2020,100.0,1438,71.2,915,45.3,582,28.8,333,16.5,1105,54.7
01,10,01,03,5699,100.0,3497,61.4,3511,61.6,2202,38.6,1309,23.0,2188,38.4
01,10,01,04,4982,100.0,3327,66.8,2932,58.9,1655,33.2,1277,25.6,2050,41.1
01,10,02,05,2966,100.0,2004,67.6,1440,48.6,962,32.4,478,16.1,1526,51.4
01,10,02,06,1913,100.0,1072,56.0,1166,61.0,841,44.0,325,17.0,747,39.0
01,10,02,07,8772,100.0,4926,56.2,5469,62.3,3846,43.8,1623,18.5,3303,37.7
01,10,03,08,7410,100.0,3634,49.0,4817,65.0,3776,51.0,1041,14.0,2593,35.0
01,10,03,09,12579,100.0,5539,44.0,8923,70.9,7040,56.0,1883,15.0,3656,29.1
01,10,03,10,10277,100.0,5436,52.9,6360,61.9,4841,47.1,1519,14.8,3917,38.1
01,10,03,11,9636,100.0,5022,52.1,6282,65.2,4614,47.9,1668,17.3,3354,34.8
01,10,03,12,10262,100.0,5150,50.2,6816,66.4,5112,49.8,1704,16.6,3446,33.6
01,10,03,13,11199,100.0,5565,49.7,7367,65.8,5634,50.3,1733,15.5,3832,34.2
01,10,04,14,5560,100.0,3261,58.7,3082,55.4,2299,41.3,783,14.1,2478,44.6
01,10,04,15,13551,100.0,6210,45.8,9244,68.2,7341,54.2,1903,14.0,4307,31.8
01,10,04,16,13656,100.0,5987,43.8,9614,70.4,7669,56.2,1945,14.2,4042,29.6
01,20,05,17,4160,100.0,2652,63.8,2156,51.8,1508,36.3,648,15.6,2004,48.2
01,20,05,18,6942,100.0,4481,64.5,3848,55.4,2461,35.5,1387,20.0,3094,44.6
01,20,05,19,9610,100.0,5467,56.9,5816,60.5,4143,43.1,1673,17.4,3794,39.5
01,20,05,20,9503,100.0,4707,49.5,6565,69.1,4796,50.5,1769,18.6,2938,30.9
01,20,05,21,5308,100.0,3257,61.4,3208,60.4,2051,38.6,1157,21.8,2100,39.6
01,20,05,22,11644,100.0,4468,38.4,8963,77.0,7176,61.6,1787,15.3,2681,23.0
01,20,06,23,10998,100.0,5832,53.0,7340,66.7,5166,47.0,2174,19.8,3658,33.3
01,20,06,24,6482,100.0,4661,71.9,3185,49.1,1821,28.1,1364,21.0,3297,50.9
01,20,06,25,6955,100.0,4232,60.8,4511,64.9,2723,39.2,1788,25.7,2444,35.1
01,20,06,26,5972,100.0,2704,45.3,4269,71.5,3268,54.7,1001,16.8,1703,28.5
01,20,06,27,3421,100.0,2301,67.3,2173,63.5,1120,32.7,1053,30.8,1248,36.5
01,20,06,28,3304,100.0,1542,46.7,2407,72.9,1762,53.3,645,19.5,897,27.1
01,20,06,29,5967,100.0,2951,49.5,3909,65.5,3016,50.5,893,15.0,2058,34.5
01,30,07,30,8106,100.0,5901,72.8,4146,51.1,2205,27.2,1941,23.9,3960,48.9
01,30,07,31,8916,100.0,5505,61.7,5224,58.6,3411,38.3,1813,20.3,3692,41.4
01,30,07,32,10166,100.0,6486,63.8,5989,58.9,3680,36.2,2309,22.7,4177,41.1
01,30,07,33,11667,100.0,7364,63.1,7067,60.6,4303,36.9,2764,23.7,4600,39.4
01,30,08,34,14425,100.0,9670,67.0,9891,68.6,4755,33.0,5136,35.6,4534,31.4
01,30,08,35,10925,100.0,6778,62.0,7248,66.3,4147,38.0,3101,28.4,3677,33.7
01,30,08,36,15123,100.0,10125,67.0,8651,57.2,4998,33.0,3653,24.2,6472,42.8
01,40,09,37,11024,100.0,5786,52.5,7318,66.4,5238,47.5,2080,18.9,3706,33.6
01,40,09,38,9728,100.0,5298,54.5,6291,64.7,4430,45.5,1861,19.1,3437,35.3
01,40,09,39,6131,100.0,3472,56.6,3623,59.1,2659,43.4,964,15.7,2508,40.9
01,40,09,40,7067,100.0,2933,41.5,5714,80.9,4134,58.5,1580,22.4,1353,19.1
01,40,09,41,3919,100.0,1936,49.4,2756,70.3,1983,50.6,773,19.7,1163,29.7
01,40,09,42,8635,100.0,4812,55.7,5364,62.1,3823,44.3,1541,17.8,3271,37.9
01,40,10,43,7749,100.0,5304,68.4,4450,57.4,2445,31.6,2005,25.9,3299,42.6
01,40,10,44,10314,100.0,7177,69.6,5606,54.4,3137,30.4,2469,23.9,4708,45.6
01,40,10,45,5687,100.0,4194,73.7,3076,54.1,1493,26.3,1583,27.8,2611,45.9
01,40,10,46,8932,100.0,4656,52.1,5864,65.7,4276,47.9,1588,17.8,3068,34.3
01,40,10,47,8159,100.0,5733,70.3,3945,48.4,2426,29.7,1519,18.6,4214,51.6
01,40,10,48,9499,100.0,5866,61.8,5594,58.9,3633,38.2,1961,20.6,3905,41.1
01,40,10,49,6711,100.0,4146,61.8,3855,57.4,2565,38.2,1290,19.2,2856,42.6
02,10,01,01,7122,100.0,5338,75.0,3651,51.3,1784,25.0,1867,26.2,3471,48.7
02,10,01,02,8739,100.0,6249,71.5,5511,63.1,2490,28.5,3021,34.6,3228,36.9
02,10,01,03,5482,100.0,3491,63.7,3699,67.5,1991,36.3,1708,31.2,1783,32.5
02,10,01,04,5654,100.0,3923,69.4,3506,62.0,1731,30.6,1775,31.4,2148,38.0
02,10,01,05,9505,100.0,6821,71.8,6084,64.0,2684,28.2,3400,35.8,3421,36.0
02,10,01,06,4944,100.0,3206,64.8,3342,67.6,1738,35.2,1604,32.4,1602,32.4
02,20,02,07,2534,100.0,1163,45.9,1823,71.9,1371,54.1,452,17.8,711,28.1
02,20,02,08,5848,100.0,2711,46.4,4121,70.5,3137,53.6,984,16.8,1727,29.5
02,20,02,09,10990,100.0,4759,43.3,8084,73.6,6231,56.7,1853,16.9,2906,26.4
02,20,02,10,12247,100.0,5573,45.5,8794,71.8,6674,54.5,2120,17.3,3453,28.2
02,20,02,11,14624,100.0,6338,43.3,10897,74.5,8286,56.7,2611,17.9,3727,25.5
02,20,02,12,8493,100.0,4310,50.7,6205,73.1,4183,49.3,2022,23.8,2288,26.9
02,20,02,13,10111,100.0,4688,46.4,7117,70.4,5423,53.6,1694,16.8,2994,29.6
02,30,03,14,7243,100.0,4352,60.1,4632,64.0,2891,39.9,1741,24.0,2611,36.0
02,30,03,15,8390,100.0,4822,57.5,5507,65.6,3568,42.5,1939,23.1,2883,34.4
02,30,03,16,4225,100.0,2144,50.7,2966,70.2,2081,49.3,885,20.9,1259,29.8
02,30,04,17,8144,100.0,4497,55.2,5393,66.2,3647,44.8,1746,21.4,2751,33.8
02,30,04,18,7809,100.0,3855,49.4,5358,68.6,3954,50.6,1404,18.0,2451,31.4
02,30,04,19,10656,100.0,5603,52.6,7036,66.0,5053,47.4,1983,18.6,3620,34.0
02,40,05,20,5836,100.0,2347,40.2,4409,75.5,3489,59.8,920,15.8,1427,24.5
02,40,05,21,8338,100.0,3311,39.7,6201,74.4,5027,60.3,1174,14.1,2137,25.6
02,40,05,22,11489,100.0,3898,33.9,9006,78.4,7591,66.1,1415,12.3,2483,21.6
02,40,06,23,13637,100.0,6890,50.5,9086,66.6,6747,49.5,2339,17.2,4551,33.4
02,40,06,24,11896,100.0,4710,39.6,8424,70.8,7186,60.4,1238,10.4,3472,29.2
02,40,06,25,1219,100.0,865,71.0,504,41.3,354,29.0,150,12.3,715,58.7
02,50,07,26,9307,100.0,3702,39.8,6704,72.0,5605,60.2,1099,11.8,2603,28.0
02,50,07,27,6675,100.0,2701,40.5,4783,71.7,3974,59.5,809,12.1,1892,28.3
02,50,07,28,10154,100.0,3705,36.5,7542,74.3,6449,63.5,1093,10.8,2612,25.7
02,50,07,29,5491,100.0,2076,37.8,4152,75.6,3415,62.2,737,13.4,1339,24.4
02,50,08,30,4066,100.0,1780,43.8,2774,68.2,2286,56.2,488,12.0,1292,31.8
02,50,08,31,7991,100.0,3388,42.4,5579,69.8,4603,57.6,976,12.2,2412,30.2
02,50,08,32,9574,100.0,4452,46.5,6382,66.7,5122,53.5,1260,13.2,3192,33.3
02,50,08,33,10313,100.0,4242,41.1,7144,69.3,6071,58.9,1073,10.4,3169,30.7
02,50,08,34,11436,100.0,4316,37.7,8517,74.5,7120,62.3,1397,12.2,2919,25.5
02,50,08,35,8401,100.0,3796,45.2,5588,66.5,4605,54.8,983,11.7,2813,33.5
02,50,08,36,5042,100.0,1337,26.5,4375,86.8,3705,73.5,670,13.3,667,13.2
03,10,01,01,4693,100.0,914,19.5,4102,87.4,3779,80.5,323,6.9,591,12.6
03,10,01,02,3430,100.0,1188,34.6,2495,72.7,2242,65.4,253,7.4,935,27.3
03,10,01,03,9635,100.0,2608,27.1,7502,77.9,7027,72.9,475,4.9,2133,22.1
03,20,02,04,2552,100.0,650,25.5,1983,77.7,1902,74.5,81,3.2,569,22.3
03,20,02,05,8839,100.0,1713,19.4,7822,88.5,7126,80.6,696,7.9,1017,11.5
03,20,02,06,6749,100.0,1667,24.7,5591,82.8,5082,75.3,509,7.5,1158,17.2
03,20,02,07,11535,100.0,2391,20.7,10071,87.3,9144,79.3,927,8.0,1464,12.7
03,20,03,08,5296,100.0,854,16.1,4872,92.0,4442,83.9,430,8.1,424,8.0
03,20,03,09,5428,100.0,1048,19.3,4828,88.9,4380,80.7,448,8.3,600,11.1
03,20,03,10,8049,100.0,1426,17.7,7377,91.7,6623,82.3,754,9.4,672,8.3
03,30,04,11,11860,100.0,2962,25.0,9873,83.2,8898,75.0,975,8.2,1987,16.8
03,30,04,12,5202,100.0,614,11.8,4911,94.4,4588,88.2,323,6.2,291,5.6
03,30,04,13,3128,100.0,313,10.0,2981,95.3,2815,90.0,166,5.3,147,4.7
03,30,05,14,6918,100.0,800,11.6,6439,93.1,6118,88.4,321,4.6,479,6.9
03,30,05,15,50,100.0,6,12.0,44,88.0,44,88.0,0,0.0,6,12.0
03,30,05,16,8736,100.0,2499,28.6,6872,78.7,6237,71.4,635,7.3,1864,21.3
03,30,05,17,1132,100.0,81,7.2,1084,95.8,1051,92.8,33,2.9,48,4.2
03,40,06,18,4808,100.0,1103,22.9,4387,91.2,3705,77.1,682,14.2,421,8.8
03,40,06,19,10559,100.0,2325,22.0,9283,87.9,8234,78.0,1049,9.9,1276,12.1
03,40,06,20,3511,100.0,758,21.6,3107,88.5,2753,78.4,354,10.1,404,11.5
03,40,07,21,11937,100.0,2969,24.9,10213,85.6,8968,75.1,1245,10.4,1724,14.4
03,40,07,22,3820,100.0,820,21.5,3322,87.0,3000,78.5,322,8.4,498,13.0
03,40,07,23,7195,100.0,1861,25.9,6050,84.1,5334,74.1,716,10.0,1145,15.9
03,40,07,24,8092,100.0,1525,18.8,7141,88.2,6567,81.2,574,7.1,951,11.8
03,40,07,25,7468,100.0,1122,15.0,6808,91.2,6346,85.0,462,6.2,660,8.8
03,40,08,26,7138,100.0,1796,25.2,5843,81.9,5342,74.8,501,7.0,1295,18.1
03,40,08,27,9647,100.0,2601,27.0,7927,82.2,7046,73.0,881,9.1,1720,17.8
03,40,08,28,4903,100.0,1407,28.7,3912,79.8,3496,71.3,416,8.5,991,20.2
03,40,08,29,6064,100.0,1504,24.8,4989,82.3,4560,75.2,429,7.1,1075,17.7
03,40,08,30,9292,100.0,1826,19.7,8137,87.6,7466,80.3,671,7.2,1155,12.4
03,40,08,31,0,100.0,0,0.0,0,0.0,0,0.0,0,0.0,0,0.0
03,50,09,32,6456,100.0,1989,30.8,4818,74.6,4467,69.2,351,5.4,1638,25.4
03,50,09,33,7607,100.0,1607,21.1,6532,85.9,6000,78.9,532,7.0,1075,14.1
03,50,09,34,10343,100.0,3172,30.7,8145,78.7,7171,69.3,974,9.4,2198,21.3
03,50,09,35,6684,100.0,1977,29.6,5340,79.9,4707,70.4,633,9.5,1344,20.1
03,50,09,36,10008,100.0,2508,25.1,8330,83.2,7500,74.9,830,8.3,1678,16.8
03,50,10,37,8547,100.0,1975,23.1,7142,83.6,6572,76.9,570,6.7,1405,16.4
03,50,10,38,7309,100.0,1344,18.4,6345,86.8,5965,81.6,380,5.2,964,13.2
03,60,11,39,3788,100.0,1450,38.3,2794,73.8,2338,61.7,456,12.0,994,26.2
03,60,11,40,5993,100.0,2097,35.0,4529,75.6,3896,65.0,633,10.6,1464,24.4
03,60,11,41,6863,100.0,2632,38.4,5001,72.9,4231,61.6,770,11.2,1862,27.1
03,60,11,42,10934,100.0,4191,38.3,8024,73.4,6743,61.7,1281,11.7,2910,26.6
03,60,12,43,6963,100.0,2191,31.5,5522,79.3,4772,68.5,750,10.8,1441,20.7
03,60,12,44,7656,100.0,2278,29.8,6165,80.5,5378,70.2,787,10.3,1491,19.5
03,60,12,45,13352,100.0,4349,32.6,10330,77.4,9003,67.4,1327,9.9,3022,22.6
03,60,13,46,5993,100.0,2347,39.2,4356,72.7,3646,60.8,710,11.8,1637,27.3
03,60,13,47,9434,100.0,3268,34.6,7365,78.1,6166,65.4,1199,12.7,2069,21.9
03,60,13,48,7518,100.0,2690,35.8,5703,75.9,4828,64.2,875,11.6,1815,24.1
03,60,14,49,9951,100.0,2234,22.5,8500,85.4,7717,77.5,783,7.9,1451,14.6
03,60,14,50,4697,100.0,2566,54.6,2454,52.2,2131,45.4,323,6.9,2243,47.8
03,60,14,51,6423,100.0,2209,34.4,4849,75.5,4214,65.6,635,9.9,1574,24.5
03,60,14,52,4724,100.0,1966,41.6,3316,70.2,2758,58.4,558,11.8,1408,29.8
03,60,14,53,3216,100.0,1161,36.1,2528,78.6,2055,63.9,473,14.7,688,21.4
03,70,15,54,11549,100.0,4750,41.1,8316,72.0,6799,58.9,1517,13.1,3233,28.0
03,70,15,55,7357,100.0,2636,35.8,5604,76.2,4721,64.2,883,12.0,1753,23.8
03,70,15,56,8592,100.0,3558,41.4,6140,71.5,5034,58.6,1106,12.9,2452,28.5
03,70,16,57,3192,100.0,1090,34.1,2459,77.0,2102,65.9,357,11.2,733,23.0
03,70,16,58,8340,100.0,2909,34.9,6366,76.3,5431,65.1,935,11.2,1974,23.7
03,70,16,59,9439,100.0,3588,38.0,7054,74.7,5851,62.0,1203,12.7,2385,25.3
03,70,16,60,12813,100.0,3931,30.7,10355,80.8,8882,69.3,1473,11.5,2458,19.2
04,10,01,01,11599,100.0,6147,53.0,7795,67.2,5452,47.0,2343,20.2,3804,32.8
04,10,01,02,7855,100.0,4569,58.2,5539,70.5,3286,41.8,2253,28.7,2316,29.5
04,20,02,03,1499,100.0,451,30.1,1232,82.2,1048,69.9,184,12.3,267,17.8
04,20,02,04,3076,100.0,1241,40.3,2198,71.5,1835,59.7,363,11.8,878,28.5
04,20,02,05,2486,100.0,827,33.3,1988,80.0,1659,66.7,329,13.2,498,20.0
04,20,02,06,2899,100.0,851,29.4,2466,85.1,2048,70.6,418,14.4,433,14.9
04,20,02,07,2949,100.0,1060,35.9,2197,74.5,1889,64.1,308,10.4,752,25.5
04,20,03,08,6238,100.0,2336,37.4,4743,76.0,3902,62.6,841,13.5,1495,24.0
04,20,03,09,6845,100.0,2015,29.4,5797,84.7,4830,70.6,967,14.1,1048,15.3
04,20,03,10,7603,100.0,2812,37.0,6056,79.7,4791,63.0,1265,16.6,1547,20.3
04,20,03,11,7373,100.0,3086,41.9,5470,74.2,4287,58.1,1183,16.0,1903,25.8
04,30,04,12,4432,100.0,2623,59.2,2468,55.7,1809,40.8,659,14.9,1964,44.3
04,30,04,13,9976,100.0,4784,48.0,7497,75.2,5192,52.0,2305,23.1,2479,24.8
04,30,04,14,10503,100.0,4157,39.6,8143,77.5,6346,60.4,1797,17.1,2360,22.5
04,30,04,15,6362,100.0,2534,39.8,4882,76.7,3828,60.2,1054,16.6,1480,23.3
04,30,04,16,11884,100.0,5055,42.5,8846,74.4,6829,57.5,2017,17.0,3038,25.6
04,30,05,17,9517,100.0,4689,49.3,6622,69.6,4828,50.7,1794,18.9,2895,30.4
04,30,05,18,5814,100.0,2755,47.4,4245,73.0,3059,52.6,1186,20.4,1569,27.0
04,30,06,19,8860,100.0,4243,47.9,6324,71.4,4617,52.1,1707,19.3,2536,28.6
04,30,06,20,3911,100.0,2444,62.5,2394,61.2,1467,37.5,927,23.7,1517,38.8
04,30,06,21,10651,100.0,5262,49.4,7627,71.6,5389,50.6,2238,21.0,3024,28.4
04,30,06,22,5233,100.0,3122,59.7,3462,66.2,2111,40.3,1351,25.8,1771,33.8
04,30,06,23,12099,100.0,6820,56.4,7705,63.7,5279,43.6,2426,20.1,4394,36.3
04,30,06,24,9277,100.0,4258,45.9,6661,71.8,5019,54.1,1642,17.7,2616,28.2
04,40,07,25,82,100.0,58,70.7,34,41.5,24,29.3,10,12.2,48,58.5
04,40,07,26,5404,100.0,2394,44.3,4087,75.6,3010,55.7,1077,19.9,1317,24.4
04,40,07,27,8300,100.0,3566,43.0,6321,76.2,4734,57.0,1587,19.1,1979,23.8
04,40,07,28,3221,100.0,1281,39.8,2550,79.2,1940,60.2,610,18.9,671,20.8
04,40,07,29,2891,100.0,1176,40.7,2244,77.6,1715,59.3,529,18.3,647,22.4
04,40,08,30,8383,100.0,4027,48.0,5949,71.0,4356,52.0,1593,19.0,2434,29.0
04,40,08,31,1536,100.0,464,30.2,1308,85.2,1072,69.8,236,15.4,228,14.8
04,40,08,32,6897,100.0,1866,27.1,5906,85.6,5031,72.9,875,12.7,991,14.4
04,40,08,33,4015,100.0,1551,38.6,3226,80.3,2464,61.4,762,19.0,789,19.7
04,40,08,34,3463,100.0,1174,33.9,2838,82.0,2289,66.1,549,15.9,625,18.0
04,40,08,35,10233,100.0,2944,28.8,8631,84.3,7289,71.2,1342,13.1,1602,15.7
04,50,09,36,5486,100.0,2461,44.9,4083,74.4,3025,55.1,1058,19.3,1403,25.6
04,50,09,37,7585,100.0,3328,43.9,5580,73.6,4257,56.1,1323,17.4,2005,26.4
04,50,09,38,8288,100.0,3972,47.9,5937,71.6,4316,52.1,1621,19.6,2351,28.4
04,50,09,39,6760,100.0,3418,50.6,4823,71.3,3342,49.4,1481,21.9,1937,28.7
04,50,10,40,5889,100.0,2679,45.5,4357,74.0,3210,54.5,1147,19.5,1532,26.0
04,50,10,41,5456,100.0,2544,46.6,3939,72.2,2912,53.4,1027,18.8,1517,27.8
04,50,10,42,3691,100.0,2155,58.4,2290,62.0,1536,41.6,754,20.4,1401,38.0
04,50,10,43,11023,100.0,5238,47.5,7912,71.8,5785,52.5,2127,19.3,3111,28.2
04,50,10,44,5408,100.0,2459,45.5,3904,72.2,2949,54.5,955,17.7,1504,27.8
04,50,10,45,9101,100.0,4483,49.3,6343,69.7,4618,50.7,1725,19.0,2758,30.3
04,50,11,46,4572,100.0,2042,44.7,3374,73.8,2530,55.3,844,18.5,1198,26.2
04,50,11,47,5510,100.0,2414,43.8,4156,75.4,3096,56.2,1060,19.2,1354,24.6
04,50,11,48,4565,100.0,2214,48.5,3230,70.8,2351,51.5,879,19.3,1335,29.2
04,50,11,49,10012,100.0,4223,42.2,7449,74.4,5789,57.8,1660,16.6,2563,25.6
04,50,11,50,3059,100.0,1246,40.7,2293,75.0,1813,59.3,480,15.7,766,25.0
04,50,11,51,7459,100.0,2630,35.3,5953,79.8,4829,64.7,1124,15.1,1506,20.2
04,50,11,52,6823,100.0,3064,44.9,5000,73.3,3759,55.1,1241,18.2,1823,26.7
04,50,11,53,7375,100.0,3381,45.8,5407,73.3,3994,54.2,1413,19.2,1968,26.7
05,10,01,01,4358,100.0,1069,24.5,3832,87.9,3289,75.5,543,12.5,526,12.1
05,10,01,02,4350,100.0,1196,27.5,3623,83.3,3154,72.5,469,10.8,727,16.7
05,10,01,03,6095,100.0,3141,51.5,4174,68.5,2954,48.5,1220,20.0,1921,31.5
05,10,01,04,6111,100.0,3063,50.1,4270,69.9,3048,49.9,1222,20.0,1841,30.1
05,10,01,05,7657,100.0,1699,22.2,6834,89.3,5958,77.8,876,11.4,823,10.7
05,10,02,06,3666,100.0,1662,45.3,2688,73.3,2004,54.7,684,18.7,978,26.7
05,10,02,07,2319,100.0,668,28.8,2047,88.3,1651,71.2,396,17.1,272,11.7
05,10,02,08,10979,100.0,5484,49.9,7692,70.1,5495,50.1,2197,20.0,3287,29.9
05,10,02,09,11784,100.0,6497,55.1,8585,72.9,5287,44.9,3298,28.0,3199,27.1
05,10,02,10,7812,100.0,3278,42.0,5642,72.2,4534,58.0,1108,14.2,2170,27.8
05,10,02,11,6226,100.0,2348,37.7,4999,80.3,3878,62.3,1121,18.0,1227,19.7
05,10,03,12,4117,100.0,1878,45.6,2862,69.5,2239,54.4,623,15.1,1255,30.5
05,10,03,13,6511,100.0,3646,56.0,4403,67.6,2865,44.0,1538,23.6,2108,32.4
05,10,03,14,7431,100.0,4678,63.0,3925,52.8,2753,37.0,1172,15.8,3506,47.2
05,10,03,15,6971,100.0,3390,48.6,4669,67.0,3581,51.4,1088,15.6,2302,33.0
05,10,03,16,10485,100.0,4760,45.4,7647,72.9,5725,54.6,1922,18.3,2838,27.1
05,10,03,17,4036,100.0,2249,55.7,2213,54.8,1787,44.3,426,10.6,1823,45.2
05,20,04,18,3885,100.0,976,25.1,3540,91.1,2909,74.9,631,16.2,345,8.9
05,20,04,19,1666,100.0,91,5.5,1642,98.6,1575,94.5,67,4.0,24,1.4
05,20,04,20,5888,100.0,2044,34.7,4857,82.5,3844,65.3,1013,17.2,1031,17.5
05,20,04,21,4439,100.0,1485,33.5,3479,78.4,2954,66.5,525,11.8,960,21.6
05,20,04,22,1156,100.0,323,27.9,969,83.8,833,72.1,136,11.8,187,16.2
05,20,04,23,6770,100.0,2587,38.2,5185,76.6,4183,61.8,1002,14.8,1585,23.4
05,20,05,24,3404,100.0,1035,30.4,2961,87.0,2369,69.6,592,17.4,443,13.0
05,20,05,25,2460,100.0,683,27.8,2202,89.5,1777,72.2,425,17.3,258,10.5
05,20,05,26,5749,100.0,3506,61.0,3296,57.3,2243,39.0,1053,18.3,2453,42.7
05,20,05,27,12029,100.0,7870,65.4,7285,60.6,4159,34.6,3126,26.0,4744,39.4
05,20,05,28,7193,100.0,2252,31.3,6003,83.5,4941,68.7,1062,14.8,1190,16.5
05,20,06,29,8368,100.0,3727,44.5,5965,71.3,4641,55.5,1324,15.8,2403,28.7
05,20,06,30,10048,100.0,4181,41.6,7263,72.3,5867,58.4,1396,13.9,2785,27.7
05,20,06,31,8618,100.0,3674,42.6,6202,72.0,4944,57.4,1258,14.6,2416,28.0
05,20,06,32,3754,100.0,1895,50.5,2512,66.9,1859,49.5,653,17.4,1242,33.1
05,20,06,33,2098,100.0,675,32.2,1761,83.9,1423,67.8,338,16.1,337,16.1
05,20,06,34,4413,100.0,835,18.9,3954,89.6,3578,81.1,376,8.5,459,10.4
05,30,07,35,4382,100.0,2787,63.6,3080,70.3,1595,36.4,1485,33.9,1302,29.7
05,30,07,36,3619,100.0,2013,55.6,2727,75.4,1606,44.4,1121,31.0,892,24.6
05,30,07,37,11809,100.0,5678,48.1,8825,74.7,6131,51.9,2694,22.8,2984,25.3
05,30,08,38,29,100.0,19,65.5,13,44.8,10,34.5,3,10.3,16,55.2
05,30,08,39,7604,100.0,3939,51.8,5243,69.0,3665,48.2,1578,20.8,2361,31.0
05,30,08,40,469,100.0,243,51.8,327,69.7,226,48.2,101,21.5,142,30.3
05,30,08,41,4662,100.0,2361,50.6,3241,69.5,2301,49.4,940,20.2,1421,30.5
05,40,09,42,3772,100.0,845,22.4,3378,89.6,2927,77.6,451,12.0,394,10.4
05,40,09,43,10454,100.0,2123,20.3,9673,92.5,8331,79.7,1342,12.8,781,7.5
05,40,09,44,2210,100.0,427,19.3,2030,91.9,1783,80.7,247,11.2,180,8.1
05,40,09,45,3660,100.0,641,17.5,3379,92.3,3019,82.5,360,9.8,281,7.7
06,10,01,01,6886,100.0,1925,28.0,5868,85.2,4961,72.0,907,13.2,1018,14.8
06,10,01,02,9166,100.0,3774,41.2,6921,75.5,5392,58.8,1529,16.7,2245,24.5
06,10,01,03,6192,100.0,2097,33.9,5126,82.8,4095,66.1,1031,16.7,1066,17.2
06,10,02,04,6865,100.0,2613,38.1,5462,79.6,4252,61.9,1210,17.6,1403,20.4
06,10,02,05,9983,100.0,3650,36.6,7978,79.9,6333,63.4,1645,16.5,2005,20.1
06,10,02,06,7753,100.0,2589,33.4,6317,81.5,5164,66.6,1153,14.9,1436,18.5
06,10,02,07,8145,100.0,3014,37.0,6456,79.3,5131,63.0,1325,16.3,1689,20.7
06,10,02,08,6987,100.0,2395,34.3,5668,81.1,4592,65.7,1076,15.4,1319,18.9
06,10,02,09,9374,100.0,3621,38.6,7335,78.2,5753,61.4,1582,16.9,2039,21.8
06,10,02,10,5027,100.0,1672,33.3,4107,81.7,3355,66.7,752,15.0,920,18.3
06,20,03,11,4866,100.0,1309,26.9,4206,86.4,3557,73.1,649,13.3,660,13.6
06,20,03,12,6247,100.0,2190,35.1,4892,78.3,4057,64.9,835,13.4,1355,21.7
06,20,03,13,7408,100.0,2613,35.3,5976,80.7,4795,64.7,1181,15.9,1432,19.3
06,20,03,14,7177,100.0,2298,32.0,5920,82.5,4879,68.0,1041,14.5,1257,17.5
06,20,03,15,6648,100.0,2383,35.8,5445,81.9,4265,64.2,1180,17.7,1203,18.1
06,20,03,16,5424,100.0,2387,44.0,4039,74.5,3037,56.0,1002,18.5,1385,25.5
06,20,03,17,6331,100.0,1429,22.6,5657,89.4,4902,77.4,755,11.9,674,10.6
06,20,04,18,0,100.0,0,0.0,0,0.0,0,0.0,0,0.0,0,0.0
06,20,04,19,4510,100.0,2397,53.1,3255,72.2,2113,46.9,1142,25.3,1255,27.8
06,20,04,20,7216,100.0,2259,31.3,5903,81.8,4957,68.7,946,13.1,1313,18.2
06,20,04,21,8395,100.0,2501,29.8,6918,82.4,5894,70.2,1024,12.2,1477,17.6
06,20,04,22,7108,100.0,1743,24.5,6040,85.0,5365,75.5,675,9.5,1068,15.0
06,20,04,23,8656,100.0,2639,30.5,7306,84.4,6017,69.5,1289,14.9,1350,15.6
06,30,05,24,5733,100.0,1575,27.5,4791,83.6,4158,72.5,633,11.0,942,16.4
06,30,05,25,5744,100.0,1586,27.6,4822,83.9,4158,72.4,664,11.6,922,16.1
06,30,05,26,3387,100.0,1145,33.8,2739,80.9,2242,66.2,497,14.7,648,19.1
06,30,05,27,8435,100.0,2565,30.4,7101,84.2,5870,69.6,1231,14.6,1334,15.8
06,30,05,28,11008,100.0,2830,25.7,9554,86.8,8178,74.3,1376,12.5,1454,13.2
06,30,06,29,7025,100.0,2091,29.8,5878,83.7,4934,70.2,944,13.4,1147,16.3
06,30,06,30,5654,100.0,2387,42.2,4094,72.4,3267,57.8,827,14.6,1560,27.6
06,30,06,31,2946,100.0,1100,37.3,2194,74.5,1846,62.7,348,11.8,752,25.5
06,30,06,32,13961,100.0,4431,31.7,11766,84.3,9530,68.3,2236,16.0,2195,15.7
06,30,06,33,12088,100.0,3407,28.2,10188,84.3,8681,71.8,1507,12.5,1900,15.7
06,30,06,34,8415,100.0,2170,25.8,7232,85.9,6245,74.2,987,11.7,1183,14.1
06,40,07,35,10231,100.0,2577,25.2,8705,85.1,7654,74.8,1051,10.3,1526,14.9
06,40,07,36,5212,100.0,1182,22.7,4699,90.2,4030,77.3,669,12.8,513,9.8
06,40,07,37,11301,100.0,3710,32.8,8717,77.1,7591,67.2,1126,10.0,2584,22.9
06,40,08,38,7457,100.0,1535,20.6,6689,89.7,5922,79.4,767,10.3,768,10.3
06,40,08,39,5230,100.0,1242,23.7,4578,87.5,3988,76.3,590,11.3,652,12.5
06,40,08,40,7188,100.0,1314,18.3,6512,90.6,5874,81.7,638,8.9,676,9.4
06,40,08,41,6164,100.0,1781,28.9,5184,84.1,4383,71.1,801,13.0,980,15.9
06,40,08,42,4860,100.0,1889,38.9,4076,83.9,2971,61.1,1105,22.7,784,16.1
06,40,08,43,4761,100.0,1471,30.9,3946,82.9,3290,69.1,656,13.8,815,17.1
06,40,08,44,7351,100.0,2614,35.6,5923,80.6,4737,64.4,1186,16.1,1428,19.4
07,10,01,01,9890,100.0,4956,50.1,6971,70.5,4934,49.9,2037,20.6,2919,29.5
07,10,01,02,8652,100.0,4552,52.6,5673,65.6,4100,47.4,1573,18.2,2979,34.4
07,10,01,03,7784,100.0,4980,64.0,4920,63.2,2804,36.0,2116,27.2,2864,36.8
07,10,02,04,10388,100.0,4247,40.9,7811,75.2,6141,59.1,1670,16.1,2577,24.8
07,10,02,05,5227,100.0,3568,68.3,3170,60.6,1659,31.7,1511,28.9,2057,39.4
07,10,02,06,8379,100.0,4264,50.9,5846,69.8,4115,49.1,1731,20.7,2533,30.2
07,20,03,07,10604,100.0,4050,38.2,8376,79.0,6554,61.8,1822,17.2,2228,21.0
07,20,03,08,10539,100.0,4982,47.3,7553,71.7,5557,52.7,1996,18.9,2986,28.3
07,20,04,09,9410,100.0,3623,38.5,7340,78.0,5787,61.5,1553,16.5,2070,22.0
07,20,04,10,5601,100.0,3091,55.2,3906,69.7,2510,44.8,1396,24.9,1695,30.3
07,20,04,11,2764,100.0,1251,45.3,2047,74.1,1513,54.7,534,19.3,717,25.9
07,20,04,12,2091,100.0,1260,60.3,1298,62.1,831,39.7,467,22.3,793,37.9
07,20,04,13,7729,100.0,2815,36.4,6101,78.9,4914,63.6,1187,15.4,1628,21.1
07,20,04,14,3803,100.0,1579,41.5,2887,75.9,2224,58.5,663,17.4,916,24.1
07,30,05,15,6988,100.0,1967,28.1,5983,85.6,5021,71.9,962,13.8,1005,14.4
07,30,05,16,8935,100.0,2816,31.5,7331,82.0,6119,68.5,1212,13.6,1604,18.0
07,30,05,17,9536,100.0,3409,35.7,7624,79.9,6127,64.3,1497,15.7,1912,20.1
07,30,06,18,9273,100.0,3199,34.5,7543,81.3,6074,65.5,1469,15.8,1730,18.7
07,30,06,19,12214,100.0,5668,46.4,9250,75.7,6546,53.6,2704,22.1,2964,24.3
07,40,07,20,11816,100.0,5071,42.9,9340,79.0,6745,57.1,2595,22.0,2476,21.0
07,40,07,21,7187,100.0,3575,49.7,4594,63.9,3612,50.3,982,13.7,2593,36.1
07,40,08,22,3064,100.0,1083,35.3,2465,80.5,1981,64.7,484,15.8,599,19.5
07,40,08,23,9773,100.0,3764,38.5,7797,79.8,6009,61.5,1788,18.3,1976,20.2
07,40,08,24,7418,100.0,3088,41.6,5690,76.7,4330,58.4,1360,18.3,1728,23.3
07,40,08,25,7368,100.0,3305,44.9,5474,74.3,4063,55.1,1411,19.2,1894,25.7
07,40,08,26,5170,100.0,1578,30.5,4368,84.5,3592,69.5,776,15.0,802,15.5
07,40,09,27,11318,100.0,5521,48.8,8068,71.3,5797,51.2,2271,20.1,3250,28.7
07,40,09,28,3979,100.0,2386,60.0,2438,61.3,1593,40.0,845,21.2,1541,38.7
07,50,10,29,8456,100.0,3902,46.1,6366,75.3,4554,53.9,1812,21.4,2090,24.7
07,50,10,30,8773,100.0,3867,44.1,6739,76.8,4906,55.9,1833,20.9,2034,23.2
07,50,10,31,9142,100.0,3282,35.9,7485,81.9,5860,64.1,1625,17.8,1657,18.1
07,50,10,32,5989,100.0,2287,38.2,4954,82.7,3702,61.8,1252,20.9,1035,17.3
07,50,11,33,8165,100.0,3559,43.6,6033,73.9,4606,56.4,1427,17.5,2132,26.1
07,50,11,34,10568,100.0,3385,32.0,8947,84.7,7183,68.0,1764,16.7,1621,15.3
07,50,11,35,2242,100.0,619,27.6,1963,87.6,1623,72.4,340,15.2,279,12.4
07,60,12,36,10313,100.0,4745,46.0,7537,73.1,5568,54.0,1969,19.1,2776,26.9
07,60,12,37,4797,100.0,1367,28.5,4171,87.0,3430,71.5,741,15.4,626,13.0
07,60,12,38,2855,100.0,1184,41.5,2333,81.7,1671,58.5,662,23.2,522,18.3
07,60,13,39,5725,100.0,2489,43.5,4756,83.1,3236,56.5,1520,26.6,969,16.9
07,60,13,40,6498,100.0,2911,44.8,5223,80.4,3587,55.2,1636,25.2,1275,19.6
07,60,13,41,2226,100.0,716,32.2,1839,82.6,1510,67.8,329,14.8,387,17.4
07,60,14,42,10419,100.0,2650,25.4,9151,87.8,7769,74.6,1382,13.3,1268,12.2
07,60,14,43,10927,100.0,2806,25.7,9718,88.9,8121,74.3,1597,14.6,1209,11.1
07,60,15,44,9020,100.0,3153,35.0,7472,82.8,5867,65.0,1605,17.8,1548,17.2
07,60,15,45,8250,100.0,3433,41.6,6347,76.9,4817,58.4,1530,18.5,1903,23.1
07,60,15,46,7006,100.0,1538,22.0,6306,90.0,5468,78.0,838,12.0,700,10.0
07,60,15,47,3870,100.0,949,24.5,3312,85.6,2921,75.5,391,10.1,558,14.4
07,60,15,48,2927,100.0,608,20.8,2641,90.2,2319,79.2,322,11.0,286,9.8
08,10,01,01,4696,100.0,2711,57.7,2850,60.7,1985,42.3,865,18.4,1846,39.3
08,10,01,02,8304,100.0,4521,54.4,5280,63.6,3783,45.6,1497,18.0,3024,36.4
08,10,01,03,7275,100.0,3756,51.6,4828,66.4,3519,48.4,1309,18.0,2447,33.6
08,10,01,04,6731,100.0,4007,59.5,4172,62.0,2724,40.5,1448,21.5,2559,38.0
08,10,01,05,6187,100.0,3901,63.1,3860,62.4,2286,36.9,1574,25.4,2327,37.6
08,10,02,06,9506,100.0,5614,59.1,5802,61.0,3892,40.9,1910,20.1,3704,39.0
08,10,02,07,7505,100.0,5065,67.5,4836,64.4,2440,32.5,2396,31.9,2669,35.6
08,10,02,08,12209,100.0,7035,57.6,7639,62.6,5174,42.4,2465,20.2,4570,37.4
08,10,02,09,8552,100.0,5156,60.3,5058,59.1,3396,39.7,1662,19.4,3494,40.9
08,10,03,10,7717,100.0,3969,51.4,5253,68.1,3748,48.6,1505,19.5,2464,31.9
08,10,03,11,7246,100.0,3586,49.5,4881,67.4,3660,50.5,1221,16.9,2365,32.6
08,10,03,12,11772,100.0,6198,52.7,7760,65.9,5574,47.3,2186,18.6,4012,34.1
08,10,03,13,3804,100.0,1471,38.7,2958,77.8,2333,61.3,625,16.4,846,22.2
08,10,03,14,8055,100.0,4947,61.4,4793,59.5,3108,38.6,1685,20.9,3262,40.5
08,10,04,15,6586,100.0,3659,55.6,4179,63.5,2927,44.4,1252,19.0,2407,36.5
08,10,04,16,6481,100.0,3457,53.3,4257,65.7,3024,46.7,1233,19.0,2224,34.3
08,10,04,17,9657,100.0,5410,56.0,6138,63.6,4247,44.0,1891,19.6,3519,36.4
08,10,04,18,9385,100.0,4569,48.7,6468,68.9,4816,51.3,1652,17.6,2917,31.1
08,10,04,19,7311,100.0,4633,63.4,4148,56.7,2678,36.6,1470,20.1,3163,43.3
08,10,05,20,5828,100.0,4407,75.6,3544,60.8,1421,24.4,2123,36.4,2284,39.2
08,10,05,21,9564,100.0,6443,67.4,6572,68.7,3121,32.6,3451,36.1,2992,31.3
08,20,06,22,5752,100.0,4043,70.3,3043,52.9,1709,29.7,1334,23.2,2709,47.1
08,20,06,23,6871,100.0,3723,54.2,4439,64.6,3148,45.8,1291,18.8,2432,35.4
08,20,06,24,8878,100.0,4471,50.4,6463,72.8,4407,49.6,2056,23.2,2415,27.2
08,20,07,25,2524,100.0,886,35.1,2171,86.0,1638,64.9,533,21.1,353,14.0
08,20,07,26,6233,100.0,1993,32.0,5281,84.7,4240,68.0,1041,16.7,952,15.3
08,20,07,27,8004,100.0,2725,34.0,6645,83.0,5279,66.0,1366,17.1,1359,17.0
08,20,07,28,1190,100.0,403,33.9,1014,85.2,787,66.1,227,19.1,176,14.8
08,20,07,29,1872,100.0,705,37.7,1587,84.8,1167,62.3,420,22.4,285,15.2
08,20,07,30,3373,100.0,1201,35.6,2741,81.3,2172,64.4,569,16.9,632,18.7
08,20,08,31,8357,100.0,2632,31.5,7162,85.7,5725,68.5,1437,17.2,1195,14.3
08,20,08,32,11800,100.0,4238,35.9,9827,83.3,7562,64.1,2265,19.2,1973,16.7
08,20,08,33,8620,100.0,4245,49.2,6460,74.9,4375,50.8,2085,24.2,2160,25.1
08,30,09,34,12603,100.0,6935,55.0,9724,77.2,5668,45.0,4056,32.2,2879,22.8
08,30,09,35,7438,100.0,3595,48.3,5847,78.6,3843,51.7,2004,26.9,1591,21.4
08,30,10,36,7431,100.0,3781,50.9,5821,78.3,3650,49.1,2171,29.2,1610,21.7
08,30,10,37,11013,100.0,6606,60.0,8253,74.9,4407,40.0,3846,34.9,2760,25.1
08,40,11,38,2885,100.0,1049,36.4,2428,84.2,1836,63.6,592,20.5,457,15.8
08,40,11,39,4171,100.0,1579,37.9,3433,82.3,2592,62.1,841,20.2,738,17.7
08,40,11,40,2681,100.0,1011,37.7,2217,82.7,1670,62.3,547,20.4,464,17.3
08,40,12,41,8319,100.0,3347,40.2,6814,81.9,4972,59.8,1842,22.1,1505,18.1
08,40,12,42,6850,100.0,2013,29.4,5979,87.3,4837,70.6,1142,16.7,871,12.7
08,40,12,43,10083,100.0,3364,33.4,8445,83.8,6719,66.6,1726,17.1,1638,16.2
08,40,12,44,7302,100.0,2061,28.2,6587,90.2,5241,71.8,1346,18.4,715,9.8
08,40,12,45,3718,100.0,1219,32.8,3291,88.5,2499,67.2,792,21.3,427,11.5
08,40,12,46,7945,100.0,2321,29.2,6965,87.7,5624,70.8,1341,16.9,980,12.3
09,10,01,01,13359,100.0,4776,35.8,10404,77.9,8583,64.2,1821,13.6,2955,22.1
09,10,02,02,4331,100.0,973,22.5,3748,86.5,3358,77.5,390,9.0,583,13.5
09,10,02,03,6994,100.0,1726,24.7,5766,82.4,5268,75.3,498,7.1,1228,17.6
09,10,03,04,11899,100.0,2591,21.8,10280,86.4,9308,78.2,972,8.2,1619,13.6
09,10,03,05,4279,100.0,1134,26.5,3551,83.0,3145,73.5,406,9.5,728,17.0
09,10,03,06,3131,100.0,1075,34.3,2511,80.2,2056,65.7,455,14.5,620,19.8
09,10,04,07,8578,100.0,1507,17.6,7635,89.0,7071,82.4,564,6.6,943,11.0
09,10,04,08,8431,100.0,1823,21.6,7240,85.9,6608,78.4,632,7.5,1191,14.1
09,10,04,09,3985,100.0,1095,27.5,3465,87.0,2890,72.5,575,14.4,520,13.0
09,20,05,10,7792,100.0,3049,39.1,5406,69.4,4743,60.9,663,8.5,2386,30.6
09,20,05,11,13260,100.0,3998,30.2,10388,78.3,9262,69.8,1126,8.5,2872,21.7
09,20,05,12,3979,100.0,1304,32.8,2982,74.9,2675,67.2,307,7.7,997,25.1
09,20,06,13,10725,100.0,4230,39.4,7384,68.8,6495,60.6,889,8.3,3341,31.2
09,20,06,14,3833,100.0,653,17.0,3351,87.4,3180,83.0,171,4.5,482,12.6
09,20,07,15,4127,100.0,2046,49.6,2618,63.4,2081,50.4,537,13.0,1509,36.6
09,20,07,16,8023,100.0,2339,29.2,6176,77.0,5684,70.8,492,6.1,1847,23.0
09,20,07,17,9703,100.0,2412,24.9,7909,81.5,7291,75.1,618,6.4,1794,18.5
09,20,08,18,4006,100.0,995,24.8,3241,80.9,3011,75.2,230,5.7,765,19.1
09,20,08,19,8506,100.0,2367,27.8,6745,79.3,6139,72.2,606,7.1,1761,20.7
09,30,09,20,13048,100.0,2960,22.7,11497,88.1,10088,77.3,1409,10.8,1551,11.9
09,30,09,21,2772,100.0,467,16.8,2536,91.5,2305,83.2,231,8.3,236,8.5
09,30,09,22,5940,100.0,1446,24.3,4983,83.9,4494,75.7,489,8.2,957,16.1
09,30,09,23,8383,100.0,2242,26.7,7149,85.3,6141,73.3,1008,12.0,1234,14.7
09,30,10,24,3662,100.0,990,27.0,3064,83.7,2672,73.0,392,10.7,598,16.3
09,30,10,25,11805,100.0,2520,21.3,10136,85.9,9285,78.7,851,7.2,1669,14.1
09,30,11,26,8131,100.0,1643,20.2,7044,86.6,6488,79.8,556,6.8,1087,13.4
09,30,12,27,1896,100.0,234,12.3,1790,94.4,1662,87.7,128,6.8,106,5.6
09,30,12,28,2623,100.0,338,12.9,2451,93.4,2285,87.1,166,6.3,172,6.6
09,40,13,29,10316,100.0,1070,10.4,9622,93.3,9246,89.6,376,3.6,694,6.7
09,40,13,30,1873,100.0,241,12.9,1741,93.0,1632,87.1,109,5.8,132,7.0
09,40,14,31,5917,100.0,1100,18.6,5094,86.1,4817,81.4,277,4.7,823,13.9
09,40,14,32,1545,100.0,290,18.8,1366,88.4,1255,81.2,111,7.2,179,11.6
09,40,14,33,4583,100.0,967,21.1,3846,83.9,3616,78.9,230,5.0,737,16.1
09,40,15,34,7622,100.0,1984,26.0,6188,81.2,5638,74.0,550,7.2,1434,18.8
09,40,16,35,7053,100.0,734,10.4,6673,94.6,6319,89.6,354,5.0,380,5.4
09,50,17,36,4635,100.0,622,13.4,4212,90.9,4013,86.6,199,4.3,423,9.1
09,50,17,37,14382,100.0,1507,10.5,13509,93.9,12875,89.5,634,4.4,873,6.1
09,50,18,38,10704,100.0,1574,14.7,9692,90.5,9130,85.3,562,5.3,1012,9.5
09,50,19,39,6781,100.0,1648,24.3,5580,82.3,5133,75.7,447,6.6,1201,17.7
09,50,19,40,2685,100.0,547,20.4,2285,85.1,2138,79.6,147,5.5,400,14.9
09,50,19,41,2805,100.0,491,17.5,2463,87.8,2314,82.5,149,5.3,342,12.2
09,50,20,42,4173,100.0,597,14.3,3763,90.2,3576,85.7,187,4.5,410,9.8
09,50,20,43,9127,100.0,1027,11.3,8498,93.1,8100,88.7,398,4.4,629,6.9
10,10,01,01,5853,100.0,1927,32.9,4621,79.0,3926,67.1,695,11.9,1232,21.0
10,10,01,02,3668,100.0,1303,35.5,2711,73.9,2365,64.5,346,9.4,957,26.1
10,10,01,03,7827,100.0,2282,29.2,6408,81.9,5545,70.8,863,11.0,1419,18.1
10,10,01,04,7557,100.0,2385,31.6,6392,84.6,5172,68.4,1220,16.1,1165,15.4
10,10,02,05,1263,100.0,888,70.3,424,33.6,375,29.7,49,3.9,839,66.4
10,10,02,06,11353,100.0,3401,30.0,9319,82.1,7952,70.0,1367,12.0,2034,17.9
10,10,02,07,8242,100.0,1643,19.9,7157,86.8,6599,80.1,558,6.8,1085,13.2
10,10,02,08,9829,100.0,2925,29.8,7967,81.1,6904,70.2,1063,10.8,1862,18.9
10,10,02,09,9525,100.0,3443,36.1,7085,74.4,6082,63.9,1003,10.5,2440,25.6
10,10,02,10,10846,100.0,3257,30.0,9020,83.2,7589,70.0,1431,13.2,1826,16.8
10,10,03,11,2263,100.0,775,34.2,1764,77.9,1488,65.8,276,12.2,499,22.1
10,10,03,12,15483,100.0,4989,32.2,12478,80.6,10494,67.8,1984,12.8,3005,19.4
10,10,03,13,4939,100.0,1762,35.7,3712,75.2,3177,64.3,535,10.8,1227,24.8
10,10,03,14,6446,100.0,1532,23.8,5585,86.6,4914,76.2,671,10.4,861,13.4
10,10,03,15,7821,100.0,2549,32.6,6392,81.7,5272,67.4,1120,14.3,1429,18.3
10,10,03,16,3740,100.0,626,16.7,3466,92.7,3114,83.3,352,9.4,274,7.3
10,20,04,17,7950,100.0,3243,40.8,5783,72.7,4707,59.2,1076,13.5,2167,27.3
10,20,04,18,6983,100.0,1868,26.8,5576,79.9,5115,73.2,461,6.6,1407,20.1
10,20,04,19,4333,100.0,1996,46.1,2851,65.8,2337,53.9,514,11.9,1482,34.2
10,20,04,20,8235,100.0,3096,37.6,5700,69.2,5139,62.4,561,6.8,2535,30.8
10,20,04,21,1731,100.0,895,51.7,1193,68.9,836,48.3,357,20.6,538,31.1
10,20,04,22,7136,100.0,3297,46.2,4382,61.4,3839,53.8,543,7.6,2754,38.6
10,20,04,23,6170,100.0,2396,38.8,4398,71.3,3774,61.2,624,10.1,1772,28.7
10,20,05,24,11553,100.0,3391,29.4,9019,78.1,8162,70.6,857,7.4,2534,21.9
10,20,05,25,5402,100.0,1736,32.1,4078,75.5,3666,67.9,412,7.6,1324,24.5
10,20,05,26,6251,100.0,2491,39.8,4373,70.0,3760,60.2,613,9.8,1878,30.0
10,20,06,27,3655,100.0,948,25.9,3052,83.5,2707,74.1,345,9.4,603,16.5
10,20,06,28,6607,100.0,2046,31.0,5114,77.4,4561,69.0,553,8.4,1493,22.6
10,20,06,29,9139,100.0,1911,20.9,7953,87.0,7228,79.1,725,7.9,1186,13.0
10,20,06,30,6570,100.0,1123,17.1,5928,90.2,5447,82.9,481,7.3,642,9.8
10,30,07,31,7793,100.0,1535,19.7,6800,87.3,6258,80.3,542,7.0,993,12.7
10,30,07,32,7164,100.0,1814,25.3,6058,84.6,5350,74.7,708,9.9,1106,15.4
10,30,07,33,5327,100.0,1677,31.5,4186,78.6,3650,68.5,536,10.1,1141,21.4
10,30,07,34,10595,100.0,1564,14.8,9856,93.0,9031,85.2,825,7.8,739,7.0
10,40,08,35,7906,100.0,879,11.1,7451,94.2,7027,88.9,424,5.4,455,5.8
10,40,08,36,3972,100.0,534,13.4,3641,91.7,3438,86.6,203,5.1,331,8.3
10,40,08,37,7886,100.0,735,9.3,7559,95.9,7151,90.7,408,5.2,327,4.1
10,40,09,38,10270,100.0,1059,10.3,9756,95.0,9211,89.7,545,5.3,514,5.0
10,40,09,39,4543,100.0,639,14.1,4191,92.3,3904,85.9,287,6.3,352,7.7
10,40,09,40,5891,100.0,513,8.7,5634,95.6,5378,91.3,256,4.3,257,4.4
10,40,09,41,9795,100.0,946,9.7,9373,95.7,8849,90.3,524,5.3,422,4.3
11,10,01,01,3325,100.0,351,10.6,3138,94.4,2974,89.4,164,4.9,187,5.6
11,10,01,02,3100,100.0,1322,42.6,2090,67.4,1778,57.4,312,10.1,1010,32.6
11,10,02,03,9109,100.0,3345,36.7,6887,75.6,5764,63.3,1123,12.3,2222,24.4
11,10,02,04,7431,100.0,2850,38.4,5495,73.9,4581,61.6,914,12.3,1936,26.1
11,10,02,05,6231,100.0,2161,34.7,4686,75.2,4070,65.3,616,9.9,1545,24.8
11,10,02,06,7689,100.0,2641,34.3,5711,74.3,5048,65.7,663,8.6,1978,25.7
11,10,03,07,11791,100.0,3997,33.9,9292,78.8,7794,66.1,1498,12.7,2499,21.2
11,10,03,08,9721,100.0,3304,34.0,7484,77.0,6417,66.0,1067,11.0,2237,23.0
11,10,03,09,6597,100.0,2071,31.4,5050,76.5,4526,68.6,524,7.9,1547,23.5
11,20,04,10,10336,100.0,3603,34.9,7619,73.7,6733,65.1,886,8.6,2717,26.3
11,20,04,11,6928,100.0,1935,27.9,5637,81.4,4993,72.1,644,9.3,1291,18.6
11,20,05,12,3966,100.0,913,23.0,3253,82.0,3053,77.0,200,5.0,713,18.0
11,20,05,13,10261,100.0,3139,30.6,7880,76.8,7122,69.4,758,7.4,2381,23.2
11,20,05,14,15803,100.0,5335,33.8,12284,77.7,10468,66.2,1816,11.5,3519,22.3
11,20,05,15,4334,100.0,1160,26.8,3653,84.3,3174,73.2,479,11.1,681,15.7
11,30,06,16,6012,100.0,2363,39.3,4573,76.1,3649,60.7,924,15.4,1439,23.9
11,30,06,17,4388,100.0,1393,31.7,3553,81.0,2995,68.3,558,12.7,835,19.0
11,30,06,18,3775,100.0,1295,34.3,2829,74.9,2480,65.7,349,9.2,946,25.1
11,30,06,19,8851,100.0,3514,39.7,6263,70.8,5337,60.3,926,10.5,2588,29.2
11,30,06,20,11345,100.0,4360,38.4,8510,75.0,6985,61.6,1525,13.4,2835,25.0
11,30,07,21,6551,100.0,4530,69.1,2476,37.8,2021,30.9,455,6.9,4075,62.2
11,30,07,22,10217,100.0,3041,29.8,8394,82.2,7176,70.2,1218,11.9,1823,17.8
11,30,07,23,2780,100.0,1969,70.8,1022,36.8,811,29.2,211,7.6,1758,63.2
11,30,07,24,4256,100.0,1362,32.0,3315,77.9,2894,68.0,421,9.9,941,22.1
11,30,07,25,10048,100.0,2653,26.4,8210,81.7,7395,73.6,815,8.1,1838,18.3
11,30,08,26,10368,100.0,4380,42.2,7465,72.0,5988,57.8,1477,14.2,2903,28.0
11,40,09,27,4248,100.0,1171,27.6,3487,82.1,3077,72.4,410,9.7,761,17.9
11,40,09,28,2721,100.0,1115,41.0,1858,68.3,1606,59.0,252,9.3,863,31.7
11,40,09,29,16604,100.0,5156,31.1,12769,76.9,11448,68.9,1321,8.0,3835,23.1
11,40,09,30,4758,100.0,969,20.4,4153,87.3,3789,79.6,364,7.7,605,12.7
11,40,09,31,6937,100.0,2117,30.5,5488,79.1,4820,69.5,668,9.6,1449,20.9
11,40,10,32,6157,100.0,2449,39.8,4363,70.9,3708,60.2,655,10.6,1794,29.1
11,40,10,33,6827,100.0,2855,41.8,4989,73.1,3972,58.2,1017,14.9,1838,26.9
11,40,10,34,3355,100.0,1222,36.4,2483,74.0,2133,63.6,350,10.4,872,26.0
11,40,11,35,10997,100.0,4009,36.5,8382,76.2,6988,63.5,1394,12.7,2615,23.8
11,40,11,36,8204,100.0,2279,27.8,6472,78.9,5925,72.2,547,6.7,1732,21.1
11,40,11,37,8690,100.0,3227,37.1,6618,76.2,5463,62.9,1155,13.3,2072,23.8
11,50,12,38,4457,100.0,1212,27.2,3717,83.4,3245,72.8,472,10.6,740,16.6
11,50,13,39,10536,100.0,2805,26.6,8551,81.2,7731,73.4,820,7.8,1985,18.8
11,50,13,40,11215,100.0,2118,18.9,9859,87.9,9097,81.1,762,6.8,1356,12.1
11,50,13,41,9169,100.0,2575,28.1,7364,80.3,6594,71.9,770,8.4,1805,19.7
12,10,01,01,11129,100.0,6510,58.5,7126,64.0,4619,41.5,2507,22.5,4003,36.0
12,10,01,02,9968,100.0,5336,53.5,6600,66.2,4632,46.5,1968,19.7,3368,33.8
12,10,01,03,7626,100.0,3588,47.0,5548,72.8,4038,53.0,1510,19.8,2078,27.2
12,10,02,04,9054,100.0,4736,52.3,6205,68.5,4318,47.7,1887,20.8,2849,31.5
12,10,02,05,13896,100.0,6862,49.4,9828,70.7,7034,50.6,2794,20.1,4068,29.3
12,10,02,06,4678,100.0,1764,37.7,3694,79.0,2914,62.3,780,16.7,984,21.0
12,20,03,07,2766,100.0,1262,45.6,1982,71.7,1504,54.4,478,17.3,784,28.3
12,20,03,08,5760,100.0,2712,47.1,4248,73.8,3048,52.9,1200,20.8,1512,26.3
12,20,03,09,11085,100.0,6385,57.6,6947,62.7,4700,42.4,2247,20.3,4138,37.3
12,20,03,10,8098,100.0,4923,60.8,5145,63.5,3175,39.2,1970,24.3,2953,36.5
12,20,04,11,309,100.0,211,68.3,182,58.9,98,31.7,84,27.2,127,41.1
12,20,04,12,6359,100.0,2386,37.5,5041,79.3,3973,62.5,1068,16.8,1318,20.7
12,20,04,13,8087,100.0,3562,44.0,6073,75.1,4525,56.0,1548,19.1,2014,24.9
12,20,04,14,1765,100.0,758,42.9,1196,67.8,1007,57.1,189,10.7,569,32.2
12,20,05,15,11010,100.0,3004,27.3,9224,83.8,8006,72.7,1218,11.1,1786,16.2
12,40,06,16,6163,100.0,1154,18.7,5542,89.9,5009,81.3,533,8.6,621,10.1
12,40,06,17,6803,100.0,1030,15.1,6374,93.7,5773,84.9,601,8.8,429,6.3
12,40,06,18,3793,100.0,691,18.2,3498,92.2,3102,81.8,396,10.4,295,7.8
12,40,06,19,7755,100.0,1248,16.1,7146,92.1,6507,83.9,639,8.2,609,7.9
12,40,07,20,8446,100.0,1239,14.7,7931,93.9,7207,85.3,724,8.6,515,6.1
12,40,07,21,8010,100.0,1292,16.1,7372,92.0,6718,83.9,654,8.2,638,8.0
12,40,07,22,8521,100.0,1405,16.5,7824,91.8,7116,83.5,708,8.3,697,8.2
12,40,07,23,8123,100.0,1462,18.0,7399,91.1,6661,82.0,738,9.1,724,8.9
12,50,08,24,9667,100.0,1802,18.6,8734,90.3,7865,81.4,869,9.0,933,9.7
12,50,08,25,6902,100.0,2206,32.0,5409,78.4,4696,68.0,713,10.3,1493,21.6
12,50,09,26,5152,100.0,1604,31.1,4206,81.6,3548,68.9,658,12.8,946,18.4
12,50,09,27,6823,100.0,1976,29.0,5820,85.3,4847,71.0,973,14.3,1003,14.7
12,50,09,28,5200,100.0,1161,22.3,4601,88.5,4039,77.7,562,10.8,599,11.5
12,50,09,29,5074,100.0,939,18.5,4721,93.0,4135,81.5,586,11.5,353,7.0
12,50,09,30,9683,100.0,3443,35.6,7596,78.4,6240,64.4,1356,14.0,2087,21.6
12,60,10,31,3277,100.0,1087,33.2,2759,84.2,2190,66.8,569,17.4,518,15.8
12,60,10,32,6144,100.0,3380,55.0,4013,65.3,2764,45.0,1249,20.3,2131,34.7
12,60,11,33,11484,100.0,6187,53.9,8321,72.5,5297,46.1,3024,26.3,3163,27.5
12,60,11,34,15911,100.0,7881,49.5,11742,73.8,8030,50.5,3712,23.3,4169,26.2
12,60,12,35,10645,100.0,6368,59.8,7309,68.7,4277,40.2,3032,28.5,3336,31.3
12,60,12,36,3095,100.0,1400,45.2,2474,79.9,1695,54.8,779,25.2,621,20.1
