district_id,forecast_area_id,district_region_id,planning_area_id,inhabitants,inhabitants_percentage,inhabitants_with_migration_background,inhabitants_with_migration_background_percentage,inhabitants_germans,inhabitants_germans_percentage,inhabitants_germans_without_migration_background,inhabitants_germans_without_migration_background_percentage,inhabitants_germans_with_migration_background,inhabitants_germans_with_migration_background_percentage,inhabitants_foreigners,inhabitants_foreigners_percentage
01,01,11,01,3126,100.0,1700,54.382597568778,1962,62.763915547025,1426,45.617402431222,536,17.1465131158029,1164,37.2360844529751
01,01,11,02,199,100.0,66,33.1658291457286,142,71.356783919598,133,66.8341708542714,9,4.52261306532663,57,28.643216080402
01,01,11,03,5157,100.0,2838,55.0319953461315,3366,65.2705061082024,2319,44.9680046538685,1047,20.3025014543339,1791,34.7294938917976
01,01,11,04,4442,100.0,2793,62.8770823953174,2841,63.9576767221972,1649,37.1229176046826,1192,26.8347591175146,1601,36.0423232778028
01,01,11,05,1118,100.0,616,55.0983899821109,668,59.7495527728086,502,44.9016100178891,166,14.8479427549195,450,40.2504472271914
01,01,12,01,2062,100.0,1014,49.1755577109602,1416,68.6711930164888,1048,50.8244422890398,368,17.8467507274491,646,31.3288069835112
01,01,12,02,499,100.0,202,40.4809619238477,350,70.1402805611223,297,59.5190380761523,53,10.6212424849699,149,29.8597194388778
01,01,12,03,946,100.0,466,49.2600422832981,597,63.107822410148,480,50.7399577167019,117,12.3678646934461,349,36.892177589852
01,01,12,04,6627,100.0,2631,39.7012222725215,4919,74.2266485589256,3996,60.2987777274785,923,13.9278708314471,1708,25.7733514410744
01,01,13,01,5877,100.0,2142,36.4471669218989,4358,74.1534796664965,3735,63.5528330781011,623,10.6006465883954,1519,25.8465203335035
01,01,13,02,12316,100.0,4390,35.6446898343618,9272,75.284183176356,7926,64.3553101656382,1346,10.9288730107178,3044,24.715816823644
01,01,13,03,8602,100.0,3213,37.3517786561265,6339,73.6921646128807,5389,62.6482213438735,950,11.0439432690072,2263,26.3078353871193
01,01,13,04,8454,100.0,2663,31.4998817127987,6811,80.5654128223326,5791,68.5001182872013,1020,12.0652945351313,1643,19.4345871776674
01,01,13,05,7217,100.0,2195,30.4142995704586,5811,80.5182208673964,5022,69.5857004295414,789,10.9325204378551,1406,19.4817791326036
01,01,13,06,8797,100.0,3061,34.795953165852,6823,77.5605319995453,5736,65.204046834148,1087,12.3564851653973,1974,22.4394680004547
01,01,14,01,15467,100.0,5611,36.2772354044094,11421,73.8410810111851,9856,63.7227645955906,1565,10.1183164155945,4046,26.1589189888149
01,01,14,02,12893,100.0,4262,33.0566974327154,9953,77.1969285658885,8631,66.9433025672846,1322,10.2536259986039,2940,22.8030714341115
01,02,21,01,3434,100.0,1722,50.1456027955737,2235,65.0844496214327,1712,49.8543972044263,523,15.2300524170064,1199,34.9155503785673
01,02,21,02,6284,100.0,3565,56.7313812858052,3835,61.0280076384468,2719,43.2686187141948,1116,17.7593889242521,2449,38.9719923615531
01,02,21,03,263,100.0,179,68.0608365019012,130,49.4296577946768,84,31.9391634980989,46,17.4904942965779,133,50.5703422053232
01,02,21,04,17903,100.0,8277,46.2324750041893,12701,70.9434173043624,9626,53.7675249958108,3075,17.1758923085516,5202,29.0565826956376
01,02,21,05,5147,100.0,2857,55.5080629492908,3439,66.8156207499514,2290,44.4919370507092,1149,22.3236836992423,1708,33.1843792500486
01,02,21,06,11560,100.0,3832,33.1487889273356,9323,80.6487889273356,7728,66.8512110726644,1595,13.7975778546713,2237,19.3512110726644
01,02,22,01,10538,100.0,4832,45.8531030556083,7626,72.3666729929778,5706,54.1468969443917,1920,18.2197760485861,2912,27.6333270070222
01,02,22,02,1467,100.0,947,64.5535105657805,1002,68.3026584867076,520,35.4464894342195,482,32.8561690524881,465,31.6973415132924
01,02,22,03,6866,100.0,3876,56.4520827264783,4679,68.1473929507719,2990,43.5479172735217,1689,24.5994756772502,2187,31.8526070492281
01,02,22,04,5898,100.0,2207,37.4194642251611,4507,76.4157341471685,3691,62.5805357748389,816,13.8351983723296,1391,23.5842658528315
01,02,22,05,3219,100.0,1811,56.2597079838459,2289,71.1090400745573,1408,43.7402920161541,881,27.3687480584032,930,28.8909599254427
01,02,22,06,3044,100.0,1140,37.4507227332457,2434,79.9605781865966,1904,62.5492772667543,530,17.4113009198423,610,20.0394218134034
01,02,22,07,5581,100.0,2317,41.5158573732306,3966,71.0625335961297,3264,58.4841426267694,702,12.5783909693603,1615,28.9374664038703
01,03,31,01,26241,100.0,15446,58.86208604855,16231,61.8535878968027,10795,41.13791395145,5436,20.7156739453527,10010,38.1464121031973
01,03,31,02,11602,100.0,6811,58.7053956214446,7331,63.1873814859507,4791,41.2946043785554,2540,21.8927771073953,4271,36.8126185140493
01,03,32,01,12955,100.0,8337,64.3535314550367,9116,70.366653801621,4618,35.6464685449633,4498,34.7201852566577,3839,29.633346198379
01,03,32,02,9720,100.0,5177,53.261316872428,7214,74.2181069958848,4543,46.738683127572,2671,27.4794238683128,2506,25.7818930041152
01,03,32,03,13974,100.0,8558,61.2423071418348,8757,62.6663804207815,5416,38.7576928581652,3341,23.9086875626163,5217,37.3336195792185
01,04,41,01,20069,100.0,8880,44.2473466540436,14514,72.3204942946833,11189,55.7526533459564,3325,16.5678409487269,5555,27.6795057053167
01,04,41,02,15825,100.0,5645,35.6714060031596,12460,78.7361769352291,10180,64.3285939968404,2280,14.4075829383886,3365,21.2638230647709
01,04,41,03,8094,100.0,3919,48.4185816654312,5540,68.4457622930566,4175,51.5814183345688,1365,16.8643439584878,2554,31.5542377069434
01,04,42,01,23308,100.0,15406,66.0974772610263,13489,57.8728333619358,7902,33.9025227389737,5587,23.9703106229621,9819,42.1271666380642
01,04,42,02,16628,100.0,9289,55.8636035602598,10191,61.2881885975463,7339,44.1363964397402,2852,17.1517921578061,6437,38.7118114024537
01,04,42,03,15944,100.0,8916,55.920722528851,10067,63.1397390868038,7028,44.079277471149,3039,19.0604616156548,5877,36.8602609131962
02,01,01,01,6140,100.0,4237,69.0065146579805,3701,60.2768729641694,1903,30.9934853420195,1798,29.2833876221498,2439,39.7231270358306
02,01,01,02,13237,100.0,8731,65.9590541663519,9168,69.2604064365037,4506,34.0409458336481,4662,35.2194606028556,4069,30.7395935634963
02,01,01,03,15588,100.0,10538,67.6032845778804,10253,65.7749550936618,5050,32.3967154221196,5203,33.3782396715422,5335,34.2250449063382
02,01,01,04,5103,100.0,3240,63.4920634920635,3471,68.0188124632569,1863,36.5079365079365,1608,31.5108759553204,1632,31.9811875367431
02,02,02,01,296,100.0,139,46.9594594594595,218,73.6486486486487,157,53.0405405405405,61,20.6081081081081,78,26.3513513513513
02,02,02,02,5844,100.0,2330,39.8699520876112,4327,74.0417522245038,3514,60.1300479123888,813,13.911704312115,1517,25.9582477754962
02,02,02,03,10728,100.0,3870,36.0738255033557,8387,78.1785980611484,6858,63.9261744966443,1529,14.2524235645041,2341,21.8214019388516
02,02,02,04,12167,100.0,4844,39.8126078737569,9106,74.841785156571,7323,60.1873921262431,1783,14.6543930303279,3061,25.1582148434289
02,02,02,05,14832,100.0,5646,38.0663430420712,11380,76.7259978425027,9186,61.9336569579288,2194,14.7923408845739,3452,23.2740021574973
02,02,02,06,19032,100.0,8352,43.8839848675914,13950,73.297604035309,10680,56.1160151324086,3270,17.1815889029004,5082,26.702395964691
02,03,03,01,9157,100.0,5679,62.0181282079284,5642,61.6140657420553,3478,37.9818717920716,2164,23.6321939499836,3515,38.3859342579447
02,03,03,02,13272,100.0,6978,52.5768535262206,8953,67.457805907173,6294,47.4231464737794,2659,20.0346594333936,4319,32.542194092827
02,03,04,01,15187,100.0,7058,46.4739579903865,10587,69.7109369855798,8129,53.5260420096135,2458,16.1848949759663,4600,30.2890630144202
02,03,04,02,11244,100.0,5458,48.5414443258627,7590,67.5026680896478,5786,51.4585556741373,1804,16.0441124155105,3654,32.4973319103522
02,04,05,01,5447,100.0,1189,21.828529465761,4770,87.5711400771067,4258,78.171470534239,512,9.39966954286763,677,12.4288599228933
02,04,05,02,7152,100.0,1601,22.3853467561521,6144,85.9060402684564,5551,77.6146532438479,593,8.2913870246085,1008,14.0939597315436
02,04,05,03,10726,100.0,2207,20.5761700540742,9238,86.1271676300578,8519,79.4238299459258,719,6.70333768413202,1488,13.8728323699422
02,04,07,01,12316,100.0,3952,32.0883403702501,9711,78.8486521597921,8364,67.9116596297499,1347,10.9369925300422,2605,21.1513478402079
02,04,07,02,10671,100.0,2178,20.4104582513354,9248,86.6647924280761,8493,79.5895417486646,755,7.07525067941149,1423,13.3352075719239
02,04,07,03,928,100.0,611,65.8405172413793,412,44.3965517241379,317,34.1594827586207,95,10.2370689655172,516,55.6034482758621
02,05,06,01,8785,100.0,2139,24.3483210017075,7258,82.6180990324417,6646,75.6516789982926,612,6.96642003414912,1527,17.3819009675583
02,05,06,02,20075,100.0,4814,23.9800747198007,16768,83.5267745952678,15261,76.0199252801993,1507,7.50684931506849,3307,16.4732254047323
02,05,08,01,18879,100.0,5103,27.0300333704116,15276,80.9153027173049,13776,72.9699666295884,1500,7.94533608771651,3603,19.0846972826951
02,05,08,02,19959,100.0,4987,24.9862217545969,16334,81.8377674232176,14972,75.0137782454031,1362,6.82398917781452,3625,18.1622325767824
02,05,08,03,6664,100.0,1601,24.0246098439376,5530,82.9831932773109,5063,75.9753901560624,467,7.0078031212485,1134,17.0168067226891
02,05,08,04,3567,100.0,697,19.5402298850575,3162,88.6459209419681,2870,80.4597701149425,292,8.18615082702551,405,11.354079058032
03,01,01,01,3507,100.0,353,10.0655831194753,3289,93.7838608497291,3154,89.9344168805247,135,3.84944396920445,218,6.21613915027089
03,01,01,02,11649,100.0,1447,12.4216670958881,10594,90.9434286204825,10202,87.578332904112,392,3.3650957163705,1055,9.05657137951756
03,01,01,04,213,100.0,39,18.3098591549296,192,90.1408450704225,174,81.6901408450704,18,8.45070422535211,21,9.85915492957746
03,02,02,03,2053,100.0,81,3.94544568923527,2023,98.5387238188018,1972,96.0545543107648,51,2.48416950803702,30,1.46127618119825
03,02,02,09,14143,100.0,1651,11.6736194583893,13218,93.4596620236159,12492,88.3263805416107,726,5.13328148200523,925,6.54033797638408
03,02,02,10,10503,100.0,951,9.05455584118823,10051,95.6964676759021,9552,90.9454441588118,499,4.75102351709036,452,4.30353232409788
03,02,03,07,17366,100.0,1691,9.73741794310722,16812,96.8098583438904,15675,90.2625820568928,1137,6.54727628699758,554,3.19014165610964
03,03,04,05,10610,100.0,906,8.53911404335533,10267,96.7672007540057,9704,91.4608859566447,563,5.30631479736098,343,3.23279924599435
03,03,04,06,8147,100.0,463,5.68307352399656,7968,97.8028722229042,7684,94.3169264760034,284,3.4859457469007,179,2.19712777709586
03,03,07,11,6724,100.0,310,4.6103509815586,6607,98.2599643069601,6414,95.3896490184414,193,2.87031528851874,117,1.74003569303986
03,03,07,15,6687,100.0,523,7.82114550620607,6436,96.2464483325856,6164,92.1788544937939,272,4.06759383879169,251,3.75355166741439
03,03,07,16,1136,100.0,34,2.99295774647887,1126,99.1197183098592,1102,97.0070422535211,24,2.11267605633803,10,0.880281690140845
03,04,05,08,4593,100.0,844,18.3757892445025,4349,94.6875680383192,3749,81.6242107554975,600,13.0633572828217,244,5.31243196168082
03,04,05,12,9565,100.0,1054,11.019341348667,9132,95.4730789336121,8511,88.980658651333,621,6.49242028227914,433,4.52692106638787
03,04,05,13,3367,100.0,401,11.9097119097119,3191,94.7727947727948,2966,88.0902880902881,225,6.68250668250668,176,5.22720522720523
03,04,06,14,34543,100.0,3662,10.6012795646006,32595,94.360651941059,30881,89.3987204353994,1714,4.96193150565961,1948,5.63934805894103
03,04,08,18,33787,100.0,4075,12.060851806908,31135,92.1508272412466,29712,87.939148193092,1423,4.21167904815462,2652,7.84917275875337
03,05,09,19,5555,100.0,928,16.7056705670567,4763,85.7425742574258,4627,83.2943294329433,136,2.44824482448245,792,14.2574257425743
03,05,09,20,7168,100.0,765,10.6724330357143,6737,93.9871651785714,6403,89.3275669642857,334,4.65959821428571,431,6.01283482142857
03,05,09,23,8820,100.0,1309,14.8412698412698,7987,90.5555555555556,7511,85.1587301587302,476,5.3968253968254,833,9.44444444444444
03,05,09,24,5613,100.0,949,16.9071797612685,4967,88.4910030286834,4664,83.0928202387315,303,5.3981827899519,646,11.5089969713166
03,05,09,25,8772,100.0,1041,11.8673050615595,8145,92.8522571819426,7731,88.1326949384405,414,4.71956224350205,627,7.14774281805746
03,05,10,17,4138,100.0,653,15.7805703238279,3685,89.0526824552924,3485,84.2194296761721,200,4.83325277912035,453,10.9473175447076
03,05,10,21,6483,100.0,535,8.25235230603116,6113,94.2927656948944,5948,91.7476476939688,165,2.5451180009255,370,5.70723430510566
03,05,10,22,4518,100.0,261,5.77689243027888,4397,97.3218238158477,4257,94.2231075697211,140,3.0987162461266,121,2.67817618415228
03,06,11,26,14905,100.0,3363,22.5628983562563,12632,84.750083864475,11542,77.4371016437437,1090,7.3129822207313,2273,15.249916135525
03,06,11,31,10145,100.0,2846,28.0532281912272,8177,80.6012814194184,7299,71.9467718087728,878,8.65450961064564,1968,19.3987185805816
03,06,12,27,14376,100.0,3086,21.4663327768503,12306,85.6010016694491,11290,78.5336672231497,1016,7.06733444629939,2070,14.3989983305509
03,06,12,28,12462,100.0,2202,17.6697159364468,10990,88.1880917990692,10260,82.3302840635532,730,5.85780773551597,1472,11.8119082009308
03,06,13,32,22176,100.0,5929,26.7361111111111,18265,82.3638167388167,16247,73.2638888888889,2018,9.09992784992785,3911,17.6361832611833
03,06,14,29,10078,100.0,1068,10.5973407422108,9442,93.6892240523914,9010,89.4026592577892,432,4.2865647946021,636,6.31077594760865
03,06,14,30,3206,100.0,667,20.804741110418,2695,84.061135371179,2539,79.195258889582,156,4.86587648159701,511,15.938864628821
03,06,14,34,6124,100.0,1173,19.1541476159373,5330,87.0346178967995,4951,80.8458523840627,379,6.18876551273677,794,12.9653821032005
03,06,14,35,3907,100.0,859,21.9861786536985,3327,85.1548502687484,3048,78.0138213463015,279,7.14102892244689,580,14.8451497312516
03,06,14,41,2418,100.0,526,21.7535153019024,2164,89.4954507857734,1892,78.2464846980976,272,11.2489660876758,254,10.5045492142266
03,07,15,36,10594,100.0,3390,31.9992448555786,8313,78.4689446856711,7204,68.0007551444214,1109,10.4681895412498,2281,21.5310553143289
03,07,15,37,14620,100.0,4338,29.671682626539,11567,79.1176470588235,10282,70.328317373461,1285,8.78932968536252,3053,20.8823529411765
03,07,16,33,2709,100.0,500,18.4569952011812,2429,89.6640826873385,2209,81.5430047988188,220,8.12107788851975,280,10.3359173126615
03,07,16,38,16933,100.0,4613,27.242662257131,13819,81.6098742101222,12320,72.757337742869,1499,8.85253646725329,3114,18.3901257898778
03,07,16,39,12257,100.0,2764,22.550379375051,10522,85.8448233662397,9493,77.449620624949,1029,8.39520274129069,1735,14.1551766337603
04,01,01,01,10389,100.0,4280,41.1974203484455,8073,77.70719029743,6109,58.8025796515545,1964,18.9046106458754,2316,22.29280970257
04,01,01,02,815,100.0,292,35.8282208588957,565,69.3251533742331,523,64.1717791411043,42,5.15337423312884,250,30.6748466257669
04,01,01,03,7638,100.0,3659,47.9052107881645,5898,77.2191673212883,3979,52.0947892118356,1919,25.1243781094527,1740,22.7808326787117
04,02,02,04,163,100.0,61,37.4233128834356,123,75.4601226993865,102,62.5766871165644,21,12.8834355828221,40,24.5398773006135
04,02,02,05,1256,100.0,264,21.0191082802548,1102,87.7388535031847,992,78.9808917197452,110,8.75796178343949,154,12.2611464968153
04,02,02,06,2541,100.0,480,18.8902007083825,2271,89.3742621015348,2061,81.1097992916175,210,8.26446280991736,270,10.6257378984652
04,02,02,07,2598,100.0,693,26.6743648960739,2208,84.9884526558892,1905,73.3256351039261,303,11.662817551963,390,15.0115473441109
04,02,02,08,2848,100.0,691,24.2626404494382,2476,86.938202247191,2157,75.7373595505618,319,11.2008426966292,372,13.061797752809
04,02,02,09,3130,100.0,1106,35.3354632587859,2272,72.5878594249201,2024,64.6645367412141,248,7.92332268370607,858,27.4121405750799
04,02,03,10,602,100.0,291,48.3388704318937,350,58.1395348837209,311,51.6611295681063,39,6.47840531561462,252,41.8604651162791
04,02,03,11,14127,100.0,3701,26.1980604516175,12026,85.1277695193601,10426,73.8019395483825,1600,11.3258299709776,2101,14.8722304806399
04,02,03,12,5357,100.0,1515,28.2807541534441,4415,82.4155310808288,3842,71.7192458465559,573,10.6962852342729,942,17.5844689191712
04,02,03,13,7339,100.0,2773,37.7844392969069,5514,75.1328518871781,4566,62.2155607030931,948,12.917291184085,1825,24.8671481128219
04,02,03,14,8,100.0,8,100.0,0,0.0,0,0.0,0,0.0,8,100.0
04,03,04,15,2758,100.0,1347,48.8397389412618,1752,63.5242929659173,1411,51.1602610587382,341,12.3640319071791,1006,36.4757070340827
04,03,04,16,10357,100.0,4766,46.017186443951,7673,74.0851597953075,5591,53.982813556049,2082,20.1023462392585,2684,25.9148402046925
04,03,04,17,10797,100.0,3857,35.7228859868482,8480,78.5403352783181,6940,64.2771140131518,1540,14.2632212651663,2317,21.4596647216819
04,03,05,18,9344,100.0,3829,40.9781678082192,7047,75.4173801369863,5515,59.0218321917808,1532,16.3955479452055,2297,24.5826198630137
04,03,05,19,5624,100.0,2324,41.3229018492176,4279,76.0846372688478,3300,58.6770981507824,979,17.4075391180654,1345,23.9153627311522
04,03,06,20,8452,100.0,3515,41.5877898722196,6392,75.6270705158542,4937,58.4122101277804,1455,17.2148603880738,2060,24.3729294841458
04,03,06,21,2972,100.0,1529,51.4468371467026,2037,68.5397039030956,1443,48.5531628532974,594,19.9865410497981,935,31.4602960969044
04,03,06,22,10187,100.0,4503,44.2033964857171,7548,74.0944340826544,5684,55.7966035142829,1864,18.2978305683715,2639,25.9055659173456
04,03,06,23,4588,100.0,2439,53.1604184829991,3160,68.8753269398431,2149,46.8395815170009,1011,22.0357454228422,1428,31.1246730601569
04,03,07,24,6281,100.0,2053,32.6858780448973,5069,80.7037096003821,4228,67.3141219551027,841,13.3895876452794,1212,19.2962903996179
04,03,07,25,11845,100.0,4447,37.5432672013508,8939,75.4664415365133,7398,62.4567327986492,1541,13.0097087378641,2906,24.5335584634867
04,03,07,26,5388,100.0,2169,40.2561247216036,4061,75.3711952487008,3219,59.7438752783964,842,15.6273199703044,1327,24.6288047512992
04,03,08,27,11921,100.0,5967,50.0545256270447,8025,67.3181780052009,5954,49.9454743729553,2071,17.3727036322456,3896,32.6818219947991
04,03,08,28,9293,100.0,3862,41.5581620574626,6815,73.3347681050253,5431,58.4418379425374,1384,14.8929301624879,2478,26.6652318949747
04,03,09,29,5843,100.0,2369,40.5442409721034,4344,74.3453705288379,3474,59.4557590278966,870,14.8896115009413,1499,25.6546294711621
04,03,09,30,5449,100.0,2232,40.9616443384107,4010,73.5914846760874,3217,59.0383556615893,793,14.5531290144981,1439,26.4085153239126
04,03,09,31,3470,100.0,1790,51.5850144092219,2280,65.7060518731988,1680,48.4149855907781,600,17.2910662824208,1190,34.2939481268012
04,03,10,32,14640,100.0,5449,37.2199453551913,11453,78.2308743169399,9191,62.7800546448088,2262,15.4508196721311,3187,21.7691256830601
04,04,11,33,34,100.0,9,26.4705882352941,28,82.3529411764706,25,73.5294117647059,3,8.82352941176471,6,17.6470588235294
04,04,11,34,5008,100.0,1788,35.702875399361,3993,79.732428115016,3220,64.297124600639,773,15.435303514377,1015,20.267571884984
04,04,11,35,2751,100.0,894,32.4972737186478,2234,81.2068338785896,1857,67.5027262813522,377,13.7041075972374,517,18.7931661214104
04,04,11,36,2960,100.0,900,30.4054054054054,2425,81.9256756756757,2060,69.5945945945946,365,12.3310810810811,535,18.0743243243243
04,04,11,37,7835,100.0,2574,32.8525845564773,6446,82.2718570516911,5261,67.1474154435226,1185,15.1244416081685,1389,17.7281429483089
04,04,12,38,5632,100.0,1629,28.9240056818182,4852,86.1505681818182,4003,71.0759943181818,849,15.0745738636364,780,13.8494318181818
04,04,12,39,202,100.0,87,43.0693069306931,142,70.2970297029703,115,56.9306930693069,27,13.3663366336634,60,29.7029702970297
04,04,12,40,1538,100.0,408,26.5279583875163,1304,84.7854356306892,1130,73.4720416124837,174,11.3133940182055,234,15.2145643693108
04,04,12,41,6933,100.0,1530,22.0683686715707,6071,87.5667099379778,5403,77.9316313284293,668,9.63507860954854,862,12.4332900620222
04,04,13,42,3964,100.0,1141,28.7840565085772,3356,84.6619576185671,2823,71.2159434914228,533,13.4460141271443,608,15.3380423814329
04,04,13,43,3519,100.0,984,27.9624893435635,2994,85.0809889173061,2535,72.0375106564365,459,13.0434782608696,525,14.9190110826939
04,04,13,44,10624,100.0,2564,24.1340361445783,9113,85.777484939759,8060,75.8659638554217,1053,9.91152108433735,1511,14.222515060241
04,05,14,45,6163,100.0,2477,40.1914651955217,4774,77.4622748661366,3686,59.8085348044783,1088,17.6537400616583,1389,22.5377251338634
04,05,14,46,10475,100.0,4178,39.8854415274463,8037,76.7255369928401,6297,60.1145584725537,1740,16.6109785202864,2438,23.2744630071599
04,05,14,47,5220,100.0,2002,38.3524904214559,3972,76.0919540229885,3218,61.6475095785441,754,14.4444444444444,1248,23.9080459770115
04,05,14,48,9002,100.0,3797,42.179515663186,6602,73.3392579426794,5205,57.820484336814,1397,15.5187736058654,2400,26.6607420573206
04,05,15,49,4251,100.0,1547,36.3914373088685,3294,77.4876499647142,2704,63.6085626911315,590,13.8790872735827,957,22.5123500352858
04,05,15,50,5356,100.0,1968,36.7438386855863,4220,78.790141896938,3388,63.2561613144137,832,15.5339805825243,1136,21.209858103062
04,05,15,51,4300,100.0,1604,37.3023255813953,3389,78.8139534883721,2696,62.6976744186047,693,16.1162790697674,911,21.1860465116279
04,05,16,52,9572,100.0,3355,35.0501462599248,7473,78.0714584203928,6217,64.9498537400752,1256,13.1216046803176,2099,21.9285415796072
04,05,16,53,6606,100.0,2494,37.753557372086,5110,77.3539206781714,4112,62.246442627914,998,15.1074780502573,1496,22.6460793218286
04,05,16,54,2968,100.0,947,31.9070080862534,2426,81.7385444743935,2021,68.0929919137466,405,13.6455525606469,542,18.2614555256065
04,05,16,55,6968,100.0,2761,39.6239954075775,5297,76.0189437428244,4207,60.3760045924225,1090,15.6429391504018,1671,23.9810562571757
04,05,16,56,7473,100.0,2147,28.730095008698,6227,83.3266425799545,5326,71.269904991302,901,12.0567375886525,1246,16.6733574200455
04,06,17,57,75,100.0,6,8.0,75,100.0,69,92.0,6,8.0,0,0.0
05,01,01,01,9937,100.0,2268,22.8237898762202,8916,89.7252691959344,7669,77.1762101237798,1247,12.5490590721546,1021,10.2747308040656
05,01,01,02,5700,100.0,1027,18.0175438596491,5137,90.1228070175439,4673,81.9824561403509,464,8.14035087719298,563,9.87719298245614
05,01,01,03,7397,100.0,1031,13.9380830066243,6968,94.2003514938489,6366,86.0619169933757,602,8.13843450047316,429,5.79964850615114
05,01,02,04,3100,100.0,1078,34.7741935483871,2627,84.741935483871,2022,65.2258064516129,605,19.5161290322581,473,15.258064516129
05,01,02,05,1915,100.0,465,24.2819843342037,1745,91.1227154046997,1450,75.7180156657963,295,15.4046997389034,170,8.87728459530026
05,01,02,06,9967,100.0,2935,29.4471756797432,8843,88.7227851911307,7032,70.5528243202568,1811,18.1699608708739,1124,11.2772148088693
05,01,02,07,11197,100.0,5061,45.1996070375994,9335,83.3705456818791,6136,54.8003929624006,3199,28.5701527194784,1862,16.6294543181209
05,01,02,08,7433,100.0,2068,27.8218754204224,6313,84.9320597336203,5365,72.1781245795776,948,12.7539351540428,1120,15.0679402663797
05,01,02,09,6037,100.0,1595,26.4204074871625,5387,89.2330627795262,4442,73.5795925128375,945,15.6534702666888,650,10.7669372204737
05,01,03,10,3788,100.0,1047,27.6399155227033,3207,84.662090813094,2741,72.3600844772967,466,12.3020063357973,581,15.337909186906
05,01,03,11,5535,100.0,2774,50.1174345076784,4100,74.0740740740741,2761,49.8825654923216,1339,24.1915085817525,1435,25.9259259259259
05,01,03,12,6865,100.0,3314,48.2738528769119,4692,68.3466860888565,3551,51.7261471230881,1141,16.6205389657684,2173,31.6533139111435
05,01,03,13,6504,100.0,2341,35.9932349323493,5176,79.5817958179582,4163,64.0067650676507,1013,15.5750307503075,1328,20.4182041820418
05,01,03,14,11756,100.0,3916,33.3106498809119,9690,82.425995236475,7840,66.6893501190881,1850,15.7366451173869,2066,17.574004763525
05,01,03,39,440,100.0,82,18.6363636363636,398,90.4545454545455,358,81.3636363636364,40,9.09090909090909,42,9.54545454545455
05,02,04,15,3895,100.0,668,17.1501925545571,3716,95.4043645699615,3227,82.8498074454429,489,12.5545571245186,179,4.59563543003851
05,02,04,16,1723,100.0,89,5.16540917005224,1695,98.3749274521184,1634,94.8345908299478,61,3.54033662217063,28,1.6250725478816
05,02,04,17,5749,100.0,1401,24.3694555574883,5147,89.528613671943,4348,75.6305444425117,799,13.8980692294312,602,10.4713863280571
05,02,04,18,3978,100.0,681,17.1191553544495,3686,92.6596279537456,3297,82.8808446455505,389,9.77878330819507,292,7.3403720462544
05,02,04,19,6891,100.0,1527,22.1593382673052,6187,89.7837759396314,5364,77.8406617326948,823,11.9431142069366,704,10.2162240603686
05,02,04,20,950,100.0,155,16.3157894736842,885,93.1578947368421,795,83.6842105263158,90,9.47368421052632,65,6.8421052631579
05,02,05,21,2957,100.0,681,23.0300980723706,2731,92.3571187013866,2276,76.9699019276294,455,15.3872167737572,226,7.64288129861346
05,02,05,22,7196,100.0,2745,38.1461923290717,5651,78.5297387437465,4451,61.8538076709283,1200,16.6759310728182,1545,21.4702612562535
05,02,05,23,11497,100.0,5567,48.4213273027746,9390,81.6734800382709,5930,51.5786726972254,3460,30.0948073410455,2107,18.3265199617291
05,02,05,24,6116,100.0,892,14.5846958796599,5775,94.4244604316547,5224,85.4153041203401,551,9.00915631131459,341,5.57553956834532
05,02,06,25,7379,100.0,2158,29.2451551700772,6274,85.025071147852,5221,70.7548448299228,1053,14.2702263179293,1105,14.974928852148
05,02,06,26,17328,100.0,4738,27.3430286241921,14739,85.058864265928,12590,72.6569713758079,2149,12.40189289012,2589,14.941135734072
05,02,06,27,3936,100.0,1305,33.155487804878,3311,84.1209349593496,2631,66.844512195122,680,17.2764227642276,625,15.8790650406504
05,02,06,28,1988,100.0,394,19.8189134808853,1816,91.3480885311871,1594,80.1810865191147,222,11.1670020120724,172,8.65191146881288
05,02,06,29,4390,100.0,574,13.0751708428246,4128,94.0318906605923,3816,86.9248291571754,312,7.10706150341686,262,5.96810933940775
05,03,07,30,3831,100.0,1939,50.613416862438,3231,84.3382928739233,1892,49.386583137562,1339,34.9517097363613,600,15.6617071260767
05,03,07,31,11555,100.0,4429,38.3297273907399,9583,82.9337948939853,7126,61.6702726092601,2457,21.2635222847252,1972,17.0662051060147
05,03,08,32,11281,100.0,4438,39.3404839996454,8860,78.5391366013651,6843,60.6595160003546,2017,17.8796206010105,2421,21.4608633986349
05,03,08,33,1400,100.0,1097,78.3571428571429,399,28.5,303,21.6428571428571,96,6.85714285714286,1001,71.5
05,04,09,34,3966,100.0,1163,29.3242561775088,3108,78.3661119515885,2803,70.6757438224912,305,7.69036812909733,858,21.6338880484115
05,04,09,35,410,100.0,84,20.4878048780488,360,87.8048780487805,326,79.5121951219512,34,8.29268292682927,50,12.1951219512195
05,04,09,36,9435,100.0,1354,14.3508214096449,9021,95.6120826709062,8081,85.6491785903551,940,9.96290408055114,414,4.3879173290938
05,04,09,37,2141,100.0,268,12.5175151798225,2046,95.5628211116301,1873,87.4824848201775,173,8.08033629145259,95,4.43717888836992
05,04,09,38,3557,100.0,352,9.89597975822322,3424,96.2608940118077,3205,90.1040202417768,219,6.15687377003092,133,3.7391059881923
06,01,01,01,6768,100.0,1418,20.951536643026,6021,88.9627659574468,5350,79.048463356974,671,9.91430260047281,747,11.0372340425532
06,01,01,02,8648,100.0,2813,32.5277520814061,7082,81.8917668825162,5835,67.4722479185939,1247,14.4195189639223,1566,18.1082331174838
06,01,01,03,6252,100.0,1786,28.5668586052463,5362,85.7645553422905,4466,71.4331413947537,896,14.3314139475368,890,14.2354446577095
06,01,02,04,6808,100.0,2032,29.8472385428907,5864,86.1339600470035,4776,70.1527614571093,1088,15.9811985898942,944,13.8660399529965
06,01,02,05,9469,100.0,2595,27.405217023973,8240,87.0208047312282,6874,72.594782976027,1366,14.4260217552012,1229,12.9791952687718
06,01,02,06,7606,100.0,1864,24.5069681830134,6603,86.8130423349987,5742,75.4930318169866,861,11.3200105180121,1003,13.1869576650013
06,01,02,07,7723,100.0,2203,28.52518451379,6602,85.4849151883983,5520,71.47481548621,1082,14.0100997021883,1121,14.5150848116017
06,01,02,08,6398,100.0,1694,26.4770240700219,5539,86.5739293529228,4704,73.5229759299781,835,13.0509534229447,859,13.4260706470772
06,01,02,09,8958,100.0,2541,28.3657066309444,7614,84.9966510381782,6417,71.6342933690556,1197,13.3623576691226,1344,15.0033489618218
06,01,02,10,4833,100.0,1207,24.9741361473205,4223,87.3784398924064,3626,75.0258638526795,597,12.3525760397269,610,12.6215601075936
06,02,03,01,4952,100.0,949,19.1639741518578,4531,91.4983844911147,4003,80.8360258481422,528,10.6623586429725,421,8.5016155088853
06,02,03,02,5369,100.0,1042,19.4077109331347,4838,90.1098901098901,4327,80.5922890668654,511,9.51760104302477,531,9.89010989010989
06,02,03,03,7257,100.0,1860,25.6304257957834,6318,87.0607689127739,5397,74.3695742042166,921,12.6911947085573,939,12.9392310872261
06,02,03,04,6864,100.0,1625,23.6742424242424,6037,87.9516317016317,5239,76.3257575757576,798,11.6258741258741,827,12.0483682983683
06,02,03,05,11134,100.0,3346,30.0520926890605,9372,84.1746003233339,7788,69.9479073109395,1584,14.2266930123945,1762,15.8253996766661
06,02,03,06,6379,100.0,1062,16.6483774886346,5936,93.0553378272457,5317,83.3516225113654,619,9.70371531588023,443,6.94466217275435
06,02,04,07,4716,100.0,2228,47.2434266327396,3626,76.8871925360475,2488,52.7565733672604,1138,24.1306191687871,1090,23.1128074639525
06,02,04,08,6543,100.0,1332,20.3576341127923,5926,90.5700748891946,5211,79.6423658872077,715,10.9277090019869,617,9.42992511080544
06,02,04,09,8117,100.0,1745,21.4980904274978,7177,88.4193667611186,6372,78.5019095725022,805,9.91745718861648,940,11.5806332388814
06,02,04,10,6914,100.0,1077,15.5770899623951,6304,91.1773213769164,5837,84.4229100376049,467,6.75441133931154,610,8.8226786230836
06,02,04,11,8377,100.0,1649,19.6848513787752,7698,91.8944729616808,6728,80.3151486212248,970,11.579324340456,679,8.10552703831921
06,03,05,01,5479,100.0,881,16.0795765650666,5041,92.0058404818398,4598,83.9204234349334,443,8.08541704690637,438,7.99415951816025
06,03,05,02,5437,100.0,1017,18.7051682913371,4988,91.7417693581019,4420,81.2948317086629,568,10.446937649439,449,8.25823064189811
06,03,05,03,11156,100.0,2614,23.4313373969165,9859,88.3739691645751,8542,76.5686626030835,1317,11.8053065614916,1297,11.6260308354249
06,03,05,04,10934,100.0,2033,18.5933784525334,9930,90.8176330711542,8901,81.4066215474666,1029,9.41101152368758,1004,9.1823669288458
06,03,06,05,6869,100.0,1637,23.8317076721502,5972,86.9413306158102,5232,76.1682923278498,740,10.7730382879604,897,13.0586693841898
06,03,06,06,5204,100.0,1512,29.054573405073,4350,83.5895465026902,3692,70.945426594927,658,12.6441199077633,854,16.4104534973098
06,03,06,07,3166,100.0,1122,35.4390397978522,2360,74.5420088439672,2044,64.5609602021478,316,9.98104864181933,806,25.4579911560328
06,03,06,08,12036,100.0,2722,22.6154868727152,10765,89.440013293453,9314,77.3845131272848,1451,12.0555001661682,1271,10.559986706547
06,03,06,09,11741,100.0,2399,20.432671833745,10469,89.1661698322119,9342,79.567328166255,1127,9.5988416659569,1272,10.8338301677881
06,03,06,10,8148,100.0,1624,19.9312714776632,7223,88.6475208640157,6524,80.0687285223368,699,8.57879234167894,925,11.3524791359843
06,04,07,01,9719,100.0,1647,16.9461878794115,8875,91.3159790101862,8072,83.0538121205885,803,8.2621668895977,844,8.68402098981377
06,04,07,02,5328,100.0,981,18.4121621621622,4928,92.4924924924925,4347,81.5878378378378,581,10.9046546546547,400,7.50750750750751
06,04,07,03,10536,100.0,2324,22.0577069096431,9012,85.5353075170843,8212,77.9422930903569,800,7.59301442672741,1524,14.4646924829157
06,04,08,04,7431,100.0,1099,14.7893957744584,6858,92.2890593459831,6332,85.2106042255417,526,7.07845512044139,573,7.71094065401696
06,04,08,05,5305,100.0,999,18.8312912346843,4817,90.8011310084826,4306,81.1687087653158,511,9.63242224316682,488,9.19886899151744
06,04,08,06,7172,100.0,962,13.4132738427217,6705,93.4885666480759,6210,86.5867261572783,495,6.90184049079755,467,6.51143335192415
06,04,08,07,5675,100.0,1133,19.9647577092511,5063,89.215859030837,4542,80.0352422907489,521,9.18061674008811,612,10.784140969163
06,04,08,08,4157,100.0,1480,35.6025980274236,3573,85.9514072648545,2677,64.3974019725764,896,21.5540052922781,584,14.0485927351455
06,04,08,09,4871,100.0,1308,26.8528022993225,4056,83.2683227263396,3563,73.1471977006775,493,10.1211250256621,815,16.7316772736604
06,04,08,10,6972,100.0,1933,27.7251864601262,5844,83.8209982788296,5039,72.2748135398738,805,11.5461847389558,1128,16.1790017211704
07,01,01,01,9449,100.0,4102,43.4120012699757,7019,74.2829929093026,5347,56.5879987300243,1672,17.6949941792782,2430,25.7170070906974
07,01,01,02,15528,100.0,8062,51.9191138588357,10649,68.5793405461103,7466,48.0808861411644,3183,20.4984544049459,4879,31.4206594538897
07,01,01,03,9987,100.0,3515,35.1957544808251,7882,78.9225993791929,6472,64.8042455191749,1410,14.118353860018,2105,21.077400620807
07,01,01,04,13579,100.0,7666,56.4548199425584,8816,64.9237793651963,5913,43.5451800574416,2903,21.3785993077546,4763,35.0762206348037
07,02,02,01,10375,100.0,3285,31.6626506024096,8588,82.7759036144578,7090,68.3373493975904,1498,14.4385542168675,1787,17.2240963855422
07,02,02,02,9917,100.0,3841,38.7314712110517,7672,77.3621054754462,6076,61.2685287889483,1596,16.0935766864979,2245,22.6378945245538
07,02,02,03,17634,100.0,7316,41.4880344788477,13262,75.2069865033458,10318,58.5119655211523,2944,16.6950209821935,4372,24.7930134966542
07,02,02,04,11490,100.0,3921,34.1253263707572,9161,79.7302001740644,7569,65.8746736292428,1592,13.8555265448216,2329,20.2697998259356
07,03,03,01,23974,100.0,5670,23.6506215066322,20957,87.4155334946192,18304,76.3493784933678,2653,11.0661550012514,3017,12.5844665053808
07,03,03,02,9206,100.0,2591,28.1446882467956,7858,85.3573756245927,6615,71.8553117532044,1243,13.5020638713882,1348,14.6426243754073
07,03,03,03,12109,100.0,4899,40.4575109422744,9651,79.7010488066727,7210,59.5424890577257,2441,20.1585597489471,2458,20.2989511933273
07,04,04,01,17183,100.0,5895,34.3071640574987,14333,83.4138392597335,11288,65.6928359425013,3045,17.7210033172322,2850,16.5861607402665
07,04,04,02,2084,100.0,366,17.5623800383877,1932,92.7063339731286,1718,82.4376199616123,214,10.2687140115163,152,7.2936660268714
07,04,04,03,23591,100.0,7836,33.2160569708787,19446,82.4297401551439,15755,66.7839430291213,3691,15.6457971260226,4145,17.5702598448561
07,04,04,04,5038,100.0,1137,22.5684795553791,4495,89.2219134577213,3901,77.4315204446209,594,11.7903930131004,543,10.7780865422787
07,04,04,05,10778,100.0,4158,38.5785860085359,8490,78.7715717201707,6620,61.4214139914641,1870,17.3501577287066,2288,21.2284282798293
07,04,04,06,3673,100.0,1709,46.5287231146202,2674,72.8015246392595,1964,53.4712768853798,710,19.3302477538797,999,27.1984753607405
07,05,05,01,15910,100.0,5556,34.9214330609679,13168,82.7655562539283,10354,65.0785669390321,2814,17.6869893148963,2742,17.2344437460717
07,05,05,02,7779,100.0,2450,31.4950507777349,6450,82.9155418434246,5329,68.5049492222651,1121,14.4105926211595,1329,17.0844581565754
07,05,05,03,9055,100.0,2508,27.6974047487576,7878,87.0016565433462,6547,72.3025952512424,1331,14.6990612921038,1177,12.9983434566538
07,05,05,04,5544,100.0,1595,28.7698412698413,4871,87.8607503607504,3949,71.2301587301587,922,16.6305916305916,673,12.1392496392496
07,05,05,05,10448,100.0,2513,24.052450229709,9421,90.1703675344563,7935,75.947549770291,1486,14.2228177641654,1027,9.82963246554364
07,05,05,06,2227,100.0,464,20.8352043107319,2040,91.6030534351145,1763,79.1647956892681,277,12.4382577458464,187,8.3969465648855
07,06,06,01,9872,100.0,3675,37.2264991896272,7967,80.7029983792545,6197,62.7735008103728,1770,17.9294975688817,1905,19.2970016207455
07,06,06,02,4622,100.0,891,19.2773691042839,4255,92.0597144093466,3731,80.7226308957161,524,11.3370835136305,367,7.9402855906534
07,06,06,03,2784,100.0,891,32.0043103448276,2423,87.0330459770115,1893,67.9956896551724,530,19.0373563218391,361,12.9669540229885
07,06,06,04,14087,100.0,4658,33.0659473273231,12464,88.4787392631504,9429,66.9340526726769,3035,21.5446865904735,1623,11.5212607368496
07,07,07,01,10343,100.0,1790,17.3063907957072,9599,92.8067291888234,8553,82.6936092042928,1046,10.1131199845306,744,7.19327081117664
07,07,07,02,10216,100.0,1705,16.6895066562255,9603,93.9996084573219,8511,83.3104933437745,1092,10.6891151135474,613,6.00039154267815
07,07,07,03,7388,100.0,1539,20.8310774228479,6772,91.6621548456957,5849,79.1689225771521,923,12.4932322685436,616,8.33784515430428
07,07,07,04,8221,100.0,2588,31.4803551879333,7139,86.8385841138548,5633,68.5196448120667,1506,18.3189393017881,1082,13.1614158861452
07,07,07,05,7033,100.0,1027,14.6025878003697,6602,93.8717474761837,6006,85.3974121996303,596,8.47433527655339,431,6.12825252381629
07,07,07,06,3825,100.0,636,16.6274509803922,3420,89.4117647058824,3189,83.3725490196079,231,6.03921568627451,405,10.5882352941176
07,07,07,07,2817,100.0,345,12.2470713525027,2640,93.716719914803,2472,87.7529286474973,168,5.96379126730565,177,6.28328008519702
08,01,01,15,862,100.0,343,39.7911832946636,650,75.4060324825986,519,60.2088167053364,131,15.1972157772622,212,24.5939675174014
08,01,01,16,3568,100.0,1912,53.5874439461883,2345,65.7230941704036,1656,46.4125560538117,689,19.3105381165919,1223,34.2769058295964
08,01,01,17,16187,100.0,7905,48.8354852659542,10784,66.6213628220177,8282,51.1645147340458,2502,15.4568480879718,5403,33.3786371779823
08,01,01,18,11928,100.0,7043,59.0459423205902,7530,63.1287726358149,4885,40.9540576794098,2645,22.1747149564051,4398,36.8712273641851
08,01,02,11,10178,100.0,5881,57.7814894871291,6123,60.1591668304186,4297,42.2185105128709,1826,17.9406563175477,4055,39.8408331695815
08,01,02,12,7484,100.0,4911,65.6199893105291,4947,66.1010154997328,2573,34.3800106894709,2374,31.7210048102619,2537,33.8989845002672
08,01,02,13,12798,100.0,6801,53.1411157993437,8278,64.6819815596187,5997,46.8588842006564,2281,17.8230973589623,4520,35.3180184403813
08,01,02,14,8178,100.0,4566,55.8327219369039,5289,64.6735143066765,3612,44.1672780630961,1677,20.5062362435803,2889,35.3264856933235
08,01,03,01,27993,100.0,13019,46.5080555853249,19550,69.8388882935019,14974,53.4919444146751,4576,16.3469438788269,8443,30.161111706498
08,01,03,02,3740,100.0,1260,33.6898395721925,2992,80.0,2480,66.3101604278075,512,13.6898395721925,748,20.0
08,01,03,03,8612,100.0,5095,59.1616349280074,5154,59.8467254993033,3517,40.8383650719926,1637,19.0083604273107,3458,40.1532745006967
08,01,04,04,23462,100.0,12037,51.3042366379678,15543,66.2475492285398,11425,48.6957633620322,4118,17.5517858665075,7919,33.7524507714602
08,01,04,05,9026,100.0,4071,45.1030356747175,6298,69.7762020828717,4955,54.8969643252825,1343,14.8792377575892,2728,30.2237979171283
08,01,04,06,7119,100.0,3905,54.8532097204664,4619,64.8827082455401,3214,45.1467902795337,1405,19.7359179660065,2500,35.1172917544599
08,01,04,07,805,100.0,328,40.7453416149068,582,72.2981366459627,477,59.2546583850932,105,13.0434782608696,223,27.7018633540373
08,01,05,08,5526,100.0,3764,68.1143684401013,3685,66.6847629388346,1762,31.8856315598987,1923,34.7991313789359,1841,33.3152370611654
08,01,05,09,9555,100.0,6152,64.385138670853,6674,69.8482469911041,3403,35.614861329147,3271,34.2333856619571,2881,30.1517530088959
08,01,05,10,371,100.0,219,59.0296495956873,219,59.0296495956873,152,40.9703504043127,67,18.0592991913747,152,40.9703504043127
08,02,06,19,10790,100.0,5423,50.259499536608,7662,71.0101946246525,5367,49.740500463392,2295,21.2696941612604,3128,28.9898053753475
08,02,06,20,9272,100.0,3695,39.851164797239,7444,80.2847282139776,5577,60.148835202761,1867,20.1358930112166,1828,19.7152717860224
08,02,06,21,2271,100.0,511,22.5011008366358,2110,92.9106120651695,1760,77.4988991633642,350,15.4117129018054,161,7.08938793483047
08,02,06,22,14274,100.0,3483,24.4010088272383,12639,88.5456073980664,10791,75.5989911727617,1848,12.9466162253048,1635,11.4543926019336
08,02,06,23,1259,100.0,325,25.8141382049245,1112,88.3240667196187,934,74.1858617950755,178,14.1382049245433,147,11.6759332803813
08,02,06,24,1152,100.0,299,25.9548611111111,1021,88.6284722222222,853,74.0451388888889,168,14.5833333333333,131,11.3715277777778
08,02,06,25,3307,100.0,831,25.128515270638,2885,87.2391895978228,2476,74.871484729362,409,12.3677048684608,422,12.7608104021772
08,02,07,26,8270,100.0,1751,21.1729141475212,7533,91.0882708585248,6519,78.8270858524789,1014,12.261185006046,737,8.91172914147521
08,02,07,27,11450,100.0,2563,22.3842794759825,10473,91.4672489082969,8887,77.6157205240175,1586,13.8515283842795,977,8.53275109170306
08,02,07,28,8285,100.0,2820,34.0374170187085,6941,83.7779118889559,5465,65.9625829812915,1476,17.8153289076645,1344,16.2220881110441
08,03,08,29,12300,100.0,5678,46.1626016260163,10022,81.479674796748,6622,53.8373983739837,3400,27.6422764227642,2278,18.520325203252
08,03,08,30,7251,100.0,2581,35.595090332368,6233,85.960557164529,4670,64.4049096676321,1563,21.555647496897,1018,14.039442835471
08,03,08,31,16904,100.0,7747,45.829389493611,13880,82.1107430194037,9157,54.170610506389,4723,27.9401325130147,3024,17.8892569805963
08,04,09,32,2768,100.0,731,26.4089595375723,2506,90.5346820809249,2037,73.5910404624277,469,16.9436416184971,262,9.46531791907514
08,04,09,33,3922,100.0,1106,28.1998980112188,3457,88.14380418154,2816,71.8001019887812,641,16.3437021927588,465,11.85619581846
08,04,09,34,2701,100.0,738,27.3232136245835,2412,89.3002591632729,1963,72.6767863754165,449,16.6234727878564,289,10.6997408367271
08,04,10,35,7875,100.0,1982,25.168253968254,7099,90.1460317460317,5893,74.831746031746,1206,15.3142857142857,776,9.85396825396825
08,04,10,36,6805,100.0,1316,19.338721528288,6268,92.1087435709038,5489,80.661278471712,779,11.4474650991918,537,7.89125642909625
08,04,10,37,9609,100.0,1926,20.0437090227911,8757,91.133312519513,7683,79.9562909772089,1074,11.1770215423041,852,8.86668748048704
08,04,10,38,6802,100.0,1318,19.3766539253161,6377,93.7518376947957,5484,80.6233460746839,893,13.1284916201117,425,6.24816230520435
08,04,10,39,3738,100.0,1058,28.3039058319957,3394,90.7972177635099,2680,71.6960941680043,714,19.1011235955056,344,9.2027822364901
08,04,10,40,7952,100.0,1592,20.0201207243461,7396,93.0080482897384,6360,79.9798792756539,1036,13.0281690140845,556,6.99195171026157
09,01,01,01,11431,100.0,2912,25.4745866503368,9702,84.8744641763625,8519,74.5254133496632,1183,10.3490508266993,1729,15.1255358236375
09,01,01,02,69,100.0,9,13.0434782608696,60,86.9565217391304,60,86.9565217391304,0,0.0,9,13.0434782608696
09,01,02,01,4270,100.0,570,13.3489461358314,3995,93.559718969555,3700,86.6510538641686,295,6.90866510538642,275,6.44028103044497
09,01,02,02,6712,100.0,621,9.25208581644815,6344,94.5172824791418,6091,90.7479141835518,253,3.76936829558999,368,5.48271752085816
09,01,03,01,14869,100.0,1554,10.4512744636492,13987,94.0681955746856,13315,89.5487255363508,672,4.51947003833479,882,5.93180442531441
09,01,03,02,2941,100.0,553,18.8031281876913,2692,91.5334920095206,2388,81.1968718123087,304,10.3366201972118,249,8.46650799047943
09,01,04,01,7908,100.0,409,5.17197774405665,7694,97.2938796155792,7499,94.8280222559433,195,2.46585735963581,214,2.70612038442084
09,01,04,02,10772,100.0,1140,10.5829929446714,10241,95.0705532862978,9632,89.4170070553286,609,5.65354623096918,531,4.92944671370219
09,02,05,01,6212,100.0,1176,18.9311010946555,5348,86.0914359304572,5036,81.0688989053445,312,5.02253702511269,864,13.9085640695428
09,02,05,02,14433,100.0,1957,13.5592046005681,13243,91.7550058892815,12476,86.4407953994319,767,5.31421048984965,1190,8.24499411071849
09,02,06,01,7202,100.0,1090,15.1346848097751,6462,89.7250763676757,6112,84.8653151902249,350,4.85976117745071,740,10.2749236323244
09,02,06,02,3504,100.0,156,4.45205479452055,3425,97.7454337899543,3348,95.5479452054795,77,2.19748858447489,79,2.25456621004566
09,02,07,01,527,100.0,321,60.9108159392789,221,41.9354838709677,206,39.0891840607211,15,2.84629981024668,306,58.0645161290323
09,02,07,02,16003,100.0,1584,9.89814409798163,14928,93.2825095294632,14419,90.1018559020184,509,3.18065362744485,1075,6.71749047053677
09,02,08,01,2897,100.0,143,4.93614083534691,2822,97.4111149464964,2754,95.0638591646531,68,2.34725578184329,75,2.58888505350362
09,02,08,02,7257,100.0,806,11.1065178448395,6770,93.2892379771255,6451,88.8934821551605,319,4.395755821965,487,6.71076202287447
09,03,09,01,12560,100.0,1300,10.3503184713376,11911,94.8328025477707,11260,89.6496815286624,651,5.18312101910828,649,5.1671974522293
09,03,09,02,5854,100.0,631,10.7789545609839,5560,94.9777929620772,5223,89.2210454390161,337,5.75674752306116,294,5.02220703792279
09,03,09,03,7789,100.0,957,12.2865579663628,7512,96.443702657594,6832,87.7134420336372,680,8.73026062395686,277,3.55629734240596
09,03,10,01,12307,100.0,879,7.14227675306736,11834,96.1566588120582,11428,92.8577232469327,406,3.29893556512554,473,3.84334118794182
09,03,11,01,5714,100.0,454,7.94539726986349,5395,94.417220861043,5260,92.0546027301365,135,2.36261813090655,319,5.58277913895695
09,03,12,01,1774,100.0,115,6.48252536640361,1726,97.2942502818489,1659,93.5174746335964,67,3.77677564825254,48,2.70574971815107
09,03,12,02,2361,100.0,153,6.48030495552732,2271,96.1880559085133,2208,93.5196950444727,63,2.66836086404066,90,3.81194409148666
09,04,13,01,14253,100.0,905,6.34954044762506,13637,95.6781028555392,13348,93.650459552375,289,2.02764330316425,616,4.32189714446082
09,04,13,02,1794,100.0,110,6.13154960981048,1757,97.9375696767001,1684,93.8684503901895,73,4.06911928651059,37,2.06243032329989
09,04,14,01,4827,100.0,547,11.3320903252538,4391,90.9674746219184,4280,88.6679096747462,111,2.29956494717216,436,9.03252537808162
09,04,14,02,1468,100.0,131,8.92370572207084,1430,97.4114441416894,1337,91.0762942779292,93,6.33514986376022,38,2.58855585831063
09,04,15,01,7146,100.0,759,10.6213266162888,6759,94.5843828715365,6387,89.3786733837112,372,5.20570948782536,387,5.41561712846348
09,04,16,01,6511,100.0,279,4.28505605897712,6396,98.2337582552603,6232,95.7149439410229,164,2.51881431423744,115,1.76624174473967
09,05,17,01,3500,100.0,130,3.71428571428571,3424,97.8285714285714,3370,96.2857142857143,54,1.54285714285714,76,2.17142857142857
09,05,17,02,14368,100.0,685,4.76753897550111,14024,97.6057906458797,13683,95.2324610244989,341,2.37332962138085,344,2.39420935412027
09,05,18,01,9086,100.0,502,5.52498349108519,8854,97.4466211754347,8584,94.4750165089148,270,2.97160466651992,232,2.55337882456527
09,05,19,01,10085,100.0,642,6.36588993554784,9742,96.5989092711948,9443,93.6341100644522,299,2.96479920674269,343,3.40109072880516
09,05,20,01,12347,100.0,582,4.7136956345671,12051,97.6026565157528,11765,95.2863043654329,286,2.31635215031992,296,2.39734348424719
10,01,01,01,5577,100.0,1244,22.3058992289762,5055,90.6401291016676,4333,77.6941007710238,722,12.9460283306437,522,9.35987089833244
10,01,01,02,17803,100.0,3766,21.1537381340224,16395,92.091220580801,14037,78.8462618659776,2358,13.2449587148233,1408,7.90877941919901
10,01,02,03,809,100.0,369,45.6118665018541,497,61.433868974042,440,54.3881334981459,57,7.04573547589617,312,38.566131025958
10,01,02,04,10268,100.0,1907,18.5722633424231,9634,93.8254772107519,8361,81.4277366575769,1273,12.3977405531749,634,6.17452278924815
10,01,02,05,8027,100.0,902,11.237074872306,7636,95.1289398280802,7125,88.762925127694,511,6.3660147003862,391,4.87106017191977
10,01,02,06,16437,100.0,2693,16.3837683275537,15220,92.5959725010647,13744,83.6162316724463,1476,8.97974082861836,1217,7.40402749893533
10,01,02,07,10692,100.0,2160,20.2020202020202,9782,91.4889637111859,8532,79.7979797979798,1250,11.6909839132061,910,8.51103628881407
10,01,03,08,1985,100.0,386,19.4458438287154,1762,88.7657430730479,1599,80.5541561712846,163,8.21158690176322,223,11.2342569269521
10,01,03,09,14353,100.0,2610,18.1843517034766,13386,93.2627325297847,11743,81.8156482965234,1643,11.4470842332613,967,6.73726747021529
10,01,03,10,17747,100.0,2861,16.1210345410492,16669,93.9257339268609,14886,83.8789654589508,1783,10.0467684679101,1078,6.07426607313912
10,01,03,11,2942,100.0,376,12.780421481985,2858,97.1447994561523,2566,87.219578518015,292,9.92522093813732,84,2.85520054384772
10,02,04,12,6687,100.0,1627,24.3307910871841,5937,88.7842081650965,5060,75.6692089128159,877,13.1149992522805,750,11.2157918349035
10,02,04,13,15054,100.0,1845,12.2558788361897,14188,94.2473761126611,13209,87.7441211638103,979,6.5032549488508,866,5.75262388733891
10,02,04,14,1647,100.0,579,35.1548269581056,1534,93.1390406800243,1068,64.8451730418944,466,28.2938676381299,113,6.86095931997571
10,02,04,15,5399,100.0,947,17.540285238007,4785,88.6275236154843,4452,82.459714761993,333,6.16780885349139,614,11.3724763845157
10,02,04,16,5531,100.0,1244,22.4914120412222,4810,86.9643825709637,4287,77.5085879587778,523,9.45579461218586,721,13.0356174290363
10,02,05,17,8794,100.0,635,7.22083238571754,8542,97.1344098248806,8159,92.7791676142825,383,4.35524221059814,252,2.8655901751194
10,02,05,18,5117,100.0,536,10.4748876294704,4835,94.4889583740473,4581,89.5251123705296,254,4.96384600351769,282,5.51104162595271
10,02,05,19,5879,100.0,1415,24.0687191699269,4825,82.0717809151216,4464,75.9312808300732,361,6.14050008504848,1054,17.9282190848784
10,02,06,20,3328,100.0,433,13.0108173076923,3148,94.5913461538462,2895,86.9891826923077,253,7.60216346153846,180,5.40865384615385
10,02,06,21,5999,100.0,715,11.9186531088515,5642,94.049008168028,5284,88.0813468911485,358,5.96766127687948,357,5.950991831972
10,02,06,22,8706,100.0,921,10.578911095796,8332,95.7041121065932,7785,89.421088904204,547,6.28302320238916,374,4.29588789340685
10,02,06,23,6542,100.0,578,8.83521858758789,6349,97.0498318557016,5964,91.1647814124121,385,5.88505044328951,193,2.95016814429838
10,03,07,24,7737,100.0,1043,13.4806772650898,7023,90.7716169057774,6694,86.5193227349102,329,4.25229417086726,714,9.22838309422257
10,03,07,25,5818,100.0,699,12.014437951186,5486,94.2935716741148,5119,87.985562048814,367,6.30800962530079,332,5.70642832588518
10,03,07,26,2887,100.0,227,7.86283339106339,2799,96.9518531347419,2660,92.1371666089366,139,4.81468652580533,88,3.04814686525805
10,03,07,27,9180,100.0,686,7.47276688453159,8932,97.2984749455338,8494,92.5272331154684,438,4.77124183006536,248,2.70152505446623
10,04,08,28,7582,100.0,385,5.07781587971512,7423,97.9029279873384,7197,94.9221841202849,226,2.98074386705355,159,2.09707201266157
10,04,08,29,3574,100.0,171,4.78455512031337,3485,97.5097929490767,3403,95.2154448796866,82,2.29434806939004,89,2.49020705092334
10,04,08,30,7500,100.0,380,5.06666666666667,7361,98.1466666666667,7120,94.9333333333333,241,3.21333333333333,139,1.85333333333333
10,04,09,31,9141,100.0,508,5.5573788425774,8949,97.8995733508369,8633,94.4426211574226,316,3.45695219341429,192,2.10042664916311
10,04,09,32,3922,100.0,262,6.68026517083121,3790,96.6343702192759,3660,93.3197348291688,130,3.31463539010709,132,3.36562978072412
10,04,09,33,14441,100.0,701,4.854234471297,14142,97.929506266879,13740,95.145765528703,402,2.78374073817603,299,2.07049373312097
11,01,01,01,580,100.0,60,10.3448275862069,542,93.448275862069,520,89.6551724137931,22,3.79310344827586,38,6.55172413793104
11,01,01,02,2542,100.0,110,4.3273013375295,2503,98.4657749803305,2432,95.6726986624705,71,2.79307631785995,39,1.53422501966955
11,01,01,03,1268,100.0,94,7.41324921135647,1237,97.5552050473186,1174,92.5867507886435,63,4.96845425867508,31,2.44479495268139
11,01,02,04,8861,100.0,2051,23.1463717413385,7871,88.827446112177,6810,76.8536282586616,1061,11.9738178535154,990,11.172553887823
11,01,02,05,6655,100.0,1501,22.5544703230654,5990,90.007513148009,5154,77.4455296769346,836,12.5619834710744,665,9.99248685199098
11,01,02,06,5855,100.0,890,15.200683176772,5399,92.2117847993168,4965,84.799316823228,434,7.41246797608881,456,7.78821520068318
11,01,02,07,6905,100.0,872,12.6285300506879,6491,94.0043446777697,6033,87.3714699493121,458,6.63287472845764,414,5.99565532223027
11,01,03,08,11045,100.0,2268,20.5341783612494,10055,91.0366681756451,8777,79.4658216387506,1278,11.5708465368945,990,8.96333182435491
11,01,03,09,9560,100.0,1878,19.6443514644351,8548,89.4142259414226,7682,80.3556485355649,866,9.05857740585774,1012,10.5857740585774
11,01,03,10,5210,100.0,466,8.94433781190019,5009,96.1420345489443,4744,91.0556621880998,265,5.08637236084453,201,3.85796545105566
11,02,04,11,8016,100.0,1138,14.1966067864271,7246,90.3942115768463,6878,85.8033932135729,368,4.59081836327345,770,9.60578842315369
11,02,04,12,6130,100.0,804,13.115823817292,5767,94.0783034257749,5326,86.884176182708,441,7.19412724306689,363,5.92169657422512
11,02,05,13,3433,100.0,207,6.02971162248762,3335,97.1453539178561,3226,93.9702883775124,109,3.17506554034372,98,2.8546460821439
11,02,05,14,8441,100.0,1165,13.8016822651345,7557,89.5273071910911,7276,86.1983177348655,281,3.32898945622557,884,10.4726928089089
11,02,05,15,14400,100.0,2758,19.1527777777778,12906,89.625,11642,80.8472222222222,1264,8.77777777777778,1494,10.375
11,02,05,16,3700,100.0,299,8.08108108108108,3573,96.5675675675676,3401,91.9189189189189,172,4.64864864864865,127,3.43243243243243
11,03,06,17,6101,100.0,1640,26.8808392066874,5128,84.0517947877397,4461,73.1191607933126,667,10.9326339944271,973,15.9482052122603
11,03,06,18,15768,100.0,3231,20.4908675799087,13953,88.4893455098935,12537,79.5091324200913,1416,8.98021308980213,1815,11.5106544901065
11,03,06,19,10567,100.0,2591,24.5197312387622,9131,86.4105233273398,7976,75.4802687612378,1155,10.930254566102,1436,13.5894766726602
11,03,07,20,5481,100.0,3394,61.923006750593,2375,43.3315088487502,2087,38.076993249407,288,5.25451559934319,3106,56.6684911512498
11,03,07,21,22588,100.0,4277,18.9348326545068,19681,87.1303346909864,18311,81.0651673454932,1370,6.06516734549318,2907,12.8696653090136
11,03,08,24,10012,100.0,2941,29.3747502996404,8311,83.0103875349581,7071,70.6252497003596,1240,12.3851378345985,1701,16.989612465042
11,04,09,25,3644,100.0,633,17.371020856202,3252,89.2425905598244,3011,82.628979143798,241,6.61361141602635,392,10.7574094401756
11,04,09,26,27464,100.0,4339,15.7988639673755,24745,90.0997669676668,23125,84.2011360326245,1620,5.89863093504224,2719,9.90023303233324
11,04,10,22,5134,100.0,1268,24.6980911569926,4332,84.3786521231009,3866,75.3019088430074,466,9.07674328009349,802,15.6213478768991
11,04,10,23,5903,100.0,1512,25.614094528206,5074,85.9562934101304,4391,74.385905471794,683,11.5703879383364,829,14.0437065898696
11,04,10,27,2701,100.0,520,19.2521288411699,2398,88.7819326175491,2181,80.7478711588301,217,8.03406145871899,303,11.2180673824509
11,04,11,28,24465,100.0,4343,17.7518904557531,21914,89.5728591865931,20122,82.2481095442469,1792,7.32474964234621,2551,10.4271408134069
11,05,12,29,3438,100.0,436,12.6817917393834,3233,94.0372309482257,3002,87.3182082606166,231,6.71902268760907,205,5.96276905177429
11,05,13,30,8406,100.0,1279,15.2153223887699,7505,89.2814656197954,7127,84.7846776112301,378,4.49678800856531,901,10.7185343802046
11,05,13,31,9593,100.0,735,7.66183675596789,9228,96.195142291254,8858,92.3381632440321,370,3.85697904722193,365,3.80485770874596
11,05,13,32,6532,100.0,614,9.39987752602572,6266,95.9277403551745,5918,90.6001224739743,348,5.32761788120025,266,4.07225964482547
12,10,31,15,7448,100.0,2725,36.5870032223416,5961,80.0349087003222,4723,63.4129967776584,1238,16.6219119226638,1487,19.9650912996778
12,10,31,16,9210,100.0,3749,40.7057546145494,7184,78.0021715526601,5461,59.2942453854506,1723,18.7079261672096,2026,21.9978284473398
12,10,31,17,10136,100.0,4610,45.4814522494081,7471,73.7075769534333,5526,54.5185477505919,1945,19.1890292028414,2665,26.2924230465667
12,10,32,18,13032,100.0,4777,36.6559238796808,10624,81.5224063842848,8255,63.3440761203192,2369,18.1783302639656,2408,18.4775936157152
12,10,32,19,8571,100.0,3122,36.4251545910629,6964,81.2507292031268,5449,63.5748454089371,1515,17.6758837941897,1607,18.7492707968732
12,10,32,20,4574,100.0,1084,23.6991692173153,4074,89.0686488850022,3490,76.3008307826847,584,12.7678181023174,500,10.9313511149978
12,21,41,25,7150,100.0,1637,22.8951048951049,6347,88.7692307692308,5513,77.1048951048951,834,11.6643356643357,803,11.2307692307692
12,21,41,26,7532,100.0,2282,30.2973977695167,6553,87.0021242697823,5250,69.7026022304833,1303,17.299522039299,979,12.9978757302177
12,21,44,21,2605,100.0,785,30.1343570057582,2174,83.4548944337812,1820,69.8656429942418,354,13.5892514395393,431,16.5451055662188
12,21,44,22,7714,100.0,4069,52.7482499351828,5573,72.245268343272,3645,47.2517500648172,1928,24.9935182784548,2141,27.754731656728
12,21,44,23,5491,100.0,1815,33.0540885084684,4663,84.9207794572937,3676,66.9459114915316,987,17.9748679657622,828,15.0792205427062
12,21,44,24,10323,100.0,4594,44.5025670832123,7627,73.8835609803352,5729,55.4974329167878,1898,18.3861280635474,2696,26.1164390196648
12,21,45,27,10492,100.0,1809,17.2417079679756,9539,90.9168890583302,8683,82.7582920320244,856,8.15859702630576,953,9.08311094166984
12,21,45,28,256,100.0,58,22.65625,230,89.84375,198,77.34375,32,12.5,26,10.15625
12,22,42,29,6029,100.0,696,11.5442030187427,5755,95.4552993862996,5333,88.4557969812573,422,6.9995024050423,274,4.54470061370045
12,22,42,30,17834,100.0,1888,10.5865201300886,17094,95.850622406639,15946,89.4134798699114,1148,6.4371425367276,740,4.149377593361
12,23,11,01,16266,100.0,1721,10.5803516537563,15497,95.2723472273454,14545,89.4196483462437,952,5.85269888110168,769,4.72765277265462
12,23,11,02,16627,100.0,1672,10.0559331208276,15997,96.2109821374872,14955,89.9440668791724,1042,6.26691525831479,630,3.78901786251278
12,30,12,03,14755,100.0,3852,26.1064046086073,12342,83.6462216197899,10903,73.8935953913928,1439,9.75262622839715,2413,16.3537783802101
12,30,12,04,6353,100.0,1338,21.0609161026287,5657,89.0445458838344,5015,78.9390838973713,642,10.1054619864631,696,10.9554541161656
12,30,12,05,4842,100.0,708,14.6220570012392,4567,94.3205287071458,4134,85.3779429987609,433,8.94258570838496,275,5.67947129285419
12,30,12,06,5003,100.0,660,13.1920847491505,4777,95.4827103737757,4343,86.8079152508495,434,8.67479512292625,226,4.51728962622427
12,30,21,07,2991,100.0,992,33.1661651621531,2599,86.8940153794717,1999,66.8338348378469,600,20.0601805416249,392,13.1059846205283
12,30,21,08,13423,100.0,4969,37.0185502495716,11246,83.7815689488192,8454,62.9814497504284,2792,20.8001191983908,2177,16.2184310511808
12,30,21,09,11193,100.0,5270,47.0829983025105,8499,75.9313856874832,5923,52.9170016974895,2576,23.0143839899937,2694,24.0686143125167
12,30,21,10,10066,100.0,5043,50.0993443274389,7582,75.3228690641764,5023,49.9006556725611,2559,25.4222133916153,2484,24.6771309358236
12,30,22,11,3282,100.0,738,22.4862888482633,2989,91.0725167580743,2544,77.5137111517367,445,13.5588056063376,293,8.92748324192566
12,30,22,12,5571,100.0,1955,35.0924430084365,4588,82.3550529527912,3616,64.9075569915635,972,17.4474959612278,983,17.6449470472088
12,30,43,13,6467,100.0,1160,17.9372197309417,5805,89.7634142569971,5307,82.0627802690583,498,7.70063398793877,662,10.2365857430029
12,30,43,14,9666,100.0,1143,11.8249534450652,9156,94.723774053383,8523,88.1750465549348,633,6.54872749844817,510,5.27622594661701
