district_id,forecast_area_id,district_region_id,planning_area_id,inhabitants,inhabitants_percentage,inhabitants_with_migration_background,inhabitants_with_migration_background_percentage,inhabitants_germans,inhabitants_germans_percentage,inhabitants_germans_without_migration_background,inhabitants_germans_without_migration_background_percentage,inhabitants_germans_with_migration_background,inhabitants_germans_with_migration_background_percentage,inhabitants_foreigners,inhabitants_foreigners_percentage
01,10,01,01,3503,100.0,2223,63.5,1994,56.9,1280,36.5,714,20.4,1509,43.1
01,10,01,02,1996,100.0,1392,69.7,931,46.6,604,30.3,327,16.4,1065,53.4
01,10,01,03,5537,100.0,3352,60.5,3443,62.2,2185,39.5,1258,22.7,2094,37.8
01,10,01,04,4850,100.0,3215,66.3,2876,59.3,1635,33.7,1241,25.6,1974,40.7
01,10,02,05,2981,100.0,2010,67.4,1429,47.9,971,32.6,458,15.4,1552,52.1
01,10,02,06,1893,100.0,1049,55.4,1170,61.8,844,44.6,326,17.2,723,38.2
01,10,02,07,8814,100.0,4908,55.7,5497,62.4,3906,44.3,1591,18.1,3317,37.6
01,10,03,08,7371,100.0,3510,47.6,4851,65.8,3861,52.4,990,13.4,2520,34.2
01,10,03,09,12518,100.0,5335,42.6,8997,71.9,7183,57.4,1814,14.5,3521,28.1
01,10,03,10,10276,100.0,5368,52.2,6382,62.1,4908,47.8,1474,14.3,3894,37.9
01,10,03,11,9437,100.0,4671,49.5,6386,67.7,4766,50.5,1620,17.2,3051,32.3
01,10,03,12,10136,100.0,4940,48.7,6826,67.3,5196,51.3,1630,16.1,3310,32.7
01,10,03,13,11016,100.0,5312,48.2,7383,67.0,5704,51.8,1679,15.2,3633,33.0
01,10,04,14,5560,100.0,3203,57.6,3132,56.3,2357,42.4,775,13.9,2428,43.7
01,10,04,15,12997,100.0,5531,42.6,9273,71.3,7466,57.4,1807,13.9,3724,28.7
01,10,04,16,13400,100.0,5656,42.2,9626,71.8,7744,57.8,1882,14.0,3774,28.2
01,20,05,17,3771,100.0,2237,59.3,2195,58.2,1534,40.7,661,17.5,1576,41.8
01,20,05,18,6935,100.0,4437,64.0,3870,55.8,2498,36.0,1372,19.8,3065,44.2
01,20,05,19,9200,100.0,5095,55.4,5710,62.1,4105,44.6,1605,17.4,3490,37.9
01,20,05,20,9552,100.0,4698,49.2,6647,69.6,4854,50.8,1793,18.8,2905,30.4
01,20,05,21,5239,100.0,3176,60.6,3220,61.5,2063,39.4,1157,22.1,2019,38.5
01,20,05,22,11575,100.0,4370,37.8,9009,77.8,7205,62.2,1804,15.6,2566,22.2
01,20,06,23,10922,100.0,5710,52.3,7389,67.7,5212,47.7,2177,19.9,3533,32.3
01,20,06,24,6396,100.0,4526,70.8,3190,49.9,1870,29.2,1320,20.6,3206,50.1
01,20,06,25,6927,100.0,4189,60.5,4552,65.7,2738,39.5,1814,26.2,2375,34.3
01,20,06,26,5905,100.0,2612,44.2,4293,72.7,3293,55.8,1000,16.9,1612,27.3
01,20,06,27,3354,100.0,2236,66.7,2171,64.7,1118,33.3,1053,31.4,1183,35.3
01,20,06,28,3235,100.0,1455,45.0,2443,75.5,1780,55.0,663,20.5,792,24.5
01,20,06,29,5902,100.0,2866,48.6,3930,66.6,3036,51.4,894,15.1,1972,33.4
01,30,07,30,8042,100.0,5833,72.5,4203,52.3,2209,27.5,1994,24.8,3839,47.7
01,30,07,31,8694,100.0,5216,60.0,5292,60.9,3478,40.0,1814,20.9,3402,39.1
01,30,07,32,9845,100.0,6214,63.1,5893,59.9,3631,36.9,2262,23.0,3952,40.1
01,30,07,33,11638,100.0,7306,62.8,7119,61.2,4332,37.2,2787,23.9,4519,38.8
01,30,08,34,14372,100.0,9700,67.5,9898,68.9,4672,32.5,5226,36.4,4474,31.1
01,30,08,35,10764,100.0,6601,61.3,7252,67.4,4163,38.7,3089,28.7,3512,32.6
01,30,08,36,14964,100.0,9843,65.8,8827,59.0,5121,34.2,3706,24.8,6137,41.0
01,40,09,37,10840,100.0,5513,50.9,7403,68.3,5327,49.1,2076,19.2,3437,31.7
01,40,09,38,9690,100.0,5200,53.7,6333,65.4,4490,46.3,1843,19.0,3357,34.6
01,40,09,39,6011,100.0,3236,53.8,3727,62.0,2775,46.2,952,15.8,2284,38.0
01,40,09,40,6803,100.0,2636,38.7,5600,82.3,4167,61.3,1433,21.1,1203,17.7
01,40,09,41,3854,100.0,1829,47.5,2809,72.9,2025,52.5,784,20.3,1045,27.1
01,40,09,42,8739,100.0,4802,54.9,5444,62.3,3937,45.1,1507,17.2,3295,37.7
01,40,10,43,7746,100.0,5269,68.0,4486,57.9,2477,32.0,2009,25.9,3260,42.1
01,40,10,44,10137,100.0,6932,68.4,5637,55.6,3205,31.6,2432,24.0,4500,44.4
01,40,10,45,5593,100.0,4086,73.1,3076,55.0,1507,26.9,1569,28.1,2517,45.0
01,40,10,46,8867,100.0,4520,51.0,5957,67.2,4347,49.0,1610,18.2,2910,32.8
01,40,10,47,7860,100.0,5484,69.8,3894,49.5,2376,30.2,1518,19.3,3966,50.5
01,40,10,48,9445,100.0,5753,60.9,5698,60.3,3692,39.1,2006,21.2,3747,39.7
01,40,10,49,6729,100.0,4126,61.3,3925,58.3,2603,38.7,1322,19.6,2804,41.7
02,10,01,01,6381,100.0,4555,71.4,3698,58.0,1826,28.6,1872,29.3,2683,42.0
02,10,01,02,8705,100.0,6198,71.2,5562,63.9,2507,28.8,3055,35.1,3143,36.1
02,10,01,03,5406,100.0,3414,63.2,3689,68.2,1992,36.8,1697,31.4,1717,31.8
02,10,01,04,5667,100.0,3937,69.5,3529,62.3,1730,30.5,1799,31.7,2138,37.7
02,10,01,05,9492,100.0,6815,71.8,6131,64.6,2677,28.2,3454,36.4,3361,35.4
02,10,01,06,4990,100.0,3274,65.6,3335,66.8,1716,34.4,1619,32.4,1655,33.2
02,20,02,07,2446,100.0,1088,44.5,1753,71.7,1358,55.5,395,16.1,693,28.3
02,20,02,08,5889,100.0,2691,45.7,4170,70.8,3198,54.3,972,16.5,1719,29.2
02,20,02,09,10922,100.0,4589,42.0,8155,74.7,6333,58.0,1822,16.7,2767,25.3
02,20,02,10,12233,100.0,5497,44.9,8822,72.1,6736,55.1,2086,17.1,3411,27.9
02,20,02,11,14703,100.0,6310,42.9,10981,74.7,8393,57.1,2588,17.6,3722,25.3
02,20,02,12,8564,100.0,4353,50.8,6239,72.9,4211,49.2,2028,23.7,2325,27.1
02,20,02,13,10172,100.0,4713,46.3,7161,70.4,5459,53.7,1702,16.7,3011,29.6
02,30,03,14,7466,100.0,4563,61.1,4732,63.4,2903,38.9,1829,24.5,2734,36.6
02,30,03,15,8519,100.0,4908,57.6,5599,65.7,3611,42.4,1988,23.3,2920,34.3
02,30,03,16,4239,100.0,2121,50.0,2960,69.8,2118,50.0,842,19.9,1279,30.2
02,30,04,17,8180,100.0,4521,55.3,5403,66.1,3659,44.7,1744,21.3,2777,33.9
02,30,04,18,7746,100.0,3790,48.9,5366,69.3,3956,51.1,1410,18.2,2380,30.7
02,30,04,19,10675,100.0,5586,52.3,7072,66.2,5089,47.7,1983,18.6,3603,33.8
02,40,05,20,5815,100.0,2211,38.0,4468,76.8,3604,62.0,864,14.9,1347,23.2
02,40,05,21,8083,100.0,3017,37.3,6182,76.5,5066,62.7,1116,13.8,1901,23.5
02,40,05,22,11343,100.0,3643,32.1,9030,79.6,7700,67.9,1330,11.7,2313,20.4
02,40,06,23,13541,100.0,6679,49.3,9144,67.5,6862,50.7,2282,16.9,4397,32.5
02,40,06,24,11885,100.0,4544,38.2,8520,71.7,7341,61.8,1179,9.9,3365,28.3
02,40,06,25,1086,100.0,745,68.6,443,40.8,341,31.4,102,9.4,643,59.2
02,50,07,26,9285,100.0,3595,38.7,6751,72.7,5690,61.3,1061,11.4,2534,27.3
02,50,07,27,6642,100.0,2542,38.3,4884,73.5,4100,61.7,784,11.8,1758,26.5
02,50,07,28,10103,100.0,3552,35.2,7602,75.2,6551,64.8,1051,10.4,2501,24.8
02,50,07,29,5489,100.0,1992,36.3,4195,76.4,3497,63.7,698,12.7,1294,23.6
02,50,08,30,4032,100.0,1723,42.7,2807,69.6,2309,57.3,498,12.4,1225,30.4
02,50,08,31,7981,100.0,3260,40.8,5659,70.9,4721,59.2,938,11.8,2322,29.1
02,50,08,32,9351,100.0,4164,44.5,6384,68.3,5187,55.5,1197,12.8,2967,31.7
02,50,08,33,10283,100.0,4103,39.9,7209,70.1,6180,60.1,1029,10.0,3074,29.9
02,50,08,34,11506,100.0,4265,37.1,8568,74.5,7241,62.9,1327,11.5,2938,25.5
02,50,08,35,8044,100.0,3401,42.3,5575,69.3,4643,57.7,932,11.6,2469,30.7
02,50,08,36,4987,100.0,1262,25.3,4358,87.4,3725,74.7,633,12.7,629,12.6
03,10,01,01,4668,100.0,868,18.6,4112,88.1,3800,81.4,312,6.7,556,11.9
03,10,01,02,3298,100.0,1008,30.6,2533,76.8,2290,69.4,243,7.4,765,23.2
03,10,01,03,9312,100.0,2199,23.6,7595,81.6,7113,76.4,482,5.2,1717,18.4
03,20,02,04,2056,100.0,154,7.5,1991,96.8,1902,92.5,89,4.3,65,3.2
03,20,02,05,8809,100.0,1588,18.0,7891,89.6,7221,82.0,670,7.6,918,10.4
03,20,02,06,6595,100.0,1523,23.1,5587,84.7,5072,76.9,515,7.8,1008,15.3
03,20,02,07,11493,100.0,2178,19.0,10208,88.8,9315,81.0,893,7.8,1285,11.2
03,20,03,08,5284,100.0,786,14.9,4901,92.8,4498,85.1,403,7.6,383,7.2
03,20,03,09,5387,100.0,986,18.3,4836,89.8,4401,81.7,435,8.1,551,10.2
03,20,03,10,8035,100.0,1380,17.2,7410,92.2,6655,82.8,755,9.4,625,7.8
03,30,04,11,11588,100.0,2626,22.7,9965,86.0,8962,77.3,1003,8.7,1623,14.0
03,30,04,12,5262,100.0,633,12.0,4948,94.0,4629,88.0,319,6.1,314,6.0
03,30,04,13,3147,100.0,308,9.8,3010,95.6,2839,90.2,171,5.4,137,4.4
03,30,05,14,6954,100.0,747,10.7,6558,94.3,6207,89.3,351,5.0,396,5.7
03,30,05,15,52,100.0,6,11.5,46,88.5,46,88.5,0,0.0,6,11.5
03,30,05,16,8288,100.0,2077,25.1,6785,81.9,6211,74.9,574,6.9,1503,18.1
03,30,05,17,1113,100.0,62,5.6,1078,96.9,1051,94.4,27,2.4,35,3.1
03,40,06,18,4851,100.0,1084,22.3,4446,91.7,3767,77.7,679,14.0,405,8.3
03,40,06,19,10477,100.0,2210,21.1,9314,88.9,8267,78.9,1047,10.0,1163,11.1
03,40,06,20,3534,100.0,738,20.9,3151,89.2,2796,79.1,355,10.0,383,10.8
03,40,07,21,11772,100.0,2756,23.4,10198,86.6,9016,76.6,1182,10.0,1574,13.4
03,40,07,22,3643,100.0,644,17.7,3328,91.4,2999,82.3,329,9.0,315,8.6
03,40,07,23,7100,100.0,1770,24.9,6034,85.0,5330,75.1,704,9.9,1066,15.0
03,40,07,24,7566,100.0,1141,15.1,6909,91.3,6425,84.9,484,6.4,657,8.7
03,40,07,25,7414,100.0,1075,14.5,6801,91.7,6339,85.5,462,6.2,613,8.3
03,40,08,26,6907,100.0,1583,22.9,5751,83.3,5324,77.1,427,6.2,1156,16.7
03,40,08,27,9676,100.0,2500,25.8,8040,83.1,7176,74.2,864,8.9,1636,16.9
03,40,08,28,4868,100.0,1343,27.6,3923,80.6,3525,72.4,398,8.2,945,19.4
03,40,08,29,5783,100.0,1252,21.6,4956,85.7,4531,78.4,425,7.3,827,14.3
03,40,08,30,9318,100.0,1689,18.1,8283,88.9,7629,81.9,654,7.0,1035,11.1
03,40,08,31,0,100.0,0,0.0,0,0.0,0,0.0,0,0.0,0,0.0
03,50,09,32,6018,100.0,1537,25.5,4790,79.6,4481,74.5,309,5.1,1228,20.4
03,50,09,33,7731,100.0,1526,19.7,6716,86.9,6205,80.3,511,6.6,1015,13.1
03,50,09,34,10310,100.0,3029,29.4,8234,79.9,7281,70.6,953,9.2,2076,20.1
03,50,09,35,6655,100.0,1880,28.2,5386,80.9,4775,71.8,611,9.2,1269,19.1
03,50,09,36,9911,100.0,2353,23.7,8360,84.4,7558,76.3,802,8.1,1551,15.6
03,50,10,37,8588,100.0,1895,22.1,7248,84.4,6693,77.9,555,6.5,1340,15.6
03,50,10,38,7413,100.0,1334,18.0,6515,87.9,6079,82.0,436,5.9,898,12.1
03,60,11,39,3760,100.0,1386,36.9,2834,75.4,2374,63.1,460,12.2,926,24.6
03,60,11,40,5987,100.0,1975,33.0,4625,77.3,4012,67.0,613,10.2,1362,22.7
03,60,11,41,6634,100.0,2355,35.5,5018,75.6,4279,64.5,739,11.1,1616,24.4
03,60,11,42,10987,100.0,4122,37.5,8096,73.7,6865,62.5,1231,11.2,2891,26.3
03,60,12,43,6983,100.0,2134,30.6,5571,79.8,4849,69.4,722,10.3,1412,20.2
03,60,12,44,7619,100.0,2186,28.7,6204,81.4,5433,71.3,771,10.1,1415,18.6
03,60,12,45,12950,100.0,3859,29.8,10327,79.7,9091,70.2,1236,9.5,2623,20.3
03,60,13,46,6015,100.0,2298,38.2,4428,73.6,3717,61.8,711,11.8,1587,26.4
03,60,13,47,9432,100.0,3197,33.9,7378,78.2,6235,66.1,1143,12.1,2054,21.8
03,60,13,48,7486,100.0,2628,35.1,5739,76.7,4858,64.9,881,11.8,1747,23.3
03,60,14,49,9906,100.0,2108,21.3,8577,86.6,7798,78.7,779,7.9,1329,13.4
03,60,14,50,4149,100.0,1959,47.2,2519,60.7,2190,52.8,329,7.9,1630,39.3
03,60,14,51,6368,100.0,2079,32.6,4874,76.5,4289,67.4,585,9.2,1494,23.5
03,60,14,52,4615,100.0,1834,39.7,3325,72.0,2781,60.3,544,11.8,1290,28.0
03,60,14,53,3068,100.0,1020,33.2,2482,80.9,2048,66.8,434,14.1,586,19.1
03,70,15,54,11523,100.0,4571,39.7,8486,73.6,6952,60.3,1534,13.3,3037,26.4
03,70,15,55,7325,100.0,2524,34.5,5695,77.7,4801,65.5,894,12.2,1630,22.3
03,70,15,56,8718,100.0,3574,41.0,6278,72.0,5144,59.0,1134,13.0,2440,28.0
03,70,16,57,3180,100.0,1095,34.4,2434,76.5,2085,65.6,349,11.0,746,23.5
03,70,16,58,8523,100.0,2921,34.3,6544,76.8,5602,65.7,942,11.1,1979,23.2
03,70,16,59,9229,100.0,3360,36.4,7046,76.3,5869,63.6,1177,12.8,2183,23.7
03,70,16,60,12916,100.0,3919,30.3,10446,80.9,8997,69.7,1449,11.2,2470,19.1
04,10,01,01,11419,100.0,5859,51.3,7852,68.8,5560,48.7,2292,20.1,3567,31.2
04,10,01,02,7787,100.0,4439,57.0,5581,71.7,3348,43.0,2233,28.7,2206,28.3
04,20,02,03,1503,100.0,441,29.3,1236,82.2,1062,70.7,174,11.6,267,17.8
04,20,02,04,2925,100.0,1044,35.7,2251,77.0,1881,64.3,370,12.6,674,23.0
04,20,02,05,2565,100.0,859,33.5,2053,80.0,1706,66.5,347,13.5,512,20.0
04,20,02,06,2910,100.0,835,28.7,2486,85.4,2075,71.3,411,14.1,424,14.6
04,20,02,07,3015,100.0,1111,36.8,2219,73.6,1904,63.2,315,10.4,796,26.4
04,20,03,08,6180,100.0,2250,36.4,4764,77.1,3930,63.6,834,13.5,1416,22.9
04,20,03,09,6777,100.0,1908,28.2,5829,86.0,4869,71.8,960,14.2,948,14.0
04,20,03,10,7648,100.0,2869,37.5,6054,79.2,4779,62.5,1275,16.7,1594,20.8
04,20,03,11,7270,100.0,2934,40.4,5510,75.8,4336,59.6,1174,16.1,1760,24.2
04,30,04,12,4113,100.0,2368,57.6,2363,57.5,1745,42.4,618,15.0,1750,42.5
04,30,04,13,10001,100.0,4792,47.9,7516,75.2,5209,52.1,2307,23.1,2485,24.8
04,30,04,14,10674,100.0,4235,39.7,8215,77.0,6439,60.3,1776,16.6,2459,23.0
04,30,04,15,6306,100.0,2464,39.1,4917,78.0,3842,60.9,1075,17.0,1389,22.0
04,30,04,16,11863,100.0,4949,41.7,8904,75.1,6914,58.3,1990,16.8,2959,24.9
04,30,05,17,9496,100.0,4557,48.0,6748,71.1,4939,52.0,1809,19.1,2748,28.9
04,30,05,18,5801,100.0,2724,47.0,4230,72.9,3077,53.0,1153,19.9,1571,27.1
04,30,06,19,8822,100.0,4113,46.6,6390,72.4,4709,53.4,1681,19.1,2432,27.6
04,30,06,20,3544,100.0,2180,61.5,2187,61.7,1364,38.5,823,23.2,1357,38.3
04,30,06,21,10590,100.0,5166,48.8,7669,72.4,5424,51.2,2245,21.2,2921,27.6
04,30,06,22,5206,100.0,3058,58.7,3472,66.7,2148,41.3,1324,25.4,1734,33.3
04,30,06,23,12179,100.0,6818,56.0,7782,63.9,5361,44.0,2421,19.9,4397,36.1
04,30,06,24,9250,100.0,4219,45.6,6632,71.7,5031,54.4,1601,17.3,2618,28.3
04,40,07,25,116,100.0,91,78.4,40,34.5,25,21.6,15,12.9,76,65.5
04,40,07,26,5457,100.0,2420,44.3,4105,75.2,3037,55.7,1068,19.6,1352,24.8
04,40,07,27,8295,100.0,3432,41.4,6414,77.3,4863,58.6,1551,18.7,1881,22.7
04,40,07,28,3207,100.0,1268,39.5,2515,78.4,1939,60.5,576,18.0,692,21.6
04,40,07,29,2863,100.0,1152,40.2,2236,78.1,1711,59.8,525,18.3,627,21.9
04,40,08,30,7493,100.0,3251,43.4,5685,75.9,4242,56.6,1443,19.3,1808,24.1
04,40,08,31,1539,100.0,468,30.4,1310,85.1,1071,69.6,239,15.5,229,14.9
04,40,08,32,6877,100.0,1798,26.1,5959,86.7,5079,73.9,880,12.8,918,13.3
04,40,08,33,4094,100.0,1537,37.5,3303,80.7,2557,62.5,746,18.2,791,19.3
04,40,08,34,3523,100.0,1169,33.2,2923,83.0,2354,66.8,569,16.2,600,17.0
04,40,08,35,10343,100.0,2973,28.7,8726,84.4,7370,71.3,1356,13.1,1617,15.6
04,50,09,36,5587,100.0,2576,46.1,4089,73.2,3011,53.9,1078,19.3,1498,26.8
04,50,09,37,7860,100.0,3531,44.9,5666,72.1,4329,55.1,1337,17.0,2194,27.9
04,50,09,38,8072,100.0,3813,47.2,5850,72.5,4259,52.8,1591,19.7,2222,27.5
04,50,09,39,6616,100.0,3202,48.4,4873,73.7,3414,51.6,1459,22.1,1743,26.3
04,50,10,40,5966,100.0,2711,45.4,4374,73.3,3255,54.6,1119,18.8,1592,26.7
04,50,10,41,5263,100.0,2367,45.0,3915,74.4,2896,55.0,1019,19.4,1348,25.6
04,50,10,42,3668,100.0,2147,58.5,2252,61.4,1521,41.5,731,19.9,1416,38.6
04,50,10,43,11040,100.0,5149,46.6,8051,72.9,5891,53.4,2160,19.6,2989,27.1
04,50,10,44,5405,100.0,2471,45.7,3884,71.9,2934,54.3,950,17.6,1521,28.1
04,50,10,45,9215,100.0,4516,49.0,6447,70.0,4699,51.0,1748,19.0,2768,30.0
04,50,11,46,4485,100.0,1971,43.9,3342,74.5,2514,56.1,828,18.5,1143,25.5
04,50,11,47,5496,100.0,2398,43.6,4121,75.0,3098,56.4,1023,18.6,1375,25.0
04,50,11,48,4503,100.0,2142,47.6,3218,71.5,2361,52.4,857,19.0,1285,28.5
04,50,11,49,9889,100.0,4137,41.8,7438,75.2,5752,58.2,1686,17.0,2451,24.8
04,50,11,50,3038,100.0,1200,39.5,2304,75.8,1838,60.5,466,15.3,734,24.2
04,50,11,51,7385,100.0,2496,33.8,5983,81.0,4889,66.2,1094,14.8,1402,19.0
04,50,11,52,6886,100.0,3091,44.9,5056,73.4,3795,55.1,1261,18.3,1830,26.6
04,50,11,53,7380,100.0,3361,45.5,5478,74.2,4019,54.5,1459,19.8,1902,25.8
05,10,01,01,4321,100.0,995,23.0,3845,89.0,3326,77.0,519,12.0,476,11.0
05,10,01,02,4265,100.0,1096,25.7,3617,84.8,3169,74.3,448,10.5,648,15.2
05,10,01,03,6021,100.0,2974,49.4,4205,69.8,3047,50.6,1158,19.2,1816,30.2
05,10,01,04,5538,100.0,2619,47.3,4083,73.7,2919,52.7,1164,21.0,1455,26.3
05,10,01,05,7633,100.0,1680,22.0,6803,89.1,5953,78.0,850,11.1,830,10.9
05,10,02,06,3630,100.0,1666,45.9,2660,73.3,1964,54.1,696,19.2,970,26.7
05,10,02,07,2287,100.0,641,28.0,2027,88.6,1646,72.0,381,16.7,260,11.4
05,10,02,08,10880,100.0,5202,47.8,7861,72.3,5678,52.2,2183,20.1,3019,27.7
05,10,02,09,11763,100.0,6352,54.0,8763,74.5,5411,46.0,3352,28.5,3000,25.5
05,10,02,10,7799,100.0,3130,40.1,5798,74.3,4669,59.9,1129,14.5,2001,25.7
05,10,02,11,6082,100.0,2185,35.9,4995,82.1,3897,64.1,1098,18.1,1087,17.9
05,10,03,12,4134,100.0,1854,44.8,2916,70.5,2280,55.2,636,15.4,1218,29.5
05,10,03,13,6227,100.0,3418,54.9,4329,69.5,2809,45.1,1520,24.4,1898,30.5
05,10,03,14,7393,100.0,4565,61.7,3995,54.0,2828,38.3,1167,15.8,3398,46.0
05,10,03,15,6897,100.0,3248,47.1,4775,69.2,3649,52.9,1126,16.3,2122,30.8
05,10,03,16,10326,100.0,4506,43.6,7718,74.7,5820,56.4,1898,18.4,2608,25.3
05,10,03,17,3611,100.0,1804,50.0,2219,61.5,1807,50.0,412,11.4,1392,38.5
05,20,04,18,3929,100.0,982,25.0,3593,91.4,2947,75.0,646,16.4,336,8.6
05,20,04,19,1666,100.0,100,6.0,1636,98.2,1566,94.0,70,4.2,30,1.8
05,20,04,20,5874,100.0,1999,34.0,4893,83.3,3875,66.0,1018,17.3,981,16.7
05,20,04,21,4367,100.0,1374,31.5,3508,80.3,2993,68.5,515,11.8,859,19.7
05,20,04,22,1124,100.0,251,22.3,994,88.4,873,77.7,121,10.8,130,11.6
05,20,04,23,6649,100.0,2392,36.0,5241,78.8,4257,64.0,984,14.8,1408,21.2
05,20,05,24,3417,100.0,1037,30.3,2983,87.3,2380,69.7,603,17.6,434,12.7
05,20,05,25,2421,100.0,636,26.3,2201,90.9,1785,73.7,416,17.2,220,9.1
05,20,05,26,5665,100.0,3338,58.9,3358,59.3,2327,41.1,1031,18.2,2307,40.7
05,20,05,27,11762,100.0,7529,64.0,7406,63.0,4233,36.0,3173,27.0,4356,37.0
05,20,05,28,7132,100.0,2098,29.4,6070,85.1,5034,70.6,1036,14.5,1062,14.9
05,20,06,29,8375,100.0,3638,43.4,6061,72.4,4737,56.6,1324,15.8,2314,27.6
05,20,06,30,9881,100.0,3904,39.5,7377,74.7,5977,60.5,1400,14.2,2504,25.3
05,20,06,31,8488,100.0,3449,40.6,6257,73.7,5039,59.4,1218,14.3,2231,26.3
05,20,06,32,3713,100.0,1804,48.6,2555,68.8,1909,51.4,646,17.4,1158,31.2
05,20,06,33,2019,100.0,590,29.2,1741,86.2,1429,70.8,312,15.5,278,13.8
05,20,06,34,4425,100.0,790,17.9,4018,90.8,3635,82.1,383,8.7,407,9.2
05,30,07,35,3429,100.0,2064,60.2,2619,76.4,1365,39.8,1254,36.6,810,23.6
05,30,07,36,3640,100.0,2021,55.5,2741,75.3,1619,44.5,1122,30.8,899,24.7
05,30,07,37,11709,100.0,5501,47.0,8883,75.9,6208,53.0,2675,22.8,2826,24.1
05,30,08,38,30,100.0,16,53.3,14,46.7,14,46.7,0,0.0,16,53.3
05,30,08,39,7765,100.0,3971,51.1,5343,68.8,3794,48.9,1549,19.9,2422,31.2
05,30,08,40,462,100.0,228,49.4,339,73.4,234,50.6,105,22.7,123,26.6
05,30,08,41,4580,100.0,2239,48.9,3276,71.5,2341,51.1,935,20.4,1304,28.5
05,40,09,42,3808,100.0,875,23.0,3389,89.0,2933,77.0,456,12.0,419,11.0
05,40,09,43,10480,100.0,2135,20.4,9704,92.6,8345,79.6,1359,13.0,776,7.4
05,40,09,44,2243,100.0,437,19.5,2041,91.0,1806,80.5,235,10.5,202,9.0
05,40,09,45,3728,100.0,672,18.0,3431,92.0,3056,82.0,375,10.1,297,8.0
06,10,01,01,6887,100.0,1901,27.6,5906,85.8,4986,72.4,920,13.4,981,14.2
06,10,01,02,9101,100.0,3652,40.1,7025,77.2,5449,59.9,1576,17.3,2076,22.8
06,10,01,03,6227,100.0,2053,33.0,5187,83.3,4174,67.0,1013,16.3,1040,16.7
06,10,02,04,6855,100.0,2586,37.7,5518,80.5,4269,62.3,1249,18.2,1337,19.5
06,10,02,05,9965,100.0,3524,35.4,8126,81.5,6441,64.6,1685,16.9,1839,18.5
06,10,02,06,7710,100.0,2442,31.7,6378,82.7,5268,68.3,1110,14.4,1332,17.3
06,10,02,07,8065,100.0,2904,36.0,6464,80.1,5161,64.0,1303,16.2,1601,19.9
06,10,02,08,6871,100.0,2291,33.3,5656,82.3,4580,66.7,1076,15.7,1215,17.7
06,10,02,09,9288,100.0,3472,37.4,7404,79.7,5816,62.6,1588,17.1,1884,20.3
06,10,02,10,4924,100.0,1571,31.9,4081,82.9,3353,68.1,728,14.8,843,17.1
06,20,03,11,4970,100.0,1314,26.4,4314,86.8,3656,73.6,658,13.2,656,13.2
06,20,03,12,6046,100.0,2032,33.6,4866,80.5,4014,66.4,852,14.1,1180,19.5
06,20,03,13,7400,100.0,2541,34.3,6047,81.7,4859,65.7,1188,16.1,1353,18.3
06,20,03,14,7176,100.0,2262,31.5,6002,83.6,4914,68.5,1088,15.2,1174,16.4
06,20,03,15,6622,100.0,2308,34.9,5470,82.6,4314,65.1,1156,17.5,1152,17.4
06,20,03,16,5302,100.0,2256,42.5,4086,77.1,3046,57.5,1040,19.6,1216,22.9
06,20,03,17,6363,100.0,1399,22.0,5697,89.5,4964,78.0,733,11.5,666,10.5
06,20,04,18,0,100.0,0,0.0,0,0.0,0,0.0,0,0.0,0,0.0
06,20,04,19,4552,100.0,2367,52.0,3336,73.3,2185,48.0,1151,25.3,1216,26.7
06,20,04,20,7218,100.0,2205,30.5,6005,83.2,5013,69.5,992,13.7,1213,16.8
06,20,04,21,8340,100.0,2416,29.0,6939,83.2,5924,71.0,1015,12.2,1401,16.8
06,20,04,22,7176,100.0,1737,24.2,6104,85.1,5439,75.8,665,9.3,1072,14.9
06,20,04,23,8665,100.0,2536,29.3,7392,85.3,6129,70.7,1263,14.6,1273,14.7
06,30,05,24,5735,100.0,1518,26.5,4804,83.8,4217,73.5,587,10.2,931,16.2
06,30,05,25,5694,100.0,1523,26.7,4844,85.1,4171,73.3,673,11.8,850,14.9
06,30,05,26,3371,100.0,1130,33.5,2725,80.8,2241,66.5,484,14.4,646,19.2
06,30,05,27,8345,100.0,2486,29.8,7076,84.8,5859,70.2,1217,14.6,1269,15.2
06,30,05,28,11121,100.0,2806,25.2,9726,87.5,8315,74.8,1411,12.7,1395,12.5
06,30,06,29,7083,100.0,2079,29.4,5971,84.3,5004,70.6,967,13.7,1112,15.7
06,30,06,30,5596,100.0,2289,40.9,4124,73.7,3307,59.1,817,14.6,1472,26.3
06,30,06,31,2963,100.0,1096,37.0,2234,75.4,1867,63.0,367,12.4,729,24.6
06,30,06,32,13986,100.0,4297,30.7,11933,85.3,9689,69.3,2244,16.0,2053,14.7
06,30,06,33,12069,100.0,3323,27.5,10211,84.6,8746,72.5,1465,12.1,1858,15.4
06,30,06,34,8540,100.0,2179,25.5,7360,86.2,6361,74.5,999,11.7,1180,13.8
06,40,07,35,10246,100.0,2525,24.6,8817,86.1,7721,75.4,1096,10.7,1429,13.9
06,40,07,36,5246,100.0,1179,22.5,4761,90.8,4067,77.5,694,13.2,485,9.2
06,40,07,37,11370,100.0,3582,31.5,8918,78.4,7788,68.5,1130,9.9,2452,21.6
06,40,08,38,7592,100.0,1609,21.2,6761,89.1,5983,78.8,778,10.2,831,10.9
06,40,08,39,5318,100.0,1294,24.3,4630,87.1,4024,75.7,606,11.4,688,12.9
06,40,08,40,7221,100.0,1283,17.8,6549,90.7,5938,82.2,611,8.5,672,9.3
06,40,08,41,6222,100.0,1787,28.7,5256,84.5,4435,71.3,821,13.2,966,15.5
06,40,08,42,4874,100.0,1877,38.5,4107,84.3,2997,61.5,1110,22.8,767,15.7
06,40,08,43,4783,100.0,1493,31.2,3926,82.1,3290,68.8,636,13.3,857,17.9
06,40,08,44,7356,100.0,2559,34.8,5953,80.9,4797,65.2,1156,15.7,1403,19.1
07,10,01,01,9835,100.0,4877,49.6,7015,71.3,4958,50.4,2057,20.9,2820,28.7
07,10,01,02,8628,100.0,4483,52.0,5689,65.9,4145,48.0,1544,17.9,2939,34.1
07,10,01,03,7729,100.0,4939,63.9,4906,63.5,2790,36.1,2116,27.4,2823,36.5
07,10,02,04,10423,100.0,4211,40.4,7886,75.7,6212,59.6,1674,16.1,2537,24.3
07,10,02,05,5235,100.0,3557,67.9,3227,61.6,1678,32.1,1549,29.6,2008,38.4
07,10,02,06,8344,100.0,4211,50.5,5829,69.9,4133,49.5,1696,20.3,2515,30.1
07,20,03,07,10572,100.0,3956,37.4,8443,79.9,6616,62.6,1827,17.3,2129,20.1
07,20,03,08,10505,100.0,4919,46.8,7535,71.7,5586,53.2,1949,18.6,2970,28.3
07,20,04,09,9367,100.0,3604,38.5,7301,77.9,5763,61.5,1538,16.4,2066,22.1
07,20,04,10,5653,100.0,3129,55.4,3891,68.8,2524,44.6,1367,24.2,1762,31.2
07,20,04,11,2753,100.0,1225,44.5,2056,74.7,1528,55.5,528,19.2,697,25.3
07,20,04,12,1907,100.0,1148,60.2,1187,62.2,759,39.8,428,22.4,720,37.8
07,20,04,13,7777,100.0,2792,35.9,6168,79.3,4985,64.1,1183,15.2,1609,20.7
07,20,04,14,3750,100.0,1534,40.9,2881,76.8,2216,59.1,665,17.7,869,23.2
07,30,05,15,6900,100.0,1901,27.6,5935,86.0,4999,72.4,936,13.6,965,14.0
07,30,05,16,8921,100.0,2752,30.8,7375,82.7,6169,69.2,1206,13.5,1546,17.3
07,30,05,17,9374,100.0,3253,34.7,7582,80.9,6121,65.3,1461,15.6,1792,19.1
07,30,06,18,9328,100.0,3169,34.0,7633,81.8,6159,66.0,1474,15.8,1695,18.2
07,30,06,19,12293,100.0,5645,45.9,9360,76.1,6648,54.1,2712,22.1,2933,23.9
07,40,07,20,11976,100.0,5090,42.5,9508,79.4,6886,57.5,2622,21.9,2468,20.6
07,40,07,21,5411,100.0,1775,32.8,4617,85.3,3636,67.2,981,18.1,794,14.7
07,40,08,22,2808,100.0,933,33.2,2273,80.9,1875,66.8,398,14.2,535,19.1
07,40,08,23,9719,100.0,3660,37.7,7830,80.6,6059,62.3,1771,18.2,1889,19.4
07,40,08,24,7323,100.0,3000,41.0,5651,77.2,4323,59.0,1328,18.1,1672,22.8
07,40,08,25,7354,100.0,3253,44.2,5482,74.5,4101,55.8,1381,18.8,1872,25.5
07,40,08,26,5112,100.0,1468,28.7,4422,86.5,3644,71.3,778,15.2,690,13.5
07,40,09,27,11284,100.0,5385,47.7,8200,72.7,5899,52.3,2301,20.4,3084,27.3
07,40,09,28,3938,100.0,2300,58.4,2486,63.1,1638,41.6,848,21.5,1452,36.9
07,50,10,29,8197,100.0,3594,43.8,6289,76.7,4603,56.2,1686,20.6,1908,23.3
07,50,10,30,8795,100.0,3846,43.7,6818,77.5,4949,56.3,1869,21.3,1977,22.5
07,50,10,31,9083,100.0,3213,35.4,7524,82.8,5870,64.6,1654,18.2,1559,17.2
07,50,10,32,5761,100.0,2069,35.9,4780,83.0,3692,64.1,1088,18.9,981,17.0
07,50,11,33,7991,100.0,3310,41.4,6049,75.7,4681,58.6,1368,17.1,1942,24.3
07,50,11,34,10574,100.0,3329,31.5,8997,85.1,7245,68.5,1752,16.6,1577,14.9
07,50,11,35,2257,100.0,620,27.5,1965,87.1,1637,72.5,328,14.5,292,12.9
07,60,12,36,10238,100.0,4581,44.7,7651,74.7,5657,55.3,1994,19.5,2587,25.3
07,60,12,37,4765,100.0,1323,27.8,4179,87.7,3442,72.2,737,15.5,586,12.3
07,60,12,38,2867,100.0,1190,41.5,2337,81.5,1677,58.5,660,23.0,530,18.5
07,60,13,39,5682,100.0,2425,42.7,4724,83.1,3257,57.3,1467,25.8,958,16.9
07,60,13,40,6420,100.0,2846,44.3,5176,80.6,3574,55.7,1602,25.0,1244,19.4
07,60,13,41,2249,100.0,720,32.0,1856,82.5,1529,68.0,327,14.5,393,17.5
07,60,14,42,10413,100.0,2561,24.6,9209,88.4,7852,75.4,1357,13.0,1204,11.6
07,60,14,43,10949,100.0,2770,25.3,9800,89.5,8179,74.7,1621,14.8,1149,10.5
07,60,15,44,8944,100.0,3014,33.7,7481,83.6,5930,66.3,1551,17.3,1463,16.4
07,60,15,45,8307,100.0,3409,41.0,6379,76.8,4898,59.0,1481,17.8,1928,23.2
07,60,15,46,7008,100.0,1499,21.4,6326,90.3,5509,78.6,817,11.7,682,9.7
07,60,15,47,3923,100.0,937,23.9,3364,85.8,2986,76.1,378,9.6,559,14.2
07,60,15,48,2925,100.0,596,20.4,2629,89.9,2329,79.6,300,10.3,296,10.1
08,10,01,01,4725,100.0,2717,57.5,2873,60.8,2008,42.5,865,18.3,1852,39.2
08,10,01,02,8285,100.0,4487,54.2,5275,63.7,3798,45.8,1477,17.8,3010,36.3
08,10,01,03,7413,100.0,3808,51.4,4923,66.4,3605,48.6,1318,17.8,2490,33.6
08,10,01,04,6638,100.0,3896,58.7,4196,63.2,2742,41.3,1454,21.9,2442,36.8
08,10,01,05,5826,100.0,3715,63.8,3595,61.7,2111,36.2,1484,25.5,2231,38.3
08,10,02,06,9655,100.0,5779,59.9,5848,60.6,3876,40.1,1972,20.4,3807,39.4
08,10,02,07,7484,100.0,5061,67.6,4871,65.1,2423,32.4,2448,32.7,2613,34.9
08,10,02,08,12325,100.0,7014,56.9,7805,63.3,5311,43.1,2494,20.2,4520,36.7
08,10,02,09,8613,100.0,5178,60.1,5103,59.2,3435,39.9,1668,19.4,3510,40.8
08,10,03,10,7858,100.0,4058,51.6,5348,68.1,3800,48.4,1548,19.7,2510,31.9
08,10,03,11,7322,100.0,3582,48.9,4962,67.8,3740,51.1,1222,16.7,2360,32.2
08,10,03,12,11936,100.0,6265,52.5,7845,65.7,5671,47.5,2174,18.2,4091,34.3
08,10,03,13,3845,100.0,1493,38.8,2980,77.5,2352,61.2,628,16.3,865,22.5
08,10,03,14,8088,100.0,4973,61.5,4812,59.5,3115,38.5,1697,21.0,3276,40.5
08,10,04,15,6473,100.0,3483,53.8,4231,65.4,2990,46.2,1241,19.2,2242,34.6
08,10,04,16,6493,100.0,3467,53.4,4288,66.0,3026,46.6,1262,19.4,2205,34.0
08,10,04,17,9791,100.0,5449,55.7,6227,63.6,4342,44.3,1885,19.3,3564,36.4
08,10,04,18,9539,100.0,4614,48.4,6574,68.9,4925,51.6,1649,17.3,2965,31.1
08,10,04,19,7186,100.0,4464,62.1,4169,58.0,2722,37.9,1447,20.1,3017,42.0
08,10,05,20,5826,100.0,4379,75.2,3601,61.8,1447,24.8,2154,37.0,2225,38.2
08,10,05,21,9566,100.0,6401,66.9,6654,69.6,3165,33.1,3489,36.5,2912,30.4
08,20,06,22,5679,100.0,3957,69.7,3087,54.4,1722,30.3,1365,24.0,2592,45.6
08,20,06,23,5998,100.0,2783,46.4,4506,75.1,3215,53.6,1291,21.5,1492,24.9
08,20,06,24,8863,100.0,4363,49.2,6574,74.2,4500,50.8,2074,23.4,2289,25.8
08,20,07,25,2507,100.0,852,34.0,2165,86.4,1655,66.0,510,20.3,342,13.6
08,20,07,26,6193,100.0,1901,30.7,5312,85.8,4292,69.3,1020,16.5,881,14.2
08,20,07,27,7979,100.0,2557,32.0,6772,84.9,5422,68.0,1350,16.9,1207,15.1
08,20,07,28,1207,100.0,411,34.1,1029,85.3,796,65.9,233,19.3,178,14.7
08,20,07,29,1888,100.0,702,37.2,1609,85.2,1186,62.8,423,22.4,279,14.8
08,20,07,30,3351,100.0,1177,35.1,2740,81.8,2174,64.9,566,16.9,611,18.2
08,20,08,31,8378,100.0,2539,30.3,7240,86.4,5839,69.7,1401,16.7,1138,13.6
08,20,08,32,11687,100.0,4011,34.3,9897,84.7,7676,65.7,2221,19.0,1790,15.3
08,20,08,33,8586,100.0,4141,48.2,6496,75.7,4445,51.8,2051,23.9,2090,24.3
08,30,09,34,12544,100.0,6805,54.2,9755,77.8,5739,45.8,4016,32.0,2789,22.2
08,30,09,35,7344,100.0,3426,46.7,5905,80.4,3918,53.3,1987,27.1,1439,19.6
08,30,10,36,7169,100.0,3573,49.8,5643,78.7,3596,50.2,2047,28.6,1526,21.3
08,30,10,37,10990,100.0,6551,59.6,8285,75.4,4439,40.4,3846,35.0,2705,24.6
08,40,11,38,2898,100.0,1031,35.6,2455,84.7,1867,64.4,588,20.3,443,15.3
08,40,11,39,4100,100.0,1494,36.4,3451,84.2,2606,63.6,845,20.6,649,15.8
08,40,11,40,2695,100.0,1004,37.3,2243,83.2,1691,62.7,552,20.5,452,16.8
08,40,12,41,8302,100.0,3211,38.7,6881,82.9,5091,61.3,1790,21.6,1421,17.1
08,40,12,42,6868,100.0,1953,28.4,6034,87.9,4915,71.6,1119,16.3,834,12.1
08,40,12,43,10061,100.0,3220,32.0,8554,85.0,6841,68.0,1713,17.0,1507,15.0
08,40,12,44,7232,100.0,1976,27.3,6531,90.3,5256,72.7,1275,17.6,701,9.7
08,40,12,45,3723,100.0,1186,31.9,3297,88.6,2537,68.1,760,20.4,426,11.4
08,40,12,46,7908,100.0,2281,28.8,6951,87.9,5627,71.2,1324,16.7,957,12.1
09,10,01,01,13269,100.0,4595,34.6,10495,79.1,8674,65.4,1821,13.7,2774,20.9
09,10,02,02,4358,100.0,960,22.0,3790,87.0,3398,78.0,392,9.0,568,13.0
09,10,02,03,6989,100.0,1584,22.7,5897,84.4,5405,77.3,492,7.0,1092,15.6
09,10,03,04,11889,100.0,2487,20.9,10351,87.1,9402,79.1,949,8.0,1538,12.9
09,10,03,05,4173,100.0,998,23.9,3552,85.1,3175,76.1,377,9.0,621,14.9
09,10,03,06,3136,100.0,1038,33.1,2564,81.8,2098,66.9,466,14.9,572,18.2
09,10,04,07,8467,100.0,1283,15.2,7675,90.6,7184,84.8,491,5.8,792,9.4
09,10,04,08,8307,100.0,1608,19.4,7322,88.1,6699,80.6,623,7.5,985,11.9
09,10,04,09,3948,100.0,1020,25.8,3499,88.6,2928,74.2,571,14.5,449,11.4
09,20,05,10,7634,100.0,2787,36.5,5501,72.1,4847,63.5,654,8.6,2133,27.9
09,20,05,11,13007,100.0,3552,27.3,10522,80.9,9455,72.7,1067,8.2,2485,19.1
09,20,05,12,3878,100.0,1195,30.8,2989,77.1,2683,69.2,306,7.9,889,22.9
09,20,06,13,10262,100.0,3751,36.6,7318,71.3,6511,63.4,807,7.9,2944,28.7
09,20,06,14,3575,100.0,420,11.7,3320,92.9,3155,88.3,165,4.6,255,7.1
09,20,07,15,3150,100.0,1385,44.0,2132,67.7,1765,56.0,367,11.7,1018,32.3
09,20,07,16,7716,100.0,1887,24.5,6306,81.7,5829,75.5,477,6.2,1410,18.3
09,20,07,17,9708,100.0,2235,23.0,8077,83.2,7473,77.0,604,6.2,1631,16.8
09,20,08,18,3491,100.0,605,17.3,3066,87.8,2886,82.7,180,5.2,425,12.2
09,20,08,19,8473,100.0,2192,25.9,6884,81.2,6281,74.1,603,7.1,1589,18.8
09,30,09,20,12458,100.0,2570,20.6,11137,89.4,9888,79.4,1249,10.0,1321,10.6
09,30,09,21,2788,100.0,441,15.8,2574,92.3,2347,84.2,227,8.1,214,7.7
09,30,09,22,5920,100.0,1317,22.2,5064,85.5,4603,77.8,461,7.8,856,14.5
09,30,09,23,8138,100.0,1880,23.1,7222,88.7,6258,76.9,964,11.8,916,11.3
09,30,10,24,3011,100.0,593,19.7,2703,89.8,2418,80.3,285,9.5,308,10.2
09,30,10,25,11024,100.0,1925,17.5,9806,89.0,9099,82.5,707,6.4,1218,11.0
09,30,11,26,7786,100.0,1440,18.5,6876,88.3,6346,81.5,530,6.8,910,11.7
09,30,12,27,1905,100.0,237,12.4,1805,94.8,1668,87.6,137,7.2,100,5.2
09,30,12,28,2709,100.0,369,13.6,2508,92.6,2340,86.4,168,6.2,201,7.4
09,40,13,29,10180,100.0,865,8.5,9686,95.1,9315,91.5,371,3.6,494,4.9
09,40,13,30,1899,100.0,238,12.5,1784,93.9,1661,87.5,123,6.5,115,6.1
09,40,14,31,5738,100.0,917,16.0,5134,89.5,4821,84.0,313,5.5,604,10.5
09,40,14,32,1540,100.0,277,18.0,1362,88.4,1263,82.0,99,6.4,178,11.6
09,40,14,33,4444,100.0,776,17.5,3894,87.6,3668,82.5,226,5.1,550,12.4
09,40,15,34,7453,100.0,1772,23.8,6220,83.5,5681,76.2,539,7.2,1233,16.5
09,40,16,35,6964,100.0,671,9.6,6654,95.5,6293,90.4,361,5.2,310,4.5
09,50,17,36,4599,100.0,581,12.6,4205,91.4,4018,87.4,187,4.1,394,8.6
09,50,17,37,14530,100.0,1515,10.4,13691,94.2,13015,89.6,676,4.7,839,5.8
09,50,18,38,10582,100.0,1479,14.0,9644,91.1,9103,86.0,541,5.1,938,8.9
09,50,19,39,6485,100.0,1322,20.4,5573,85.9,5163,79.6,410,6.3,912,14.1
09,50,19,40,2704,100.0,516,19.1,2339,86.5,2188,80.9,151,5.6,365,13.5
09,50,19,41,2779,100.0,442,15.9,2495,89.8,2337,84.1,158,5.7,284,10.2
09,50,20,42,4218,100.0,554,13.1,3841,91.1,3664,86.9,177,4.2,377,8.9
09,50,20,43,9166,100.0,938,10.2,8628,94.1,8228,89.8,400,4.4,538,5.9
10,10,01,01,5792,100.0,1794,31.0,4674,80.7,3998,69.0,676,11.7,1118,19.3
10,10,01,02,3616,100.0,1210,33.5,2757,76.2,2406,66.5,351,9.7,859,23.8
10,10,01,03,7718,100.0,2125,27.5,6485,84.0,5593,72.5,892,11.6,1233,16.0
10,10,01,04,7575,100.0,2324,30.7,6491,85.7,5251,69.3,1240,16.4,1084,14.3
10,10,02,05,1301,100.0,897,68.9,453,34.8,404,31.1,49,3.8,848,65.2
10,10,02,06,11319,100.0,3267,28.9,9435,83.4,8052,71.1,1383,12.2,1884,16.6
10,10,02,07,8224,100.0,1561,19.0,7247,88.1,6663,81.0,584,7.1,977,11.9
10,10,02,08,9523,100.0,2636,27.7,7948,83.5,6887,72.3,1061,11.1,1575,16.5
10,10,02,09,8302,100.0,2449,29.5,6694,80.6,5853,70.5,841,10.1,1608,19.4
10,10,02,10,10825,100.0,3101,28.6,9170,84.7,7724,71.4,1446,13.4,1655,15.3
10,10,03,11,2239,100.0,719,32.1,1797,80.3,1520,67.9,277,12.4,442,19.7
10,10,03,12,15164,100.0,4524,29.8,12678,83.6,10640,70.2,2038,13.4,2486,16.4
10,10,03,13,4846,100.0,1586,32.7,3792,78.3,3260,67.3,532,11.0,1054,21.7
10,10,03,14,6353,100.0,1375,21.6,5634,88.7,4978,78.4,656,10.3,719,11.3
10,10,03,15,7473,100.0,2188,29.3,6340,84.8,5285,70.7,1055,14.1,1133,15.2
10,10,03,16,3732,100.0,594,15.9,3495,93.6,3138,84.1,357,9.6,237,6.4
10,20,04,17,7282,100.0,2623,36.0,5699,78.3,4659,64.0,1040,14.3,1583,21.7
10,20,04,18,6197,100.0,1244,20.1,5354,86.4,4953,79.9,401,6.5,843,13.6
10,20,04,19,4124,100.0,1890,45.8,2712,65.8,2234,54.2,478,11.6,1412,34.2
10,20,04,20,7288,100.0,2191,30.1,5568,76.4,5097,69.9,471,6.5,1720,23.6
10,20,04,21,1813,100.0,970,53.5,1232,68.0,843,46.5,389,21.5,581,32.0
10,20,04,22,6637,100.0,2765,41.7,4390,66.1,3872,58.3,518,7.8,2247,33.9
10,20,04,23,6051,100.0,2179,36.0,4487,74.2,3872,64.0,615,10.2,1564,25.8
10,20,05,24,11079,100.0,2915,26.3,8984,81.1,8164,73.7,820,7.4,2095,18.9
10,20,05,25,5343,100.0,1562,29.2,4189,78.4,3781,70.8,408,7.6,1154,21.6
10,20,05,26,6026,100.0,2175,36.1,4460,74.0,3851,63.9,609,10.1,1566,26.0
10,20,06,27,3543,100.0,878,24.8,2995,84.5,2665,75.2,330,9.3,548,15.5
10,20,06,28,6481,100.0,1828,28.2,5198,80.2,4653,71.8,545,8.4,1283,19.8
10,20,06,29,9098,100.0,1769,19.4,8077,88.8,7329,80.6,748,8.2,1021,11.2
10,20,06,30,6456,100.0,1017,15.8,5931,91.9,5439,84.2,492,7.6,525,8.1
10,30,07,31,7767,100.0,1467,18.9,6889,88.7,6300,81.1,589,7.6,878,11.3
10,30,07,32,7078,100.0,1697,24.0,6119,86.5,5381,76.0,738,10.4,959,13.5
10,30,07,33,4832,100.0,1251,25.9,4079,84.4,3581,74.1,498,10.3,753,15.6
10,30,07,34,10593,100.0,1552,14.7,9834,92.8,9041,85.3,793,7.5,759,7.2
10,40,08,35,7858,100.0,827,10.5,7451,94.8,7031,89.5,420,5.3,407,5.2
10,40,08,36,3886,100.0,498,12.8,3565,91.7,3388,87.2,177,4.6,321,8.3
10,40,08,37,7788,100.0,672,8.6,7528,96.7,7116,91.4,412,5.3,260,3.3
10,40,09,38,10146,100.0,1018,10.0,9682,95.4,9128,90.0,554,5.5,464,4.6
10,40,09,39,4481,100.0,607,13.5,4143,92.5,3874,86.5,269,6.0,338,7.5
10,40,09,40,5903,100.0,523,8.9,5632,95.4,5380,91.1,252,4.3,271,4.6
10,40,09,41,9814,100.0,947,9.6,9406,95.8,8867,90.4,539,5.5,408,4.2
11,10,01,01,3363,100.0,347,10.3,3175,94.4,3016,89.7,159,4.7,188,5.6
11,10,01,02,2996,100.0,1196,39.9,2095,69.9,1800,60.1,295,9.8,901,30.1
11,10,02,03,9085,100.0,3217,35.4,6978,76.8,5868,64.6,1110,12.2,2107,23.2
11,10,02,04,7036,100.0,2494,35.4,5398,76.7,4542,64.6,856,12.2,1638,23.3
11,10,02,05,6244,100.0,2040,32.7,4814,77.1,4204,67.3,610,9.8,1430,22.9
11,10,02,06,7677,100.0,2476,32.3,5857,76.3,5201,67.7,656,8.5,1820,23.7
11,10,03,07,11795,100.0,3896,33.0,9398,79.7,7899,67.0,1499,12.7,2397,20.3
11,10,03,08,9570,100.0,3045,31.8,7579,79.2,6525,68.2,1054,11.0,1991,20.8
11,10,03,09,6265,100.0,1681,26.8,5057,80.7,4584,73.2,473,7.5,1208,19.3
11,20,04,10,10153,100.0,3369,33.2,7651,75.4,6784,66.8,867,8.5,2502,24.6
11,20,04,11,6864,100.0,1816,26.5,5697,83.0,5048,73.5,649,9.5,1167,17.0
11,20,05,12,3928,100.0,865,22.0,3286,83.7,3063,78.0,223,5.7,642,16.3
11,20,05,13,10079,100.0,2858,28.4,7939,78.8,7221,71.6,718,7.1,2140,21.2
11,20,05,14,15741,100.0,5113,32.5,12444,79.1,10628,67.5,1816,11.5,3297,20.9
11,20,05,15,4296,100.0,1073,25.0,3690,85.9,3223,75.0,467,10.9,606,14.1
11,30,06,16,5997,100.0,2287,38.1,4624,77.1,3710,61.9,914,15.2,1373,22.9
11,30,06,17,4336,100.0,1296,29.9,3597,83.0,3040,70.1,557,12.8,739,17.0
11,30,06,18,3798,100.0,1215,32.0,2927,77.1,2583,68.0,344,9.1,871,22.9
11,30,06,19,8527,100.0,3191,37.4,6283,73.7,5336,62.6,947,11.1,2244,26.3
11,30,06,20,11370,100.0,4185,36.8,8694,76.5,7185,63.2,1509,13.3,2676,23.5
11,30,07,21,6043,100.0,3988,66.0,2504,41.4,2055,34.0,449,7.4,3539,58.6
11,30,07,22,10300,100.0,2941,28.6,8546,83.0,7359,71.4,1187,11.5,1754,17.0
11,30,07,23,2596,100.0,1785,68.8,1038,40.0,811,31.2,227,8.7,1558,60.0
11,30,07,24,4131,100.0,1229,29.8,3298,79.8,2902,70.2,396,9.6,833,20.2
11,30,07,25,10072,100.0,2517,25.0,8350,82.9,7555,75.0,795,7.9,1722,17.1
11,30,08,26,9891,100.0,3928,39.7,7364,74.5,5963,60.3,1401,14.2,2527,25.5
11,40,09,27,4229,100.0,1126,26.6,3503,82.8,3103,73.4,400,9.5,726,17.2
11,40,09,28,2514,100.0,876,34.8,1885,75.0,1638,65.2,247,9.8,629,25.0
11,40,09,29,16558,100.0,4808,29.0,13050,78.8,11750,71.0,1300,7.9,3508,21.2
11,40,09,30,4709,100.0,910,19.3,4148,88.1,3799,80.7,349,7.4,561,11.9
11,40,09,31,6844,100.0,2006,29.3,5508,80.5,4838,70.7,670,9.8,1336,19.5
11,40,10,32,6185,100.0,2390,38.6,4426,71.6,3795,61.4,631,10.2,1759,28.4
11,40,10,33,6854,100.0,2723,39.7,5148,75.1,4131,60.3,1017,14.8,1706,24.9
11,40,10,34,3360,100.0,1166,34.7,2556,76.1,2194,65.3,362,10.8,804,23.9
11,40,11,35,10929,100.0,3802,34.8,8513,77.9,7127,65.2,1386,12.7,2416,22.1
11,40,11,36,8117,100.0,2079,25.6,6580,81.1,6038,74.4,542,6.7,1537,18.9
11,40,11,37,8678,100.0,3066,35.3,6766,78.0,5612,64.7,1154,13.3,1912,22.0
11,50,12,38,4438,100.0,1171,26.4,3745,84.4,3267,73.6,478,10.8,693,15.6
11,50,13,39,10422,100.0,2583,24.8,8631,82.8,7839,75.2,792,7.6,1791,17.2
11,50,13,40,10785,100.0,1625,15.1,9909,91.9,9160,84.9,749,6.9,876,8.1
11,50,13,41,7710,100.0,1512,19.6,6777,87.9,6198,80.4,579,7.5,933,12.1
12,10,01,01,10970,100.0,6285,57.3,7180,65.5,4685,42.7,2495,22.7,3790,34.5
12,10,01,02,9871,100.0,5084,51.5,6746,68.3,4787,48.5,1959,19.8,3125,31.7
12,10,01,03,7592,100.0,3513,46.3,5565,73.3,4079,53.7,1486,19.6,2027,26.7
12,10,02,04,8856,100.0,4390,49.6,6329,71.5,4466,50.4,1863,21.0,2527,28.5
12,10,02,05,13881,100.0,6692,48.2,9961,71.8,7189,51.8,2772,20.0,3920,28.2
12,10,02,06,4656,100.0,1627,34.9,3762,80.8,3029,65.1,733,15.7,894,19.2
12,20,03,07,2715,100.0,1140,42.0,2025,74.6,1575,58.0,450,16.6,690,25.4
12,20,03,08,5725,100.0,2625,45.9,4277,74.7,3100,54.1,1177,20.6,1448,25.3
12,20,03,09,10931,100.0,6175,56.5,7017,64.2,4756,43.5,2261,20.7,3914,35.8
12,20,03,10,8095,100.0,4887,60.4,5183,64.0,3208,39.6,1975,24.4,2912,36.0
12,20,04,11,342,100.0,231,67.5,192,56.1,111,32.5,81,23.7,150,43.9
12,20,04,12,6375,100.0,2341,36.7,5072,79.6,4034,63.3,1038,16.3,1303,20.4
12,20,04,13,8058,100.0,3459,42.9,6157,76.4,4599,57.1,1558,19.3,1901,23.6
12,20,04,14,1649,100.0,631,38.3,1224,74.2,1018,61.7,206,12.5,425,25.8
12,20,05,15,11071,100.0,2868,25.9,9385,84.8,8203,74.1,1182,10.7,1686,15.2
12,40,06,16,6030,100.0,1005,16.7,5554,92.1,5025,83.3,529,8.8,476,7.9
12,40,06,17,6835,100.0,1019,14.9,6416,93.9,5816,85.1,600,8.8,419,6.1
12,40,06,18,3776,100.0,681,18.0,3488,92.4,3095,82.0,393,10.4,288,7.6
12,40,06,19,7780,100.0,1266,16.3,7168,92.1,6514,83.7,654,8.4,612,7.9
12,40,07,20,8624,100.0,1338,15.5,8046,93.3,7286,84.5,760,8.8,578,6.7
12,40,07,21,8090,100.0,1301,16.1,7440,92.0,6789,83.9,651,8.0,650,8.0
12,40,07,22,8585,100.0,1395,16.2,7883,91.8,7190,83.8,693,8.1,702,8.2
12,40,07,23,8168,100.0,1436,17.6,7460,91.3,6732,82.4,728,8.9,708,8.7
12,50,08,24,9622,100.0,1721,17.9,8756,91.0,7901,82.1,855,8.9,866,9.0
12,50,08,25,6824,100.0,2085,30.6,5427,79.5,4739,69.4,688,10.1,1397,20.5
12,50,09,26,5074,100.0,1517,29.9,4209,83.0,3557,70.1,652,12.8,865,17.0
12,50,09,27,6621,100.0,1803,27.2,5738,86.7,4818,72.8,920,13.9,883,13.3
12,50,09,28,5205,100.0,1132,21.7,4640,89.1,4073,78.3,567,10.9,565,10.9
12,50,09,29,5102,100.0,935,18.3,4751,93.1,4167,81.7,584,11.4,351,6.9
12,50,09,30,10192,100.0,3845,37.7,7661,75.2,6347,62.3,1314,12.9,2531,24.8
12,60,10,31,3268,100.0,1041,31.9,2794,85.5,2227,68.1,567,17.4,474,14.5
12,60,10,32,5978,100.0,3123,52.2,4039,67.6,2855,47.8,1184,19.8,1939,32.4
12,60,11,33,11395,100.0,6088,53.4,8326,73.1,5307,46.6,3019,26.5,3069,26.9
12,60,11,34,15645,100.0,7582,48.5,11740,75.0,8063,51.5,3677,23.5,3905,25.0
12,60,12,35,10650,100.0,6299,59.1,7364,69.1,4351,40.9,3013,28.3,3286,30.9
12,60,12,36,3147,100.0,1429,45.4,2517,80.0,1718,54.6,799,25.4,630,20.0
