district_id,forecast_area_id,district_region_id,planning_area_id,inhabitants,inhabitants_percentage,inhabitants_with_migration_background,inhabitants_with_migration_background_percentage,inhabitants_germans,inhabitants_germans_percentage,inhabitants_germans_without_migration_background,inhabitants_germans_without_migration_background_percentage,inhabitants_germans_with_migration_background,inhabitants_germans_with_migration_background_percentage,inhabitants_foreigners,inhabitants_foreigners_percentage
01,01,11,01,3389,100.0,2023,59.7,2053,60.6,1366,40.3,687,20.3,1336,39.4
01,01,11,02,194,100.0,76,39.2,134,69.1,118,60.8,16,8.2,60,30.9
01,01,11,03,5121,100.0,2969,58.0,3324,64.9,2152,42.0,1172,22.9,1797,35.1
01,01,11,04,4550,100.0,2940,64.6,2797,61.5,1610,35.4,1187,26.1,1753,38.5
01,01,11,05,1559,100.0,1051,67.4,764,49.0,508,32.6,256,16.4,795,51.0
01,01,12,01,2394,100.0,1456,60.8,1397,58.4,938,39.2,459,19.2,997,41.6
01,01,12,02,628,100.0,302,48.1,410,65.3,326,51.9,84,13.4,218,34.7
01,01,12,03,1126,100.0,599,53.2,739,65.6,527,46.8,212,18.8,387,34.4
01,01,12,04,8370,100.0,4283,51.2,5545,66.2,4087,48.8,1458,17.4,2825,33.8
01,01,13,01,6807,100.0,2936,43.1,4742,69.7,3871,56.9,871,12.8,2065,30.3
01,01,13,02,12301,100.0,4929,40.1,9091,73.9,7372,59.9,1719,14.0,3210,26.1
01,01,13,03,9849,100.0,4725,48.0,6469,65.7,5124,52.0,1345,13.7,3380,34.3
01,01,13,04,8743,100.0,3840,43.9,6353,72.7,4903,56.1,1450,16.6,2390,27.3
01,01,13,05,8985,100.0,3877,43.1,6420,71.5,5108,56.9,1312,14.6,2565,28.5
01,01,13,06,10701,100.0,4844,45.3,7467,69.8,5857,54.7,1610,15.0,3234,30.2
01,01,14,01,17788,100.0,7816,43.9,12342,69.4,9972,56.1,2370,13.3,5446,30.6
01,01,14,02,13412,100.0,5391,40.2,9848,73.4,8021,59.8,1827,13.6,3564,26.6
01,02,21,01,3478,100.0,1897,54.5,2194,63.1,1581,45.5,613,17.6,1284,36.9
01,02,21,02,6814,100.0,4286,62.9,3855,56.6,2528,37.1,1327,19.5,2959,43.4
01,02,21,03,269,100.0,219,81.4,110,40.9,50,18.6,60,22.3,159,59.1
01,02,21,04,18606,100.0,9395,50.5,12514,67.3,9211,49.5,3303,17.8,6092,32.7
01,02,21,05,5209,100.0,3047,58.5,3341,64.1,2162,41.5,1179,22.6,1868,35.9
01,02,21,06,11283,100.0,3985,35.3,9057,80.3,7298,64.7,1759,15.6,2226,19.7
01,02,22,01,10846,100.0,5448,50.2,7547,69.6,5398,49.8,2149,19.8,3299,30.4
01,02,22,02,4183,100.0,2741,65.5,2433,58.2,1442,34.5,991,23.7,1750,41.8
01,02,22,03,7017,100.0,4203,59.9,4642,66.2,2814,40.1,1828,26.1,2375,33.8
01,02,22,04,5973,100.0,2578,43.2,4433,74.2,3395,56.8,1038,17.4,1540,25.8
01,02,22,05,3286,100.0,2103,64.0,2208,67.2,1183,36.0,1025,31.2,1078,32.8
01,02,22,06,3061,100.0,1304,42.6,2351,76.8,1757,57.4,594,19.4,710,23.2
01,02,22,07,5669,100.0,2680,47.3,3770,66.5,2989,52.7,781,13.8,1899,33.5
01,03,31,01,26420,100.0,16792,63.6,15555,58.9,9628,36.4,5927,22.4,10865,41.1
01,03,31,02,11654,100.0,7156,61.4,7273,62.4,4498,38.6,2775,23.8,4381,37.6
01,03,32,01,14241,100.0,9484,66.6,9886,69.4,4757,33.4,5129,36.0,4355,30.6
01,03,32,02,10402,100.0,6163,59.2,7282,70.0,4239,40.8,3043,29.3,3120,30.0
01,03,32,03,14529,100.0,9373,64.5,8719,60.0,5156,35.5,3563,24.5,5810,40.0
01,04,41,01,20582,100.0,10243,49.8,14153,68.8,10339,50.2,3814,18.5,6429,31.2
01,04,41,02,16473,100.0,7025,42.6,12381,75.2,9448,57.4,2933,17.8,4092,24.8
01,04,41,03,8721,100.0,4716,54.1,5468,62.7,4005,45.9,1463,16.8,3253,37.3
01,04,42,01,23734,100.0,16239,68.4,13524,57.0,7495,31.6,6029,25.4,10210,43.0
01,04,42,02,16819,100.0,9834,58.5,10033,59.7,6985,41.5,3048,18.1,6786,40.3
01,04,42,03,15731,100.0,9382,59.6,9617,61.1,6349,40.4,3268,20.8,6114,38.9
02,01,01,01,6428,100.0,4502,70.0,3802,59.1,1926,30.0,1876,29.2,2626,40.9
02,01,01,02,13833,100.0,9464,68.4,9149,66.1,4369,31.6,4780,34.6,4684,33.9
02,01,01,03,15234,100.0,10768,70.7,9792,64.3,4466,29.3,5326,35.0,5442,35.7
02,01,01,04,5065,100.0,3299,65.1,3446,68.0,1766,34.9,1680,33.2,1619,32.0
02,02,02,01,1931,100.0,775,40.1,1493,77.3,1156,59.9,337,17.5,438,22.7
02,02,02,02,6062,100.0,2690,44.4,4344,71.7,3372,55.6,972,16.0,1718,28.3
02,02,02,03,10900,100.0,4399,40.4,8194,75.2,6501,59.6,1693,15.5,2706,24.8
02,02,02,04,12562,100.0,5472,43.6,9096,72.4,7090,56.4,2006,16.0,3466,27.6
02,02,02,05,14964,100.0,6276,41.9,11234,75.1,8688,58.1,2546,17.0,3730,24.9
02,02,02,06,18976,100.0,9045,47.7,13598,71.7,9931,52.3,3667,19.3,5378,28.3
02,03,03,01,8847,100.0,5592,63.2,5527,62.5,3255,36.8,2272,25.7,3320,37.5
02,03,03,02,13033,100.0,7121,54.6,8764,67.2,5912,45.4,2852,21.9,4269,32.8
02,03,04,01,15109,100.0,7461,49.4,10320,68.3,7648,50.6,2672,17.7,4789,31.7
02,03,04,02,10979,100.0,5629,51.3,7316,66.6,5350,48.7,1966,17.9,3663,33.4
02,04,05,01,5380,100.0,1625,30.2,4493,83.5,3755,69.8,738,13.7,887,16.5
02,04,05,02,7706,100.0,2563,33.3,6085,79.0,5143,66.7,942,12.2,1621,21.0
02,04,05,03,11355,100.0,3325,29.3,9179,80.8,8030,70.7,1149,10.1,2176,19.2
02,04,07,01,13506,100.0,6172,45.7,9472,70.1,7334,54.3,2138,15.8,4034,29.9
02,04,07,02,11200,100.0,3564,31.8,8679,77.5,7636,68.2,1043,9.3,2521,22.5
02,04,07,03,1113,100.0,761,68.4,444,39.9,352,31.6,92,8.3,669,60.1
02,05,06,01,9174,100.0,3157,34.4,6953,75.8,6017,65.6,936,10.2,2221,24.2
02,05,06,02,22040,100.0,7365,33.4,16908,76.7,14675,66.6,2233,10.1,5132,23.3
02,05,08,01,20669,100.0,7854,38.0,15039,72.8,12815,62.0,2224,10.8,5630,27.2
02,05,08,02,21584,100.0,7624,35.3,16038,74.3,13960,64.7,2078,9.6,5546,25.7
02,05,08,03,7752,100.0,2884,37.2,5696,73.5,4868,62.8,828,10.7,2056,26.5
02,05,08,04,4681,100.0,1054,22.5,4184,89.4,3627,77.5,557,11.9,497,10.6
03,01,01,01,4247,100.0,697,16.4,3806,89.6,3550,83.6,256,6.0,441,10.4
03,01,01,02,12505,100.0,2813,22.5,10334,82.6,9692,77.5,642,5.1,2171,17.4
03,01,01,04,223,100.0,48,21.5,192,86.1,175,78.5,17,7.6,31,13.9
03,02,02,03,2053,100.0,128,6.2,2010,97.9,1925,93.8,85,4.1,43,2.1
03,02,02,09,15177,100.0,2661,17.5,13623,89.8,12516,82.5,1107,7.3,1554,10.2
03,02,02,10,11453,100.0,1850,16.2,10420,91.0,9603,83.8,817,7.1,1033,9.0
03,02,03,07,18308,100.0,2535,13.8,17227,94.1,15773,86.2,1454,7.9,1081,5.9
03,03,04,05,11479,100.0,2191,19.1,10188,88.8,9288,80.9,900,7.8,1291,11.2
03,03,04,06,8199,100.0,751,9.2,7883,96.1,7448,90.8,435,5.3,316,3.9
03,03,07,11,6895,100.0,568,8.2,6660,96.6,6327,91.8,333,4.8,235,3.4
03,03,07,15,7830,100.0,1650,21.1,6687,85.4,6180,78.9,507,6.5,1143,14.6
03,03,07,16,1108,100.0,42,3.8,1090,98.4,1066,96.2,24,2.2,18,1.6
03,04,05,08,4571,100.0,953,20.8,4260,93.2,3618,79.2,642,14.0,311,6.8
03,04,05,12,10343,100.0,1925,18.6,9383,90.7,8418,81.4,965,9.3,960,9.3
03,04,05,13,3430,100.0,617,18.0,3125,91.1,2813,82.0,312,9.1,305,8.9
03,04,06,14,37052,100.0,6298,17.0,33567,90.6,30754,83.0,2813,7.6,3485,9.4
03,04,08,18,35253,100.0,6593,18.7,31083,88.2,28660,81.3,2423,6.9,4170,11.8
03,05,09,19,5087,100.0,687,13.5,4624,90.9,4400,86.5,224,4.4,463,9.1
03,05,09,20,7449,100.0,1188,15.9,6752,90.6,6261,84.1,491,6.6,697,9.4
03,05,09,23,9965,100.0,2490,25.0,8325,83.5,7475,75.0,850,8.5,1640,16.5
03,05,09,24,6339,100.0,1585,25.0,5262,83.0,4754,75.0,508,8.0,1077,17.0
03,05,09,25,9749,100.0,1928,19.8,8531,87.5,7821,80.2,710,7.3,1218,12.5
03,05,10,17,4213,100.0,956,22.7,3547,84.2,3257,77.3,290,6.9,666,15.8
03,05,10,21,6839,100.0,1014,14.8,6172,90.2,5825,85.2,347,5.1,667,9.8
03,05,10,22,4641,100.0,531,11.4,4317,93.0,4110,88.6,207,4.5,324,7.0
03,06,11,26,16167,100.0,5163,31.9,12660,78.3,11004,68.1,1656,10.2,3507,21.7
03,06,11,31,10680,100.0,3742,35.0,8090,75.7,6938,65.0,1152,10.8,2590,24.3
03,06,12,27,14643,100.0,4042,27.6,12003,82.0,10601,72.4,1402,9.6,2640,18.0
03,06,12,28,12745,100.0,3333,26.2,10510,82.5,9412,73.8,1098,8.6,2235,17.5
03,06,13,32,22680,100.0,7389,32.6,17787,78.4,15291,67.4,2496,11.0,4893,21.6
03,06,14,29,9989,100.0,1861,18.6,8871,88.8,8128,81.4,743,7.4,1118,11.2
03,06,14,30,3981,100.0,1681,42.2,2607,65.5,2300,57.8,307,7.7,1374,34.5
03,06,14,34,6462,100.0,1941,30.0,5084,78.7,4521,70.0,563,8.7,1378,21.3
03,06,14,35,4005,100.0,1234,30.8,3172,79.2,2771,69.2,401,10.0,833,20.8
03,06,14,41,2787,100.0,788,28.3,2378,85.3,1999,71.7,379,13.6,409,14.7
03,07,15,36,11255,100.0,4289,38.1,8375,74.4,6966,61.9,1409,12.5,2880,25.6
03,07,15,37,15999,100.0,5753,36.0,12043,75.3,10246,64.0,1797,11.2,3956,24.7
03,07,16,33,3137,100.0,983,31.3,2488,79.3,2154,68.7,334,10.6,649,20.7
03,07,16,38,17650,100.0,5851,33.2,13778,78.1,11799,66.8,1979,11.2,3872,21.9
03,07,16,39,12866,100.0,3631,28.2,10605,82.4,9235,71.8,1370,10.6,2261,17.6
04,01,01,01,10801,100.0,5380,49.8,7663,70.9,5421,50.2,2242,20.8,3138,29.1
04,01,01,02,826,100.0,367,44.4,520,63.0,459,55.6,61,7.4,306,37.0
04,01,01,03,7967,100.0,4448,55.8,5721,71.8,3519,44.2,2202,27.6,2246,28.2
04,02,02,04,185,100.0,76,41.1,144,77.8,109,58.9,35,18.9,41,22.2
04,02,02,05,1290,100.0,330,25.6,1111,86.1,960,74.4,151,11.7,179,13.9
04,02,02,06,2908,100.0,917,31.5,2318,79.7,1991,68.5,327,11.2,590,20.3
04,02,02,07,2536,100.0,804,31.7,2057,81.1,1732,68.3,325,12.8,479,18.9
04,02,02,08,2977,100.0,823,27.6,2549,85.6,2154,72.4,395,13.3,428,14.4
04,02,02,09,3195,100.0,1250,39.1,2228,69.7,1945,60.9,283,8.9,967,30.3
04,02,03,10,810,100.0,540,66.7,342,42.2,270,33.3,72,8.9,468,57.8
04,02,03,11,14963,100.0,5078,33.9,11958,79.9,9885,66.1,2073,13.9,3005,20.1
04,02,03,12,5596,100.0,1887,33.7,4426,79.1,3709,66.3,717,12.8,1170,20.9
04,02,03,13,7234,100.0,2759,38.1,5580,77.1,4475,61.9,1105,15.3,1654,22.9
04,02,03,14,7,100.0,7,100.0,0,0.0,0,0.0,0,0.0,7,100.0
04,03,04,15,3219,100.0,1783,55.4,1864,57.9,1436,44.6,428,13.3,1355,42.1
04,03,04,16,10499,100.0,5127,48.8,7676,73.1,5372,51.2,2304,21.9,2823,26.9
04,03,04,17,10925,100.0,4295,39.3,8362,76.5,6630,60.7,1732,15.9,2563,23.5
04,03,05,18,9612,100.0,4492,46.7,6895,71.7,5120,53.3,1775,18.5,2717,28.3
04,03,05,19,5951,100.0,2779,46.7,4291,72.1,3172,53.3,1119,18.8,1660,27.9
04,03,06,20,8858,100.0,4038,45.6,6451,72.8,4820,54.4,1631,18.4,2407,27.2
04,03,06,21,3340,100.0,1989,59.6,2078,62.2,1351,40.4,727,21.8,1262,37.8
04,03,06,22,10866,100.0,5255,48.4,7788,71.7,5611,51.6,2177,20.0,3078,28.3
04,03,06,23,5063,100.0,2909,57.5,3386,66.9,2154,42.5,1232,24.3,1677,33.1
04,03,07,24,6557,100.0,2580,39.3,4976,75.9,3977,60.7,999,15.2,1581,24.1
04,03,07,25,12267,100.0,5099,41.6,9036,73.7,7168,58.4,1868,15.2,3231,26.3
04,03,07,26,5700,100.0,2644,46.4,4058,71.2,3056,53.6,1002,17.6,1642,28.8
04,03,08,27,12282,100.0,6783,55.2,7848,63.9,5499,44.8,2349,19.1,4434,36.1
04,03,08,28,9680,100.0,4536,46.9,6707,69.3,5144,53.1,1563,16.1,2973,30.7
04,03,09,29,6065,100.0,2689,44.3,4417,72.8,3376,55.7,1041,17.2,1648,27.2
04,03,09,30,5644,100.0,2636,46.7,3994,70.8,3008,53.3,986,17.5,1650,29.2
04,03,09,31,3708,100.0,2186,59.0,2223,60.0,1522,41.0,701,18.9,1485,40.0
04,03,10,32,15705,100.0,6969,44.4,11472,73.0,8736,55.6,2736,17.4,4233,27.0
04,04,11,33,112,100.0,79,70.5,39,34.8,33,29.5,6,5.4,73,65.2
04,04,11,34,5353,100.0,2247,42.0,4139,77.3,3106,58.0,1033,19.3,1214,22.7
04,04,11,35,2788,100.0,1037,37.2,2224,79.8,1751,62.8,473,17.0,564,20.2
04,04,11,36,3159,100.0,1159,36.7,2536,80.3,2000,63.3,536,17.0,623,19.7
04,04,11,37,8288,100.0,3310,39.9,6475,78.1,4978,60.1,1497,18.1,1813,21.9
04,04,12,38,6058,100.0,2193,36.2,5006,82.6,3865,63.8,1141,18.8,1052,17.4
04,04,12,39,536,100.0,373,69.6,244,45.5,163,30.4,81,15.1,292,54.5
04,04,12,40,1542,100.0,442,28.7,1320,85.6,1100,71.3,220,14.3,222,14.4
04,04,12,41,7071,100.0,1896,26.8,6015,85.1,5175,73.2,840,11.9,1056,14.9
04,04,13,42,4194,100.0,1523,36.3,3352,79.9,2671,63.7,681,16.2,842,20.1
04,04,13,43,3587,100.0,1166,32.5,2991,83.4,2421,67.5,570,15.9,596,16.6
04,04,13,44,10747,100.0,3116,29.0,8917,83.0,7631,71.0,1286,12.0,1830,17.0
04,05,14,45,6448,100.0,2953,45.8,4860,75.4,3495,54.2,1365,21.2,1588,24.6
04,05,14,46,10951,100.0,4949,45.2,8068,73.7,6002,54.8,2066,18.9,2883,26.3
04,05,14,47,5307,100.0,2292,43.2,3949,74.4,3015,56.8,934,17.6,1358,25.6
04,05,14,48,9416,100.0,4572,48.6,6504,69.1,4844,51.4,1660,17.6,2912,30.9
04,05,15,49,4742,100.0,2171,45.8,3374,71.2,2571,54.2,803,16.9,1368,28.8
04,05,15,50,5665,100.0,2479,43.8,4148,73.2,3186,56.2,962,17.0,1517,26.8
04,05,15,51,4523,100.0,2044,45.2,3339,73.8,2479,54.8,860,19.0,1184,26.2
04,05,16,52,9867,100.0,4038,40.9,7349,74.5,5829,59.1,1520,15.4,2518,25.5
04,05,16,53,7027,100.0,3110,44.3,5130,73.0,3917,55.7,1213,17.3,1897,27.0
04,05,16,54,3110,100.0,1193,38.4,2396,77.0,1917,61.6,479,15.4,714,23.0
04,05,16,55,7469,100.0,3367,45.1,5486,73.5,4102,54.9,1384,18.5,1983,26.5
04,05,16,56,7689,100.0,2605,33.9,6169,80.2,5084,66.1,1085,14.1,1520,19.8
04,06,17,57,65,100.0,13,20.0,52,80.0,52,80.0,0,0.0,13,20.0
05,01,01,01,10613,100.0,3197,30.1,9053,85.3,7416,69.9,1637,15.4,1560,14.7
05,01,01,02,8443,100.0,3093,36.6,6519,77.2,5350,63.4,1169,13.8,1924,22.8
05,01,01,03,7609,100.0,1518,20.0,6894,90.6,6091,80.0,803,10.6,715,9.4
05,01,02,04,3612,100.0,1613,44.7,2682,74.3,1999,55.3,683,18.9,930,25.7
05,01,02,05,2293,100.0,627,27.3,2049,89.4,1666,72.7,383,16.7,244,10.6
05,01,02,06,10681,100.0,4613,43.2,8161,76.4,6068,56.8,2093,19.6,2520,23.6
05,01,02,07,11592,100.0,6035,52.1,8827,76.1,5557,47.9,3270,28.2,2765,23.9
05,01,02,08,7669,100.0,2812,36.7,5959,77.7,4857,63.3,1102,14.4,1710,22.3
05,01,02,09,6080,100.0,2007,33.0,5100,83.9,4073,67.0,1027,16.9,980,16.1
05,01,03,10,3973,100.0,1596,40.2,2975,74.9,2377,59.8,598,15.1,998,25.1
05,01,03,11,5622,100.0,2875,51.1,4238,75.4,2747,48.9,1491,26.5,1384,24.6
05,01,03,12,7363,100.0,4290,58.3,4240,57.6,3073,41.7,1167,15.8,3123,42.4
05,01,03,13,6802,100.0,2991,44.0,4920,72.3,3811,56.0,1109,16.3,1882,27.7
05,01,03,14,12364,100.0,4993,40.4,9537,77.1,7371,59.6,2166,17.5,2827,22.9
05,01,03,39,944,100.0,643,68.1,365,38.7,301,31.9,64,6.8,579,61.3
05,02,04,15,3824,100.0,835,21.8,3577,93.5,2989,78.2,588,15.4,247,6.5
05,02,04,16,1679,100.0,98,5.8,1660,98.9,1581,94.2,79,4.7,19,1.1
05,02,04,17,5814,100.0,1781,30.6,4980,85.7,4033,69.4,947,16.3,834,14.3
05,02,04,18,4329,100.0,1191,27.5,3611,83.4,3138,72.5,473,10.9,718,16.6
05,02,04,19,7237,100.0,2340,32.3,5978,82.6,4897,67.7,1081,14.9,1259,17.4
05,02,04,20,1087,100.0,204,18.8,998,91.8,883,81.2,115,10.6,89,8.2
05,02,05,21,3270,100.0,914,28.0,2924,89.4,2356,72.0,568,17.4,346,10.6
05,02,05,22,7630,100.0,3754,49.2,5213,68.3,3876,50.8,1337,17.5,2417,31.7
05,02,05,23,12617,100.0,7645,60.6,8487,67.3,4972,39.4,3515,27.9,4130,32.7
05,02,05,24,6270,100.0,1478,23.6,5559,88.7,4792,76.4,767,12.2,711,11.3
05,02,06,25,7582,100.0,2927,38.6,5826,76.8,4655,61.4,1171,15.4,1756,23.2
05,02,06,26,18217,100.0,6651,36.5,14075,77.3,11566,63.5,2509,13.8,4142,22.7
05,02,06,27,4395,100.0,2043,46.5,3093,70.4,2352,53.5,741,16.9,1302,29.6
05,02,06,28,2001,100.0,543,27.1,1747,87.3,1458,72.9,289,14.4,254,12.7
05,02,06,29,4426,100.0,714,16.1,4104,92.7,3712,83.9,392,8.9,322,7.3
05,03,07,30,4136,100.0,2291,55.4,3347,80.9,1845,44.6,1502,36.3,789,19.1
05,03,07,31,11595,100.0,5092,43.9,9106,78.5,6503,56.1,2603,22.4,2489,21.5
05,03,08,32,12252,100.0,5856,47.8,8879,72.5,6396,52.2,2483,20.3,3373,27.5
05,03,08,33,490,100.0,241,49.2,362,73.9,249,50.8,113,23.1,128,26.1
05,04,09,34,3410,100.0,845,24.8,2946,86.4,2565,75.2,381,11.2,464,13.6
05,04,09,35,446,100.0,106,23.8,380,85.2,340,76.2,40,9.0,66,14.8
05,04,09,36,10188,100.0,1825,17.9,9593,94.2,8363,82.1,1230,12.1,595,5.8
05,04,09,37,2219,100.0,376,16.9,2075,93.5,1843,83.1,232,10.5,144,6.5
05,04,09,38,3684,100.0,548,14.9,3474,94.3,3136,85.1,338,9.2,210,5.7
06,01,01,01,6924,100.0,1866,26.9,5975,86.3,5058,73.1,917,13.2,949,13.7
06,01,01,02,8889,100.0,3229,36.3,7179,80.8,5660,63.7,1519,17.1,1710,19.2
06,01,01,03,6340,100.0,2049,32.3,5302,83.6,4291,67.7,1011,15.9,1038,16.4
06,01,02,04,6885,100.0,2436,35.4,5656,82.1,4449,64.6,1207,17.5,1229,17.9
06,01,02,05,9814,100.0,3268,33.3,8103,82.6,6546,66.7,1557,15.9,1711,17.4
06,01,02,06,7733,100.0,2318,30.0,6536,84.5,5415,70.0,1121,14.5,1197,15.5
06,01,02,07,7964,100.0,2714,34.1,6517,81.8,5250,65.9,1267,15.9,1447,18.2
06,01,02,08,6879,100.0,2160,31.4,5763,83.8,4719,68.6,1044,15.2,1116,16.2
06,01,02,09,9274,100.0,3277,35.3,7518,81.1,5997,64.7,1521,16.4,1756,18.9
06,01,02,10,4850,100.0,1398,28.8,4105,84.6,3452,71.2,653,13.5,745,15.4
06,02,03,01,4957,100.0,1184,23.9,4404,88.8,3773,76.1,631,12.7,553,11.2
06,02,03,02,6079,100.0,1933,31.8,4940,81.3,4146,68.2,794,13.1,1139,18.7
06,02,03,03,7386,100.0,2324,31.5,6167,83.5,5062,68.5,1105,15.0,1219,16.5
06,02,03,04,7279,100.0,2203,30.3,6175,84.8,5076,69.7,1099,15.1,1104,15.2
06,02,03,05,11447,100.0,4014,35.1,9320,81.4,7433,64.9,1887,16.5,2127,18.6
06,02,03,06,6353,100.0,1248,19.6,5810,91.5,5105,80.4,705,11.1,543,8.5
06,02,04,07,4618,100.0,2302,49.8,3432,74.3,2316,50.2,1116,24.2,1186,25.7
06,02,04,08,6981,100.0,2020,28.9,5887,84.3,4961,71.1,926,13.3,1094,15.7
06,02,04,09,8352,100.0,2189,26.2,7141,85.5,6163,73.8,978,11.7,1211,14.5
06,02,04,10,7010,100.0,1467,20.9,6166,88.0,5543,79.1,623,8.9,844,12.0
06,02,04,11,8624,100.0,2307,26.8,7528,87.3,6317,73.2,1211,14.0,1096,12.7
06,03,05,01,5715,100.0,1385,24.2,4865,85.1,4330,75.8,535,9.4,850,14.9
06,03,05,02,5591,100.0,1382,24.7,4865,87.0,4209,75.3,656,11.7,726,13.0
06,03,05,03,11725,100.0,3471,29.6,9939,84.8,8254,70.4,1685,14.4,1786,15.2
06,03,05,04,11119,100.0,2570,23.1,9872,88.8,8549,76.9,1323,11.9,1247,11.2
06,03,06,05,7107,100.0,1998,28.1,6030,84.8,5109,71.9,921,13.0,1077,15.2
06,03,06,06,5608,100.0,2187,39.0,4220,75.2,3421,61.0,799,14.2,1388,24.8
06,03,06,07,3133,100.0,1165,37.2,2305,73.6,1968,62.8,337,10.8,828,26.4
06,03,06,08,13729,100.0,3946,28.7,11896,86.6,9783,71.3,2113,15.4,1833,13.4
06,03,06,09,12100,100.0,3070,25.4,10447,86.3,9030,74.6,1417,11.7,1653,13.7
06,03,06,10,8485,100.0,2022,23.8,7408,87.3,6463,76.2,945,11.1,1077,12.7
06,04,07,01,10264,100.0,2367,23.1,8960,87.3,7897,76.9,1063,10.4,1304,12.7
06,04,07,02,5487,100.0,1322,24.1,4820,87.8,4165,75.9,655,11.9,667,12.2
06,04,07,03,10949,100.0,3135,28.6,8846,80.8,7814,71.4,1032,9.4,2103,19.2
06,04,08,04,7484,100.0,1384,18.5,6822,91.2,6100,81.5,722,9.6,662,8.8
06,04,08,05,5293,100.0,1213,22.9,4697,88.7,4080,77.1,617,11.7,596,11.3
06,04,08,06,7318,100.0,1253,17.1,6702,91.6,6065,82.9,637,8.7,616,8.4
06,04,08,07,5984,100.0,1486,24.8,5254,87.8,4498,75.2,756,12.6,730,12.2
06,04,08,08,4778,100.0,1771,37.1,4096,85.7,3007,62.9,1089,22.8,682,14.3
06,04,08,09,4957,100.0,1538,31.0,4043,81.6,3419,69.0,624,12.6,914,18.4
06,04,08,10,7118,100.0,2310,32.5,5869,82.5,4808,67.5,1061,14.9,1249,17.5
07,01,01,01,10002,100.0,4983,49.8,7010,70.1,5019,50.2,1991,19.9,2992,29.9
07,01,01,02,16541,100.0,9481,57.3,10708,64.7,7060,42.7,3648,22.1,5833,35.3
07,01,01,03,10591,100.0,4232,40.0,8058,76.1,6359,60.0,1699,16.0,2533,23.9
07,01,01,04,13654,100.0,7709,56.5,9133,66.9,5945,43.5,3188,23.3,4521,33.1
07,02,02,01,10669,100.0,3861,36.2,8569,80.3,6808,63.8,1761,16.5,2100,19.7
07,02,02,02,10499,100.0,4752,45.3,7625,72.6,5747,54.7,1878,17.9,2874,27.4
07,02,02,03,17994,100.0,8001,44.5,13342,74.1,9993,55.5,3349,18.6,4652,25.9
07,02,02,04,12186,100.0,4561,37.4,9556,78.4,7625,62.6,1931,15.8,2630,21.6
07,03,03,01,24713,100.0,7095,28.7,20816,84.2,17618,71.3,3198,12.9,3897,15.8
07,03,03,02,9440,100.0,3061,32.4,7840,83.1,6379,67.6,1461,15.5,1600,16.9
07,03,03,03,12350,100.0,5475,44.3,9547,77.3,6875,55.7,2672,21.6,2803,22.7
07,04,04,01,17586,100.0,6817,38.8,14299,81.3,10769,61.2,3530,20.1,3287,18.7
07,04,04,02,2311,100.0,500,21.6,2073,89.7,1811,78.4,262,11.3,238,10.3
07,04,04,03,24597,100.0,9613,39.1,19321,78.6,14984,60.9,4337,17.6,5276,21.4
07,04,04,04,5106,100.0,1432,28.0,4418,86.5,3674,72.0,744,14.6,688,13.5
07,04,04,05,11232,100.0,5144,45.8,8250,73.5,6088,54.2,2162,19.2,2982,26.5
07,04,04,06,4039,100.0,2301,57.0,2588,64.1,1738,43.0,850,21.0,1451,35.9
07,05,05,01,17124,100.0,7107,41.5,13399,78.2,10017,58.5,3382,19.8,3725,21.8
07,05,05,02,8158,100.0,3233,39.6,6265,76.8,4925,60.4,1340,16.4,1893,23.2
07,05,05,03,9130,100.0,3069,33.6,7655,83.8,6061,66.4,1594,17.5,1475,16.2
07,05,05,04,5671,100.0,1907,33.6,4809,84.8,3764,66.4,1045,18.4,862,15.2
07,05,05,05,10713,100.0,3211,30.0,9217,86.0,7502,70.0,1715,16.0,1496,14.0
07,05,05,06,2247,100.0,537,23.9,2025,90.1,1710,76.1,315,14.0,222,9.9
07,06,06,01,10305,100.0,4426,43.0,7785,75.5,5879,57.0,1906,18.5,2520,24.5
07,06,06,02,4774,100.0,1240,26.0,4227,88.5,3534,74.0,693,14.5,547,11.5
07,06,06,03,2842,100.0,1103,38.8,2353,82.8,1739,61.2,614,21.6,489,17.2
07,06,06,04,14480,100.0,5649,39.0,12207,84.3,8831,61.0,3376,23.3,2273,15.7
07,07,07,01,10525,100.0,2404,22.8,9433,89.6,8121,77.2,1312,12.5,1092,10.4
07,07,07,02,10930,100.0,2473,22.6,9966,91.2,8457,77.4,1509,13.8,964,8.8
07,07,07,03,8332,100.0,2474,29.7,7185,86.2,5858,70.3,1327,15.9,1147,13.8
07,07,07,04,8473,100.0,3372,39.8,6556,77.4,5101,60.2,1455,17.2,1917,22.6
07,07,07,05,7006,100.0,1327,18.9,6428,91.7,5679,81.1,749,10.7,578,8.3
07,07,07,06,3881,100.0,862,22.2,3367,86.8,3019,77.8,348,9.0,514,13.2
07,07,07,07,2961,100.0,557,18.8,2679,90.5,2404,81.2,275,9.3,282,9.5
08,01,01,15,938,100.0,420,44.8,665,70.9,518,55.2,147,15.7,273,29.1
08,01,01,16,3614,100.0,2123,58.7,2198,60.8,1491,41.3,707,19.6,1416,39.2
08,01,01,17,15798,100.0,8188,51.8,10333,65.4,7610,48.2,2723,17.2,5465,34.6
08,01,01,18,12044,100.0,7386,61.3,7533,62.5,4658,38.7,2875,23.9,4511,37.5
08,01,02,11,9824,100.0,5775,58.8,6033,61.4,4049,41.2,1984,20.2,3791,38.6
08,01,02,12,7397,100.0,5023,67.9,4859,65.7,2374,32.1,2485,33.6,2538,34.3
08,01,02,13,12248,100.0,6765,55.2,7983,65.2,5483,44.8,2500,20.4,4265,34.8
08,01,02,14,8570,100.0,5103,59.5,5120,59.7,3467,40.5,1653,19.3,3450,40.3
08,01,03,01,27355,100.0,13664,50.0,18629,68.1,13691,50.0,4938,18.1,8726,31.9
08,01,03,02,3852,100.0,1459,37.9,2997,77.8,2393,62.1,604,15.7,855,22.2
08,01,03,03,8306,100.0,5063,61.0,4962,59.7,3243,39.0,1719,20.7,3344,40.3
08,01,04,04,23143,100.0,12366,53.4,15191,65.6,10777,46.6,4414,19.1,7952,34.4
08,01,04,05,8894,100.0,4265,48.0,6155,69.2,4629,52.0,1526,17.2,2739,30.8
08,01,04,06,7073,100.0,4250,60.1,4267,60.3,2823,39.9,1444,20.4,2806,39.7
08,01,04,07,794,100.0,345,43.5,568,71.5,449,56.5,119,15.0,226,28.5
08,01,05,08,5734,100.0,4199,73.2,3654,63.7,1535,26.8,2119,37.0,2080,36.3
08,01,05,09,9226,100.0,6089,66.0,6596,71.5,3137,34.0,3459,37.5,2630,28.5
08,01,05,10,466,100.0,315,67.6,233,50.0,151,32.4,82,17.6,233,50.0
08,02,06,19,11702,100.0,6584,56.3,7728,66.0,5118,43.7,2610,22.3,3974,34.0
08,02,06,20,9316,100.0,4288,46.0,7196,77.2,5028,54.0,2168,23.3,2120,22.8
08,02,06,21,2329,100.0,620,26.6,2141,91.9,1709,73.4,432,18.5,188,8.1
08,02,06,22,14270,100.0,4181,29.3,12323,86.4,10089,70.7,2234,15.7,1947,13.6
08,02,06,23,1259,100.0,418,33.2,1070,85.0,841,66.8,229,18.2,189,15.0
08,02,06,24,1400,100.0,523,37.4,1224,87.4,877,62.6,347,24.8,176,12.6
08,02,06,25,3336,100.0,1064,31.9,2806,84.1,2272,68.1,534,16.0,530,15.9
08,02,07,26,8314,100.0,2275,27.4,7351,88.4,6039,72.6,1312,15.8,963,11.6
08,02,07,27,11612,100.0,3573,30.8,10090,86.9,8039,69.2,2051,17.7,1522,13.1
08,02,07,28,8801,100.0,4040,45.9,6780,77.0,4761,54.1,2019,22.9,2021,23.0
08,03,08,29,12533,100.0,6578,52.5,9851,78.6,5955,47.5,3896,31.1,2682,21.4
08,03,08,30,7279,100.0,3111,42.7,6040,83.0,4168,57.3,1872,25.7,1239,17.0
08,03,08,31,17680,100.0,9394,53.1,13819,78.2,8286,46.9,5533,31.3,3861,21.8
08,04,09,32,2821,100.0,948,33.6,2440,86.5,1873,66.4,567,20.1,381,13.5
08,04,09,33,4126,100.0,1397,33.9,3535,85.7,2729,66.1,806,19.5,591,14.3
08,04,09,34,2670,100.0,913,34.2,2282,85.5,1757,65.8,525,19.7,388,14.5
08,04,10,35,8288,100.0,2965,35.8,7001,84.5,5323,64.2,1678,20.2,1287,15.5
08,04,10,36,6865,100.0,1757,25.6,6146,89.5,5108,74.4,1038,15.1,719,10.5
08,04,10,37,9955,100.0,2877,28.9,8620,86.6,7078,71.1,1542,15.5,1335,13.4
08,04,10,38,7080,100.0,1732,24.5,6520,92.1,5348,75.5,1172,16.6,560,7.9
08,04,10,39,3807,100.0,1141,30.0,3426,90.0,2666,70.0,760,20.0,381,10.0
08,04,10,40,7947,100.0,2104,26.5,7060,88.8,5843,73.5,1217,15.3,887,11.2
09,01,01,01,12993,100.0,4253,32.7,10443,80.4,8740,67.3,1703,13.1,2550,19.6
09,01,01,02,68,100.0,12,17.6,56,82.4,56,82.4,0,0.0,12,17.6
09,01,02,01,4360,100.0,814,18.7,3919,89.9,3546,81.3,373,8.6,441,10.1
09,01,02,02,6944,100.0,1315,18.9,6094,87.8,5629,81.1,465,6.7,850,12.2
09,01,03,01,15773,100.0,2787,17.7,14106,89.4,12986,82.3,1120,7.1,1667,10.6
09,01,03,02,3121,100.0,952,30.5,2582,82.7,2169,69.5,413,13.2,539,17.3
09,01,04,01,8435,100.0,1039,12.3,7848,93.0,7396,87.7,452,5.4,587,7.0
09,01,04,02,11406,100.0,1871,16.4,10482,91.9,9535,83.6,947,8.3,924,8.1
09,02,05,01,7532,100.0,2415,32.1,5714,75.9,5117,67.9,597,7.9,1818,24.1
09,02,05,02,15881,100.0,3753,23.6,13328,83.9,12128,76.4,1200,7.6,2553,16.1
09,02,06,01,9248,100.0,2820,30.5,7078,76.5,6428,69.5,650,7.0,2170,23.5
09,02,06,02,3584,100.0,340,9.5,3395,94.7,3244,90.5,151,4.2,189,5.3
09,02,07,01,2919,100.0,1197,41.0,2035,69.7,1722,59.0,313,10.7,884,30.3
09,02,07,02,16937,100.0,3275,19.3,14628,86.4,13662,80.7,966,5.7,2309,13.6
09,02,08,01,2973,100.0,313,10.5,2775,93.3,2660,89.5,115,3.9,198,6.7
09,02,08,02,8268,100.0,1815,22.0,6975,84.4,6453,78.0,522,6.3,1293,15.6
09,03,09,01,14234,100.0,2165,15.2,13289,93.4,12069,84.8,1220,8.6,945,6.6
09,03,09,02,5642,100.0,928,16.4,5106,90.5,4714,83.6,392,6.9,536,9.5
09,03,09,03,8198,100.0,1697,20.7,7392,90.2,6501,79.3,891,10.9,806,9.8
09,03,10,01,13118,100.0,1811,13.8,12032,91.7,11307,86.2,725,5.5,1086,8.3
09,03,11,01,6885,100.0,975,14.2,6302,91.5,5910,85.8,392,5.7,583,8.5
09,03,12,01,1847,100.0,201,10.9,1776,96.2,1646,89.1,130,7.0,71,3.8
09,03,12,02,2586,100.0,272,10.5,2458,95.1,2314,89.5,144,5.6,128,4.9
09,04,13,01,10111,100.0,681,6.7,9774,96.7,9430,93.3,344,3.4,337,3.3
09,04,13,02,1911,100.0,194,10.2,1824,95.4,1717,89.8,107,5.6,87,4.6
09,04,14,01,5454,100.0,501,9.2,5232,95.9,4953,90.8,279,5.1,222,4.1
09,04,14,02,1541,100.0,233,15.1,1417,92.0,1308,84.9,109,7.1,124,8.0
09,04,14,03,4418,100.0,609,13.8,4015,90.9,3809,86.2,206,4.7,403,9.1
09,04,15,01,7263,100.0,1434,19.7,6340,87.3,5829,80.3,511,7.0,923,12.7
09,04,16,01,6764,100.0,543,8.0,6542,96.7,6221,92.0,321,4.7,222,3.3
09,05,17,01,4062,100.0,446,11.0,3782,93.1,3616,89.0,166,4.1,280,6.9
09,05,17,02,14944,100.0,1297,8.7,14326,95.9,13647,91.3,679,4.5,618,4.1
09,05,18,01,9557,100.0,952,10.0,9053,94.7,8605,90.0,448,4.7,504,5.3
09,05,19,01,11621,100.0,1725,14.8,10503,90.4,9896,85.2,607,5.2,1118,9.6
09,05,20,01,13219,100.0,1255,9.5,12530,94.8,11964,90.5,566,4.3,689,5.2
10,01,01,01,5676,100.0,1549,27.3,4809,84.7,4127,72.7,682,12.0,867,15.3
10,01,01,02,18508,100.0,5042,27.2,15976,86.3,13466,72.8,2510,13.6,2532,13.7
10,01,02,03,1253,100.0,803,64.1,507,40.5,450,35.9,57,4.5,746,59.5
10,01,02,04,10622,100.0,2701,25.4,9278,87.3,7921,74.6,1357,12.8,1344,12.7
10,01,02,05,8151,100.0,1404,17.2,7346,90.1,6747,82.8,599,7.3,805,9.9
10,01,02,06,17341,100.0,4524,26.1,14644,84.4,12817,73.9,1827,10.5,2697,15.6
10,01,02,07,10612,100.0,2693,25.4,9354,88.1,7919,74.6,1435,13.5,1258,11.9
10,01,03,08,2190,100.0,610,27.9,1840,84.0,1580,72.1,260,11.9,350,16.0
10,01,03,09,14564,100.0,3604,24.7,12950,88.9,10960,75.3,1990,13.7,1614,11.1
10,01,03,10,18290,100.0,4397,24.0,16041,87.7,13893,76.0,2148,11.7,2249,12.3
10,01,03,11,3694,100.0,537,14.5,3504,94.9,3157,85.5,347,9.4,190,5.1
10,02,04,12,7206,100.0,2365,32.8,5848,81.2,4841,67.2,1007,14.0,1358,18.8
10,02,04,13,16062,100.0,3807,23.7,13457,83.8,12255,76.3,1202,7.5,2605,16.2
10,02,04,14,1713,100.0,825,48.2,1273,74.3,888,51.8,385,22.5,440,25.7
10,02,04,15,6240,100.0,2288,36.7,4424,70.9,3952,63.3,472,7.6,1816,29.1
10,02,04,16,5949,100.0,1836,30.9,4673,78.6,4113,69.1,560,9.4,1276,21.4
10,02,05,17,9806,100.0,1746,17.8,8663,88.3,8060,82.2,603,6.1,1143,11.7
10,02,05,18,5321,100.0,1253,23.5,4475,84.1,4068,76.5,407,7.6,846,15.9
10,02,05,19,6113,100.0,2018,33.0,4725,77.3,4095,67.0,630,10.3,1388,22.7
10,02,06,20,3417,100.0,657,19.2,3074,90.0,2760,80.8,314,9.2,343,10.0
10,02,06,21,6336,100.0,1465,23.1,5395,85.1,4871,76.9,524,8.3,941,14.9
10,02,06,22,8544,100.0,1230,14.4,7948,93.0,7314,85.6,634,7.4,596,7.0
10,02,06,23,6475,100.0,886,13.7,6075,93.8,5589,86.3,486,7.5,400,6.2
10,03,07,24,7815,100.0,1422,18.2,6894,88.2,6393,81.8,501,6.4,921,11.8
10,03,07,25,6781,100.0,1509,22.3,5901,87.0,5272,77.7,629,9.3,880,13.0
10,03,07,26,3621,100.0,583,16.1,3339,92.2,3038,83.9,301,8.3,282,7.8
10,03,07,27,10148,100.0,1197,11.8,9698,95.6,8951,88.2,747,7.4,450,4.4
10,04,08,28,7765,100.0,701,9.0,7433,95.7,7064,91.0,369,4.8,332,4.3
10,04,08,29,3920,100.0,443,11.3,3643,92.9,3477,88.7,166,4.2,277,7.1
10,04,08,30,7674,100.0,547,7.1,7491,97.6,7127,92.9,364,4.7,183,2.4
10,04,09,31,9854,100.0,881,8.9,9501,96.4,8973,91.1,528,5.4,353,3.6
10,04,09,32,4332,100.0,446,10.3,4113,94.9,3886,89.7,227,5.2,219,5.1
10,04,09,33,15318,100.0,1187,7.7,14842,96.9,14131,92.3,711,4.6,476,3.1
11,01,01,01,634,100.0,79,12.5,582,91.8,555,87.5,27,4.3,52,8.2
11,01,01,02,2655,100.0,186,7.0,2572,96.9,2469,93.0,103,3.9,83,3.1
11,01,01,03,2115,100.0,697,33.0,1568,74.1,1418,67.0,150,7.1,547,25.9
11,01,02,04,8999,100.0,2909,32.3,7199,80.0,6090,67.7,1109,12.3,1800,20.0
11,01,02,05,7080,100.0,2360,33.3,5601,79.1,4720,66.7,881,12.4,1479,20.9
11,01,02,06,6138,100.0,1695,27.6,5022,81.8,4443,72.4,579,9.4,1116,18.2
11,01,02,07,7487,100.0,2053,27.4,6046,80.8,5434,72.6,612,8.2,1441,19.2
11,01,03,08,11653,100.0,3465,29.7,9619,82.5,8188,70.3,1431,12.3,2034,17.5
11,01,03,09,9661,100.0,2765,28.6,7957,82.4,6896,71.4,1061,11.0,1704,17.6
11,01,03,10,5739,100.0,1193,20.8,4936,86.0,4546,79.2,390,6.8,803,14.0
11,02,04,11,9873,100.0,2974,30.1,7672,77.7,6899,69.9,773,7.8,2201,22.3
11,02,04,12,6758,100.0,1494,22.1,5872,86.9,5264,77.9,608,9.0,886,13.1
11,02,05,13,3923,100.0,841,21.4,3281,83.6,3082,78.6,199,5.1,642,16.4
11,02,05,14,9809,100.0,2540,25.9,7887,80.4,7269,74.1,618,6.3,1922,19.6
11,02,05,15,14985,100.0,4255,28.4,12397,82.7,10730,71.6,1667,11.1,2588,17.3
11,02,05,16,4107,100.0,786,19.1,3704,90.2,3321,80.9,383,9.3,403,9.8
11,03,06,17,6247,100.0,2326,37.2,4776,76.5,3921,62.8,855,13.7,1471,23.5
11,03,06,18,16454,100.0,4850,29.5,13426,81.6,11604,70.5,1822,11.1,3028,18.4
11,03,06,19,11274,100.0,3758,33.3,8994,79.8,7516,66.7,1478,13.1,2280,20.2
11,03,07,20,6312,100.0,3582,56.7,3140,49.7,2730,43.3,410,6.5,3172,50.3
11,03,07,21,25108,100.0,6745,26.9,20584,82.0,18363,73.1,2221,8.8,4524,18.0
11,03,08,24,9997,100.0,3719,37.2,7689,76.9,6278,62.8,1411,14.1,2308,23.1
11,04,09,25,4232,100.0,1057,25.0,3542,83.7,3175,75.0,367,8.7,690,16.3
11,04,09,26,29670,100.0,7151,24.1,24868,83.8,22519,75.9,2349,7.9,4802,16.2
11,04,10,22,5491,100.0,1985,36.2,4064,74.0,3506,63.8,558,10.2,1427,26.0
11,04,10,23,6750,100.0,2430,36.0,5332,79.0,4320,64.0,1012,15.0,1418,21.0
11,04,10,27,3163,100.0,953,30.1,2527,79.9,2210,69.9,317,10.0,636,20.1
11,04,11,28,26367,100.0,7171,27.2,21962,83.3,19196,72.8,2766,10.5,4405,16.7
11,05,12,29,4250,100.0,920,21.6,3708,87.2,3330,78.4,378,8.9,542,12.8
11,05,13,30,10268,100.0,2204,21.5,8749,85.2,8064,78.5,685,6.7,1519,14.8
11,05,13,31,10590,100.0,1393,13.2,9891,93.4,9197,86.8,694,6.6,699,6.6
11,05,13,32,7148,100.0,1000,14.0,6665,93.2,6148,86.0,517,7.2,483,6.8
12,10,31,15,7825,100.0,3492,44.6,5827,74.5,4333,55.4,1494,19.1,1998,25.5
12,10,31,16,10086,100.0,5030,49.9,6981,69.2,5056,50.1,1925,19.1,3105,30.8
12,10,31,17,10980,100.0,6010,54.7,7331,66.8,4970,45.3,2361,21.5,3649,33.2
12,10,32,18,14087,100.0,6470,45.9,10365,73.6,7617,54.1,2748,19.5,3722,26.4
12,10,32,19,8852,100.0,4124,46.6,6563,74.1,4728,53.4,1835,20.7,2289,25.9
12,10,32,20,4632,100.0,1469,31.7,3864,83.4,3163,68.3,701,15.1,768,16.6
12,21,41,25,7784,100.0,2554,32.8,6422,82.5,5230,67.2,1192,15.3,1362,17.5
12,21,41,26,8109,100.0,3280,40.4,6354,78.4,4829,59.6,1525,18.8,1755,21.6
12,21,44,21,2753,100.0,1091,39.6,2078,75.5,1662,60.4,416,15.1,675,24.5
12,21,44,22,8303,100.0,4948,59.6,5361,64.6,3355,40.4,2006,24.2,2942,35.4
12,21,44,23,5710,100.0,2442,42.8,4421,77.4,3268,57.2,1153,20.2,1289,22.6
12,21,44,24,10714,100.0,5651,52.7,7266,67.8,5063,47.3,2203,20.6,3448,32.2
12,21,45,27,10975,100.0,2629,24.0,9463,86.2,8346,76.0,1117,10.2,1512,13.8
12,21,45,28,266,100.0,115,43.2,193,72.6,151,56.8,42,15.8,73,27.4
12,22,42,29,6012,100.0,842,14.0,5671,94.3,5170,86.0,501,8.3,341,5.7
12,22,42,30,18104,100.0,2543,14.0,17096,94.4,15561,86.0,1535,8.5,1008,5.6
12,23,11,01,16588,100.0,2474,14.9,15440,93.1,14114,85.1,1326,8.0,1148,6.9
12,23,11,02,16787,100.0,2275,13.6,15872,94.5,14512,86.4,1360,8.1,915,5.5
12,30,12,03,15054,100.0,4711,31.3,12156,80.7,10343,68.7,1813,12.0,2898,19.3
12,30,12,04,6455,100.0,1552,24.0,5712,88.5,4903,76.0,809,12.5,743,11.5
12,30,12,05,5113,100.0,983,19.2,4671,91.4,4130,80.8,541,10.6,442,8.6
12,30,12,06,5172,100.0,888,17.2,4859,93.9,4284,82.8,575,11.1,313,6.1
12,30,21,07,3083,100.0,1331,43.2,2519,81.7,1752,56.8,767,24.9,564,18.3
12,30,21,08,14867,100.0,6708,45.1,11529,77.5,8159,54.9,3370,22.7,3338,22.5
12,30,21,09,11647,100.0,6129,52.6,8588,73.7,5518,47.4,3070,26.4,3059,26.3
12,30,21,10,10655,100.0,6080,57.1,7457,70.0,4575,42.9,2882,27.0,3198,30.0
12,30,22,11,3295,100.0,972,29.5,2869,87.1,2323,70.5,546,16.6,426,12.9
12,30,22,12,5935,100.0,2933,49.4,4081,68.8,3002,50.6,1079,18.2,1854,31.2
12,30,43,13,6709,100.0,1798,26.8,5551,82.7,4911,73.2,640,9.5,1158,17.3
12,30,43,14,9667,100.0,1534,15.9,8906,92.1,8133,84.1,773,8.0,761,7.9
