district_id,forecast_area_id,district_region_id,planning_area_id,inhabitants,inhabitants_percentage,inhabitants_with_migration_background,inhabitants_with_migration_background_percentage,inhabitants_germans,inhabitants_germans_percentage,inhabitants_germans_without_migration_background,inhabitants_germans_without_migration_background_percentage,inhabitants_germans_with_migration_background,inhabitants_germans_with_migration_background_percentage,inhabitants_foreigners,inhabitants_foreigners_percentage
01,01,11,01,3420,100.0,2069,60.5,1993,58.3,1351,39.5,642,18.8,1427,41.7
01,01,11,02,186,100.0,78,41.9,123,66.1,108,58.1,15,8.1,63,33.9
01,01,11,03,5083,100.0,2922,57.5,3309,65.1,2161,42.5,1148,22.6,1774,34.9
01,01,11,04,4641,100.0,3010,64.9,2830,61.0,1631,35.1,1199,25.8,1811,39.0
01,01,11,05,1531,100.0,1002,65.4,782,51.1,529,34.6,253,16.5,749,48.9
01,01,12,01,2403,100.0,1438,59.8,1399,58.2,965,40.2,434,18.1,1004,41.8
01,01,12,02,648,100.0,326,50.3,411,63.4,322,49.7,89,13.7,237,36.6
01,01,12,03,1133,100.0,604,53.3,721,63.6,529,46.7,192,16.9,412,36.4
01,01,12,04,8376,100.0,4232,50.5,5538,66.1,4144,49.5,1394,16.6,2838,33.9
01,01,13,01,6899,100.0,2952,42.8,4816,69.8,3947,57.2,869,12.6,2083,30.2
01,01,13,02,12597,100.0,5108,40.5,9135,72.5,7489,59.5,1646,13.1,3462,27.5
01,01,13,03,10054,100.0,4846,48.2,6517,64.8,5208,51.8,1309,13.0,3537,35.2
01,01,13,04,8732,100.0,3675,42.1,6442,73.8,5057,57.9,1385,15.9,2290,26.2
01,01,13,05,8529,100.0,3484,40.8,6204,72.7,5045,59.2,1159,13.6,2325,27.3
01,01,13,06,10721,100.0,4754,44.3,7502,70.0,5967,55.7,1535,14.3,3219,30.0
01,01,14,01,18141,100.0,7991,44.0,12362,68.1,10150,56.0,2212,12.2,5779,31.9
01,01,14,02,13699,100.0,5550,40.5,9920,72.4,8149,59.5,1771,12.9,3779,27.6
01,02,21,01,3626,100.0,1992,54.9,2235,61.6,1634,45.1,601,16.6,1391,38.4
01,02,21,02,6795,100.0,4198,61.8,3878,57.1,2597,38.2,1281,18.9,2917,42.9
01,02,21,03,261,100.0,203,77.8,110,42.1,58,22.2,52,19.9,151,57.9
01,02,21,04,18855,100.0,9539,50.6,12653,67.1,9316,49.4,3337,17.7,6202,32.9
01,02,21,05,5359,100.0,3154,58.9,3363,62.8,2205,41.1,1158,21.6,1996,37.2
01,02,21,06,11404,100.0,4058,35.6,9066,79.5,7346,64.4,1720,15.1,2338,20.5
01,02,22,01,10976,100.0,5549,50.6,7529,68.6,5427,49.4,2102,19.2,3447,31.4
01,02,22,02,2777,100.0,1744,62.8,1768,63.7,1033,37.2,735,26.5,1009,36.3
01,02,22,03,7065,100.0,4230,59.9,4679,66.2,2835,40.1,1844,26.1,2386,33.8
01,02,22,04,6085,100.0,2639,43.4,4457,73.2,3446,56.6,1011,16.6,1628,26.8
01,02,22,05,3333,100.0,2117,63.5,2224,66.7,1216,36.5,1008,30.2,1109,33.3
01,02,22,06,2976,100.0,1223,41.1,2330,78.3,1753,58.9,577,19.4,646,21.7
01,02,22,07,5786,100.0,2734,47.3,3800,65.7,3052,52.7,748,12.9,1986,34.3
01,03,31,01,27024,100.0,17167,63.5,15684,58.0,9857,36.5,5827,21.6,11340,42.0
01,03,31,02,11989,100.0,7417,61.9,7324,61.1,4572,38.1,2752,23.0,4665,38.9
01,03,32,01,14243,100.0,9576,67.2,9752,68.5,4667,32.8,5085,35.7,4491,31.5
01,03,32,02,10346,100.0,6024,58.2,7339,70.9,4322,41.8,3017,29.2,3007,29.1
01,03,32,03,14710,100.0,9479,64.4,8780,59.7,5231,35.6,3549,24.1,5930,40.3
01,04,41,01,20950,100.0,10355,49.4,14354,68.5,10595,50.6,3759,17.9,6596,31.5
01,04,41,02,16544,100.0,6854,41.4,12507,75.6,9690,58.6,2817,17.0,4037,24.4
01,04,41,03,8766,100.0,4718,53.8,5480,62.5,4048,46.2,1432,16.3,3286,37.5
01,04,42,01,24209,100.0,16597,68.6,13556,56.0,7612,31.4,5944,24.6,10653,44.0
01,04,42,02,17071,100.0,10048,58.9,10053,58.9,7023,41.1,3030,17.7,7018,41.1
01,04,42,03,16229,100.0,9739,60.0,9781,60.3,6490,40.0,3291,20.3,6448,39.7
02,01,01,01,6869,100.0,4924,71.7,3838,55.9,1945,28.3,1893,27.6,3031,44.1
02,01,01,02,13661,100.0,9327,68.3,9108,66.7,4334,31.7,4774,34.9,4553,33.3
02,01,01,03,15142,100.0,10715,70.8,9782,64.6,4427,29.2,5355,35.4,5360,35.4
02,01,01,04,5052,100.0,3279,64.9,3427,67.8,1773,35.1,1654,32.7,1625,32.2
02,02,02,01,1834,100.0,699,38.1,1446,78.8,1135,61.9,311,17.0,388,21.2
02,02,02,02,6116,100.0,2723,44.5,4350,71.1,3393,55.5,957,15.6,1766,28.9
02,02,02,03,11020,100.0,4422,40.1,8288,75.2,6598,59.9,1690,15.3,2732,24.8
02,02,02,04,12659,100.0,5450,43.1,9210,72.8,7209,56.9,2001,15.8,3449,27.2
02,02,02,05,14989,100.0,6207,41.4,11278,75.2,8782,58.6,2496,16.7,3711,24.8
02,02,02,06,19017,100.0,8876,46.7,13741,72.3,10141,53.3,3600,18.9,5276,27.7
02,03,03,01,8984,100.0,5698,63.4,5562,61.9,3286,36.6,2276,25.3,3422,38.1
02,03,03,02,13117,100.0,7134,54.4,8868,67.6,5983,45.6,2885,22.0,4249,32.4
02,03,04,01,15261,100.0,7568,49.6,10391,68.1,7693,50.4,2698,17.7,4870,31.9
02,03,04,02,11141,100.0,5685,51.0,7421,66.6,5456,49.0,1965,17.6,3720,33.4
02,04,05,01,5372,100.0,1554,28.9,4513,84.0,3818,71.1,695,12.9,859,16.0
02,04,05,02,7493,100.0,2347,31.3,5992,80.0,5146,68.7,846,11.3,1501,20.0
02,04,05,03,11244,100.0,3139,27.9,9210,81.9,8105,72.1,1105,9.8,2034,18.1
02,04,07,01,13324,100.0,5786,43.4,9557,71.7,7538,56.6,2019,15.2,3767,28.3
02,04,07,02,11038,100.0,3261,29.5,8785,79.6,7777,70.5,1008,9.1,2253,20.4
02,04,07,03,1135,100.0,789,69.5,444,39.1,346,30.5,98,8.6,691,60.9
02,05,06,01,9191,100.0,2966,32.3,7095,77.2,6225,67.7,870,9.5,2096,22.8
02,05,06,02,21793,100.0,6967,32.0,16929,77.7,14826,68.0,2103,9.6,4864,22.3
02,05,08,01,20500,100.0,7491,36.5,15107,73.7,13009,63.5,2098,10.2,5393,26.3
02,05,08,02,21376,100.0,7147,33.4,16138,75.5,14229,66.6,1909,8.9,5238,24.5
02,05,08,03,7652,100.0,2715,35.5,5734,74.9,4937,64.5,797,10.4,1918,25.1
02,05,08,04,4782,100.0,1148,24.0,4165,87.1,3634,76.0,531,11.1,617,12.9
03,01,01,01,4275,100.0,685,16.0,3809,89.1,3590,84.0,219,5.1,466,10.9
03,01,01,02,12447,100.0,2605,20.9,10457,84.0,9842,79.1,615,4.9,1990,16.0
03,01,01,04,234,100.0,49,20.9,206,88.0,185,79.1,21,9.0,28,12.0
03,02,02,03,2430,100.0,500,20.6,2011,82.8,1930,79.4,81,3.3,419,17.2
03,02,02,09,15034,100.0,2472,16.4,13624,90.6,12562,83.6,1062,7.1,1410,9.4
03,02,02,10,11469,100.0,1781,15.5,10466,91.3,9688,84.5,778,6.8,1003,8.7
03,02,03,07,18242,100.0,2429,13.3,17247,94.5,15813,86.7,1434,7.9,995,5.5
03,03,04,05,11404,100.0,2040,17.9,10238,89.8,9364,82.1,874,7.7,1166,10.2
03,03,04,06,8211,100.0,756,9.2,7888,96.1,7455,90.8,433,5.3,323,3.9
03,03,07,11,6862,100.0,495,7.2,6663,97.1,6367,92.8,296,4.3,199,2.9
03,03,07,15,7624,100.0,1436,18.8,6651,87.2,6188,81.2,463,6.1,973,12.8
03,03,07,16,1123,100.0,30,2.7,1114,99.2,1093,97.3,21,1.9,9,0.8
03,04,05,08,4570,100.0,939,20.5,4275,93.5,3631,79.5,644,14.1,295,6.5
03,04,05,12,10264,100.0,1797,17.5,9413,91.7,8467,82.5,946,9.2,851,8.3
03,04,05,13,3390,100.0,526,15.5,3152,93.0,2864,84.5,288,8.5,238,7.0
03,04,06,14,36813,100.0,5844,15.9,33632,91.4,30969,84.1,2663,7.2,3181,8.6
03,04,08,18,35043,100.0,6203,17.7,31157,88.9,28840,82.3,2317,6.6,3886,11.1
03,05,09,19,5367,100.0,925,17.2,4658,86.8,4442,82.8,216,4.0,709,13.2
03,05,09,20,7385,100.0,1113,15.1,6753,91.4,6272,84.9,481,6.5,632,8.6
03,05,09,23,9717,100.0,2238,23.0,8220,84.6,7479,77.0,741,7.6,1497,15.4
03,05,09,24,6163,100.0,1455,23.6,5187,84.2,4708,76.4,479,7.8,976,15.8
03,05,09,25,9765,100.0,1832,18.8,8604,88.1,7933,81.2,671,6.9,1161,11.9
03,05,10,17,4226,100.0,936,22.1,3587,84.9,3290,77.9,297,7.0,639,15.1
03,05,10,21,6494,100.0,807,12.4,5956,91.7,5687,87.6,269,4.1,538,8.3
03,05,10,22,4620,100.0,471,10.2,4347,94.1,4149,89.8,198,4.3,273,5.9
03,06,11,26,15807,100.0,4795,30.3,12530,79.3,11012,69.7,1518,9.6,3277,20.7
03,06,11,31,10695,100.0,3632,34.0,8183,76.5,7063,66.0,1120,10.5,2512,23.5
03,06,12,27,14642,100.0,3919,26.8,12073,82.5,10723,73.2,1350,9.2,2569,17.5
03,06,12,28,12732,100.0,3107,24.4,10637,83.5,9625,75.6,1012,7.9,2095,16.5
03,06,13,32,22788,100.0,7239,31.8,18019,79.1,15549,68.2,2470,10.8,4769,20.9
03,06,14,29,9975,100.0,1696,17.0,8993,90.2,8279,83.0,714,7.2,982,9.8
03,06,14,30,4062,100.0,1716,42.2,2621,64.5,2346,57.8,275,6.8,1441,35.5
03,06,14,34,6463,100.0,1817,28.1,5180,80.1,4646,71.9,534,8.3,1283,19.9
03,06,14,35,4004,100.0,1188,29.7,3202,80.0,2816,70.3,386,9.6,802,20.0
03,06,14,41,2653,100.0,731,27.6,2279,85.9,1922,72.4,357,13.5,374,14.1
03,07,15,36,11147,100.0,4103,36.8,8376,75.1,7044,63.2,1332,11.9,2771,24.9
03,07,15,37,15918,100.0,5603,35.2,12101,76.0,10315,64.8,1786,11.2,3817,24.0
03,07,16,33,3192,100.0,979,30.7,2546,79.8,2213,69.3,333,10.4,646,20.2
03,07,16,38,17743,100.0,5731,32.3,13960,78.7,12012,67.7,1948,11.0,3783,21.3
03,07,16,39,12772,100.0,3477,27.2,10584,82.9,9295,72.8,1289,10.1,2188,17.1
04,01,01,01,10778,100.0,5188,48.1,7800,72.4,5590,51.9,2210,20.5,2978,27.6
04,01,01,02,813,100.0,346,42.6,521,64.1,467,57.4,54,6.6,292,35.9
04,01,01,03,7899,100.0,4347,55.0,5718,72.4,3552,45.0,2166,27.4,2181,27.6
04,02,02,04,188,100.0,68,36.2,151,80.3,120,63.8,31,16.5,37,19.7
04,02,02,05,1311,100.0,327,24.9,1132,86.3,984,75.1,148,11.3,179,13.7
04,02,02,06,2851,100.0,804,28.2,2367,83.0,2047,71.8,320,11.2,484,17.0
04,02,02,07,2574,100.0,789,30.7,2105,81.8,1785,69.3,320,12.4,469,18.2
04,02,02,08,2953,100.0,795,26.9,2542,86.1,2158,73.1,384,13.0,411,13.9
04,02,02,09,3207,100.0,1256,39.2,2238,69.8,1951,60.8,287,8.9,969,30.2
04,02,03,10,795,100.0,499,62.8,359,45.2,296,37.2,63,7.9,436,54.8
04,02,03,11,15015,100.0,5092,33.9,11946,79.6,9923,66.1,2023,13.5,3069,20.4
04,02,03,12,5542,100.0,1793,32.4,4434,80.0,3749,67.6,685,12.4,1108,20.0
04,02,03,13,7304,100.0,2775,38.0,5652,77.4,4529,62.0,1123,15.4,1652,22.6
04,02,03,14,12,100.0,12,100.0,0,0.0,0,0.0,0,0.0,12,100.0
04,03,04,15,3071,100.0,1648,53.7,1829,59.6,1423,46.3,406,13.2,1242,40.4
04,03,04,16,10616,100.0,5175,48.7,7784,73.3,5441,51.3,2343,22.1,2832,26.7
04,03,04,17,10941,100.0,4285,39.2,8399,76.8,6656,60.8,1743,15.9,2542,23.2
04,03,05,18,9581,100.0,4382,45.7,6959,72.6,5199,54.3,1760,18.4,2622,27.4
04,03,05,19,5829,100.0,2671,45.8,4247,72.9,3158,54.2,1089,18.7,1582,27.1
04,03,06,20,8949,100.0,4027,45.0,6569,73.4,4922,55.0,1647,18.4,2380,26.6
04,03,06,21,3074,100.0,1778,57.8,1962,63.8,1296,42.2,666,21.7,1112,36.2
04,03,06,22,10873,100.0,5223,48.0,7808,71.8,5650,52.0,2158,19.8,3065,28.2
04,03,06,23,5068,100.0,2896,57.1,3400,67.1,2172,42.9,1228,24.2,1668,32.9
04,03,07,24,6543,100.0,2521,38.5,5014,76.6,4022,61.5,992,15.2,1529,23.4
04,03,07,25,12453,100.0,5189,41.7,9108,73.1,7264,58.3,1844,14.8,3345,26.9
04,03,07,26,5749,100.0,2599,45.2,4126,71.8,3150,54.8,976,17.0,1623,28.2
04,03,08,27,12270,100.0,6704,54.6,7908,64.4,5566,45.4,2342,19.1,4362,35.6
04,03,08,28,9683,100.0,4479,46.3,6758,69.8,5204,53.7,1554,16.0,2925,30.2
04,03,09,29,6025,100.0,2641,43.8,4408,73.2,3384,56.2,1024,17.0,1617,26.8
04,03,09,30,5797,100.0,2736,47.2,4053,69.9,3061,52.8,992,17.1,1744,30.1
04,03,09,31,3725,100.0,2145,57.6,2253,60.5,1580,42.4,673,18.1,1472,39.5
04,03,10,32,15704,100.0,6829,43.5,11580,73.7,8875,56.5,2705,17.2,4124,26.3
04,04,11,33,68,100.0,40,58.8,35,51.5,28,41.2,7,10.3,33,48.5
04,04,11,34,5247,100.0,2112,40.3,4113,78.4,3135,59.7,978,18.6,1134,21.6
04,04,11,35,2832,100.0,1055,37.3,2267,80.0,1777,62.7,490,17.3,565,20.0
04,04,11,36,3104,100.0,1138,36.7,2486,80.1,1966,63.3,520,16.8,618,19.9
04,04,11,37,8300,100.0,3201,38.6,6563,79.1,5099,61.4,1464,17.6,1737,20.9
04,04,12,38,6116,100.0,2180,35.6,5069,82.9,3936,64.4,1133,18.5,1047,17.1
04,04,12,39,333,100.0,256,76.9,105,31.5,77,23.1,28,8.4,228,68.5
04,04,12,40,1551,100.0,436,28.1,1321,85.2,1115,71.9,206,13.3,230,14.8
04,04,12,41,7026,100.0,1794,25.5,6054,86.2,5232,74.5,822,11.7,972,13.8
04,04,13,42,4148,100.0,1436,34.6,3381,81.5,2712,65.4,669,16.1,767,18.5
04,04,13,43,3567,100.0,1126,31.6,2988,83.8,2441,68.4,547,15.3,579,16.2
04,04,13,44,10800,100.0,3028,28.0,9053,83.8,7772,72.0,1281,11.9,1747,16.2
04,05,14,45,6354,100.0,2786,43.8,4854,76.4,3568,56.2,1286,20.2,1500,23.6
04,05,14,46,10866,100.0,4834,44.5,8064,74.2,6032,55.5,2032,18.7,2802,25.8
04,05,14,47,5354,100.0,2271,42.4,4024,75.2,3083,57.6,941,17.6,1330,24.8
04,05,14,48,9480,100.0,4577,48.3,6549,69.1,4903,51.7,1646,17.4,2931,30.9
04,05,15,49,4660,100.0,2039,43.8,3383,72.6,2621,56.2,762,16.4,1277,27.4
04,05,15,50,5598,100.0,2378,42.5,4166,74.4,3220,57.5,946,16.9,1432,25.6
04,05,15,51,4523,100.0,1973,43.6,3378,74.7,2550,56.4,828,18.3,1145,25.3
04,05,16,52,9933,100.0,4005,40.3,7429,74.8,5928,59.7,1501,15.1,2504,25.2
04,05,16,53,7029,100.0,3042,43.3,5185,73.8,3987,56.7,1198,17.0,1844,26.2
04,05,16,54,3048,100.0,1108,36.4,2397,78.6,1940,63.6,457,15.0,651,21.4
04,05,16,55,7418,100.0,3247,43.8,5492,74.0,4171,56.2,1321,17.8,1926,26.0
04,05,16,56,7717,100.0,2543,33.0,6218,80.6,5174,67.0,1044,13.5,1499,19.4
04,06,17,57,67,100.0,15,22.4,55,82.1,52,77.6,3,4.5,12,17.9
05,01,01,01,10509,100.0,3021,28.7,9030,85.9,7488,71.3,1542,14.7,1479,14.1
05,01,01,02,8096,100.0,2811,34.7,6343,78.3,5285,65.3,1058,13.1,1753,21.7
05,01,01,03,7648,100.0,1461,19.1,6966,91.1,6187,80.9,779,10.2,682,8.9
05,01,02,04,3604,100.0,1585,44.0,2712,75.2,2019,56.0,693,19.2,892,24.8
05,01,02,05,2132,100.0,623,29.2,1878,88.1,1509,70.8,369,17.3,254,11.9
05,01,02,06,10613,100.0,4388,41.3,8301,78.2,6225,58.7,2076,19.6,2312,21.8
05,01,02,07,11558,100.0,5929,51.3,8890,76.9,5629,48.7,3261,28.2,2668,23.1
05,01,02,08,7706,100.0,2758,35.8,6079,78.9,4948,64.2,1131,14.7,1627,21.1
05,01,02,09,6059,100.0,1926,31.8,5146,84.9,4133,68.2,1013,16.7,913,15.1
05,01,03,10,3983,100.0,1536,38.6,3056,76.7,2447,61.4,609,15.3,927,23.3
05,01,03,11,5647,100.0,2840,50.3,4289,76.0,2807,49.7,1482,26.2,1358,24.0
05,01,03,12,7426,100.0,4249,57.2,4365,58.8,3177,42.8,1188,16.0,3061,41.2
05,01,03,13,6854,100.0,2935,42.8,5004,73.0,3919,57.2,1085,15.8,1850,27.0
05,01,03,14,12390,100.0,5006,40.4,9513,76.8,7384,59.6,2129,17.2,2877,23.2
05,01,03,39,995,100.0,672,67.5,385,38.7,323,32.5,62,6.2,610,61.3
05,02,04,15,3818,100.0,799,20.9,3587,93.9,3019,79.1,568,14.9,231,6.1
05,02,04,16,1679,100.0,95,5.7,1645,98.0,1584,94.3,61,3.6,34,2.0
05,02,04,17,5929,100.0,1872,31.6,4991,84.2,4057,68.4,934,15.8,938,15.8
05,02,04,18,4398,100.0,1189,27.0,3687,83.8,3209,73.0,478,10.9,711,16.2
05,02,04,19,7164,100.0,2153,30.1,6058,84.6,5011,69.9,1047,14.6,1106,15.4
05,02,04,20,965,100.0,192,19.9,867,89.8,773,80.1,94,9.7,98,10.2
05,02,05,21,3251,100.0,903,27.8,2925,90.0,2348,72.2,577,17.7,326,10.0
05,02,05,22,7577,100.0,3629,47.9,5251,69.3,3948,52.1,1303,17.2,2326,30.7
05,02,05,23,12696,100.0,7439,58.6,8808,69.4,5257,41.4,3551,28.0,3888,30.6
05,02,05,24,6313,100.0,1407,22.3,5654,89.6,4906,77.7,748,11.8,659,10.4
05,02,06,25,7614,100.0,2841,37.3,5952,78.2,4773,62.7,1179,15.5,1662,21.8
05,02,06,26,18203,100.0,6361,34.9,14339,78.8,11842,65.1,2497,13.7,3864,21.2
05,02,06,27,4409,100.0,1999,45.3,3135,71.1,2410,54.7,725,16.4,1274,28.9
05,02,06,28,2013,100.0,500,24.8,1787,88.8,1513,75.2,274,13.6,226,11.2
05,02,06,29,4412,100.0,704,16.0,4093,92.8,3708,84.0,385,8.7,319,7.2
05,03,07,30,4030,100.0,2193,54.4,3288,81.6,1837,45.6,1451,36.0,742,18.4
05,03,07,31,11661,100.0,4992,42.8,9256,79.4,6669,57.2,2587,22.2,2405,20.6
05,03,08,32,12286,100.0,5718,46.5,9009,73.3,6568,53.5,2441,19.9,3277,26.7
05,03,08,33,505,100.0,234,46.3,388,76.8,271,53.7,117,23.2,117,23.2
05,04,09,34,3457,100.0,872,25.2,2956,85.5,2585,74.8,371,10.7,501,14.5
05,04,09,35,459,100.0,117,25.5,388,84.5,342,74.5,46,10.0,71,15.5
05,04,09,36,10041,100.0,1768,17.6,9452,94.1,8273,82.4,1179,11.7,589,5.9
05,04,09,37,2199,100.0,353,16.1,2068,94.0,1846,83.9,222,10.1,131,6.0
05,04,09,38,3678,100.0,518,14.1,3492,94.9,3160,85.9,332,9.0,186,5.1
06,01,01,01,6934,100.0,1817,26.2,6003,86.6,5117,73.8,886,12.8,931,13.4
06,01,01,02,8818,100.0,3165,35.9,7109,80.6,5653,64.1,1456,16.5,1709,19.4
06,01,01,03,6375,100.0,2027,31.8,5345,83.8,4348,68.2,997,15.6,1030,16.2
06,01,02,04,6864,100.0,2347,34.2,5707,83.1,4517,65.8,1190,17.3,1157,16.9
06,01,02,05,9903,100.0,3238,32.7,8201,82.8,6665,67.3,1536,15.5,1702,17.2
06,01,02,06,7795,100.0,2288,29.4,6615,84.9,5507,70.6,1108,14.2,1180,15.1
06,01,02,07,7908,100.0,2651,33.5,6537,82.7,5257,66.5,1280,16.2,1371,17.3
06,01,02,08,6735,100.0,2041,30.3,5678,84.3,4694,69.7,984,14.6,1057,15.7
06,01,02,09,9200,100.0,3137,34.1,7535,81.9,6063,65.9,1472,16.0,1665,18.1
06,01,02,10,4896,100.0,1366,27.9,4170,85.2,3530,72.1,640,13.1,726,14.8
06,02,03,01,5013,100.0,1166,23.3,4471,89.2,3847,76.7,624,12.4,542,10.8
06,02,03,02,5937,100.0,1705,28.7,4991,84.1,4232,71.3,759,12.8,946,15.9
06,02,03,03,7348,100.0,2249,30.6,6169,84.0,5099,69.4,1070,14.6,1179,16.0
06,02,03,04,7249,100.0,2164,29.9,6146,84.8,5085,70.1,1061,14.6,1103,15.2
06,02,03,05,11363,100.0,3856,33.9,9353,82.3,7507,66.1,1846,16.2,2010,17.7
06,02,03,06,6402,100.0,1245,19.4,5861,91.5,5157,80.6,704,11.0,541,8.5
06,02,04,07,4631,100.0,2316,50.0,3456,74.6,2315,50.0,1141,24.6,1175,25.4
06,02,04,08,6906,100.0,1912,27.7,5864,84.9,4994,72.3,870,12.6,1042,15.1
06,02,04,09,8408,100.0,2166,25.8,7206,85.7,6242,74.2,964,11.5,1202,14.3
06,02,04,10,7183,100.0,1453,20.2,6331,88.1,5730,79.8,601,8.4,852,11.9
06,02,04,11,8561,100.0,2171,25.4,7550,88.2,6390,74.6,1160,13.5,1011,11.8
06,03,05,01,5725,100.0,1368,23.9,4882,85.3,4357,76.1,525,9.2,843,14.7
06,03,05,02,5609,100.0,1337,23.8,4913,87.6,4272,76.2,641,11.4,696,12.4
06,03,05,03,11816,100.0,3412,28.9,10038,85.0,8404,71.1,1634,13.8,1778,15.0
06,03,05,04,11081,100.0,2504,22.6,9836,88.8,8577,77.4,1259,11.4,1245,11.2
06,03,06,05,7184,100.0,2039,28.4,6089,84.8,5145,71.6,944,13.1,1095,15.2
06,03,06,06,5483,100.0,1997,36.4,4256,77.6,3486,63.6,770,14.0,1227,22.4
06,03,06,07,3102,100.0,1119,36.1,2317,74.7,1983,63.9,334,10.8,785,25.3
06,03,06,08,13681,100.0,3885,28.4,11802,86.3,9796,71.6,2006,14.7,1879,13.7
06,03,06,09,12197,100.0,3061,25.1,10541,86.4,9136,74.9,1405,11.5,1656,13.6
06,03,06,10,8469,100.0,2000,23.6,7404,87.4,6469,76.4,935,11.0,1065,12.6
06,04,07,01,10270,100.0,2309,22.5,8997,87.6,7961,77.5,1036,10.1,1273,12.4
06,04,07,02,5495,100.0,1305,23.7,4843,88.1,4190,76.3,653,11.9,652,11.9
06,04,07,03,11199,100.0,3305,29.5,8917,79.6,7894,70.5,1023,9.1,2282,20.4
06,04,08,04,7588,100.0,1427,18.8,6875,90.6,6161,81.2,714,9.4,713,9.4
06,04,08,05,5295,100.0,1154,21.8,4714,89.0,4141,78.2,573,10.8,581,11.0
06,04,08,06,7319,100.0,1208,16.5,6711,91.7,6111,83.5,600,8.2,608,8.3
06,04,08,07,5919,100.0,1421,24.0,5196,87.8,4498,76.0,698,11.8,723,12.2
06,04,08,08,4698,100.0,1747,37.2,4033,85.8,2951,62.8,1082,23.0,665,14.2
06,04,08,09,4984,100.0,1520,30.5,4062,81.5,3464,69.5,598,12.0,922,18.5
06,04,08,10,7154,100.0,2318,32.4,5878,82.2,4836,67.6,1042,14.6,1276,17.8
07,01,01,01,9949,100.0,4882,49.1,7023,70.6,5067,50.9,1956,19.7,2926,29.4
07,01,01,02,16693,100.0,9552,57.2,10798,64.7,7141,42.8,3657,21.9,5895,35.3
07,01,01,03,10619,100.0,4232,39.9,8058,75.9,6387,60.1,1671,15.7,2561,24.1
07,01,01,04,13943,100.0,7984,57.3,9088,65.2,5959,42.7,3129,22.4,4855,34.8
07,02,02,01,10664,100.0,3871,36.3,8554,80.2,6793,63.7,1761,16.5,2110,19.8
07,02,02,02,10358,100.0,4567,44.1,7624,73.6,5791,55.9,1833,17.7,2734,26.4
07,02,02,03,18022,100.0,8052,44.7,13276,73.7,9970,55.3,3306,18.3,4746,26.3
07,02,02,04,12243,100.0,4590,37.5,9545,78.0,7653,62.5,1892,15.5,2698,22.0
07,03,03,01,24824,100.0,7065,28.5,20935,84.3,17759,71.5,3176,12.8,3889,15.7
07,03,03,02,9442,100.0,3049,32.3,7815,82.8,6393,67.7,1422,15.1,1627,17.2
07,03,03,03,12409,100.0,5489,44.2,9582,77.2,6920,55.8,2662,21.5,2827,22.8
07,04,04,01,17860,100.0,6932,38.8,14371,80.5,10928,61.2,3443,19.3,3489,19.5
07,04,04,02,2328,100.0,498,21.4,2106,90.5,1830,78.6,276,11.9,222,9.5
07,04,04,03,24572,100.0,9396,38.2,19377,78.9,15176,61.8,4201,17.1,5195,21.1
07,04,04,04,5177,100.0,1399,27.0,4510,87.1,3778,73.0,732,14.1,667,12.9
07,04,04,05,11316,100.0,5089,45.0,8383,74.1,6227,55.0,2156,19.1,2933,25.9
07,04,04,06,4058,100.0,2330,57.4,2605,64.2,1728,42.6,877,21.6,1453,35.8
07,05,05,01,17038,100.0,6993,41.0,13367,78.5,10045,59.0,3322,19.5,3671,21.5
07,05,05,02,8051,100.0,2992,37.2,6400,79.5,5059,62.8,1341,16.7,1651,20.5
07,05,05,03,9263,100.0,3071,33.2,7760,83.8,6192,66.8,1568,16.9,1503,16.2
07,05,05,04,5644,100.0,1850,32.8,4799,85.0,3794,67.2,1005,17.8,845,15.0
07,05,05,05,10689,100.0,3139,29.4,9239,86.4,7550,70.6,1689,15.8,1450,13.6
07,05,05,06,2278,100.0,564,24.8,2048,89.9,1714,75.2,334,14.7,230,10.1
07,06,06,01,10259,100.0,4295,41.9,7865,76.7,5964,58.1,1901,18.5,2394,23.3
07,06,06,02,4757,100.0,1164,24.5,4251,89.4,3593,75.5,658,13.8,506,10.6
07,06,06,03,2878,100.0,1110,38.6,2376,82.6,1768,61.4,608,21.1,502,17.4
07,06,06,04,14560,100.0,5595,38.4,12339,84.7,8965,61.6,3374,23.2,2221,15.3
07,07,07,01,10512,100.0,2324,22.1,9471,90.1,8188,77.9,1283,12.2,1041,9.9
07,07,07,02,10978,100.0,2353,21.4,10044,91.5,8625,78.6,1419,12.9,934,8.5
07,07,07,03,7780,100.0,2078,26.7,6855,88.1,5702,73.3,1153,14.8,925,11.9
07,07,07,04,8572,100.0,3394,39.6,6637,77.4,5178,60.4,1459,17.0,1935,22.6
07,07,07,05,7023,100.0,1293,18.4,6467,92.1,5730,81.6,737,10.5,556,7.9
07,07,07,06,3900,100.0,842,21.6,3414,87.5,3058,78.4,356,9.1,486,12.5
07,07,07,07,2985,100.0,517,17.3,2728,91.4,2468,82.7,260,8.7,257,8.6
08,01,01,15,899,100.0,407,45.3,646,71.9,492,54.7,154,17.1,253,28.1
08,01,01,16,3668,100.0,2122,57.9,2242,61.1,1546,42.1,696,19.0,1426,38.9
08,01,01,17,16010,100.0,8172,51.0,10586,66.1,7838,49.0,2748,17.2,5424,33.9
08,01,01,18,11796,100.0,7134,60.5,7434,63.0,4662,39.5,2772,23.5,4362,37.0
08,01,02,11,9910,100.0,5798,58.5,6071,61.3,4112,41.5,1959,19.8,3839,38.7
08,01,02,12,7434,100.0,5024,67.6,4911,66.1,2410,32.4,2501,33.6,2523,33.9
08,01,02,13,12276,100.0,6706,54.6,8030,65.4,5570,45.4,2460,20.0,4246,34.6
08,01,02,14,8378,100.0,4907,58.6,5132,61.3,3471,41.4,1661,19.8,3246,38.7
08,01,03,01,27496,100.0,13489,49.1,18888,68.7,14007,50.9,4881,17.8,8608,31.3
08,01,03,02,3797,100.0,1422,37.5,2950,77.7,2375,62.5,575,15.1,847,22.3
08,01,03,03,8388,100.0,5133,61.2,5023,59.9,3255,38.8,1768,21.1,3365,40.1
08,01,04,04,23507,100.0,12433,52.9,15518,66.0,11074,47.1,4444,18.9,7989,34.0
08,01,04,05,8951,100.0,4224,47.2,6209,69.4,4727,52.8,1482,16.6,2742,30.6
08,01,04,06,7122,100.0,4244,59.6,4331,60.8,2878,40.4,1453,20.4,2791,39.2
08,01,04,07,796,100.0,355,44.6,561,70.5,441,55.4,120,15.1,235,29.5
08,01,05,08,5824,100.0,4246,72.9,3736,64.1,1578,27.1,2158,37.1,2088,35.9
08,01,05,09,9393,100.0,6196,66.0,6645,70.7,3197,34.0,3448,36.7,2748,29.3
08,01,05,10,481,100.0,307,63.8,242,50.3,174,36.2,68,14.1,239,49.7
08,02,06,19,11542,100.0,6351,55.0,7731,67.0,5191,45.0,2540,22.0,3811,33.0
08,02,06,20,9261,100.0,4179,45.1,7239,78.2,5082,54.9,2157,23.3,2022,21.8
08,02,06,21,2343,100.0,632,27.0,2139,91.3,1711,73.0,428,18.3,204,8.7
08,02,06,22,14267,100.0,4097,28.7,12354,86.6,10170,71.3,2184,15.3,1913,13.4
08,02,06,23,1253,100.0,385,30.7,1088,86.8,868,69.3,220,17.6,165,13.2
08,02,06,24,1402,100.0,512,36.5,1228,87.6,890,63.5,338,24.1,174,12.4
08,02,06,25,3287,100.0,1006,30.6,2768,84.2,2281,69.4,487,14.8,519,15.8
08,02,07,26,8435,100.0,2247,26.6,7463,88.5,6188,73.4,1275,15.1,972,11.5
08,02,07,27,11930,100.0,3734,31.3,10141,85.0,8196,68.7,1945,16.3,1789,15.0
08,02,07,28,8953,100.0,4028,45.0,6888,76.9,4925,55.0,1963,21.9,2065,23.1
08,03,08,29,12479,100.0,6414,51.4,9882,79.2,6065,48.6,3817,30.6,2597,20.8
08,03,08,30,7316,100.0,3044,41.6,6128,83.8,4272,58.4,1856,25.4,1188,16.2
08,03,08,31,17522,100.0,9033,51.6,13855,79.1,8489,48.4,5366,30.6,3667,20.9
08,04,09,32,2848,100.0,951,33.4,2458,86.3,1897,66.6,561,19.7,390,13.7
08,04,09,33,4173,100.0,1377,33.0,3589,86.0,2796,67.0,793,19.0,584,14.0
08,04,09,34,2679,100.0,851,31.8,2323,86.7,1828,68.2,495,18.5,356,13.3
08,04,10,35,8297,100.0,2871,34.6,7064,85.1,5426,65.4,1638,19.7,1233,14.9
08,04,10,36,6840,100.0,1644,24.0,6176,90.3,5196,76.0,980,14.3,664,9.7
08,04,10,37,9925,100.0,2743,27.6,8678,87.4,7182,72.4,1496,15.1,1247,12.6
08,04,10,38,7054,100.0,1643,23.3,6524,92.5,5411,76.7,1113,15.8,530,7.5
08,04,10,39,3819,100.0,1121,29.4,3443,90.2,2698,70.6,745,19.5,376,9.8
08,04,10,40,7940,100.0,1969,24.8,7134,89.8,5971,75.2,1163,14.6,806,10.2
09,01,01,01,12560,100.0,3953,31.5,10169,81.0,8607,68.5,1562,12.4,2391,19.0
09,01,01,02,75,100.0,21,28.0,60,80.0,54,72.0,6,8.0,15,20.0
09,01,02,01,4372,100.0,773,17.7,3961,90.6,3599,82.3,362,8.3,411,9.4
09,01,02,02,6939,100.0,1208,17.4,6160,88.8,5731,82.6,429,6.2,779,11.2
09,01,03,01,15690,100.0,2549,16.2,14196,90.5,13141,83.8,1055,6.7,1494,9.5
09,01,03,02,3148,100.0,944,30.0,2602,82.7,2204,70.0,398,12.6,546,17.3
09,01,04,01,8439,100.0,935,11.1,7928,93.9,7504,88.9,424,5.0,511,6.1
09,01,04,02,11401,100.0,1741,15.3,10578,92.8,9660,84.7,918,8.1,823,7.2
09,02,05,01,7534,100.0,2263,30.0,5832,77.4,5271,70.0,561,7.4,1702,22.6
09,02,05,02,15752,100.0,3436,21.8,13454,85.4,12316,78.2,1138,7.2,2298,14.6
09,02,06,01,8993,100.0,2607,29.0,6986,77.7,6386,71.0,600,6.7,2007,22.3
09,02,06,02,3569,100.0,303,8.5,3421,95.9,3266,91.5,155,4.3,148,4.1
09,02,07,01,2772,100.0,1098,39.6,1962,70.8,1674,60.4,288,10.4,810,29.2
09,02,07,02,16813,100.0,2909,17.3,14808,88.1,13904,82.7,904,5.4,2005,11.9
09,02,08,01,2975,100.0,290,9.7,2792,93.8,2685,90.3,107,3.6,183,6.2
09,02,08,02,7959,100.0,1610,20.2,6854,86.1,6349,79.8,505,6.3,1105,13.9
09,03,09,01,13611,100.0,1925,14.1,12763,93.8,11686,85.9,1077,7.9,848,6.2
09,03,09,02,5623,100.0,793,14.1,5208,92.6,4830,85.9,378,6.7,415,7.4
09,03,09,03,8159,100.0,1573,19.3,7451,91.3,6586,80.7,865,10.6,708,8.7
09,03,10,01,13134,100.0,1767,13.5,12047,91.7,11367,86.5,680,5.2,1087,8.3
09,03,11,01,6634,100.0,895,13.5,6075,91.6,5739,86.5,336,5.1,559,8.4
09,03,12,01,1821,100.0,173,9.5,1762,96.8,1648,90.5,114,6.3,59,3.2
09,03,12,02,2573,100.0,278,10.8,2434,94.6,2295,89.2,139,5.4,139,5.4
09,04,13,01,10088,100.0,623,6.2,9811,97.3,9465,93.8,346,3.4,277,2.7
09,04,13,02,1919,100.0,193,10.1,1822,94.9,1726,89.9,96,5.0,97,5.1
09,04,14,01,5481,100.0,481,8.8,5276,96.3,5000,91.2,276,5.0,205,3.7
09,04,14,02,1550,100.0,223,14.4,1448,93.4,1327,85.6,121,7.8,102,6.6
09,04,14,03,4596,100.0,711,15.5,4079,88.8,3885,84.5,194,4.2,517,11.2
09,04,15,01,7136,100.0,1341,18.8,6277,88.0,5795,81.2,482,6.8,859,12.0
09,04,16,01,6760,100.0,514,7.6,6544,96.8,6246,92.4,298,4.4,216,3.2
09,05,17,01,4090,100.0,438,10.7,3801,92.9,3652,89.3,149,3.6,289,7.1
09,05,17,02,15049,100.0,1292,8.6,14426,95.9,13757,91.4,669,4.4,623,4.1
09,05,18,01,9495,100.0,917,9.7,8998,94.8,8578,90.3,420,4.4,497,5.2
09,05,19,01,11473,100.0,1522,13.3,10524,91.7,9951,86.7,573,5.0,949,8.3
09,05,20,01,12970,100.0,1079,8.3,12418,95.7,11891,91.7,527,4.1,552,4.3
10,01,01,01,5691,100.0,1508,26.5,4887,85.9,4183,73.5,704,12.4,804,14.1
10,01,01,02,18274,100.0,4748,26.0,16026,87.7,13526,74.0,2500,13.7,2248,12.3
10,01,02,03,1168,100.0,716,61.3,501,42.9,452,38.7,49,4.2,667,57.1
10,01,02,04,10693,100.0,2600,24.3,9460,88.5,8093,75.7,1367,12.8,1233,11.5
10,01,02,05,8141,100.0,1313,16.1,7421,91.2,6828,83.9,593,7.3,720,8.8
10,01,02,06,17291,100.0,4313,24.9,14807,85.6,12978,75.1,1829,10.6,2484,14.4
10,01,02,07,10636,100.0,2567,24.1,9487,89.2,8069,75.9,1418,13.3,1149,10.8
10,01,03,08,2182,100.0,580,26.6,1841,84.4,1602,73.4,239,11.0,341,15.6
10,01,03,09,14638,100.0,3434,23.5,13167,90.0,11204,76.5,1963,13.4,1471,10.0
10,01,03,10,18013,100.0,4056,22.5,16092,89.3,13957,77.5,2135,11.9,1921,10.7
10,01,03,11,3688,100.0,520,14.1,3508,95.1,3168,85.9,340,9.2,180,4.9
10,02,04,12,7186,100.0,2245,31.2,5946,82.7,4941,68.8,1005,14.0,1240,17.3
10,02,04,13,16195,100.0,3643,22.5,13742,84.9,12552,77.5,1190,7.3,2453,15.1
10,02,04,14,1694,100.0,771,45.5,1339,79.0,923,54.5,416,24.6,355,21.0
10,02,04,15,5830,100.0,1859,31.9,4405,75.6,3971,68.1,434,7.4,1425,24.4
10,02,04,16,5642,100.0,1596,28.3,4558,80.8,4046,71.7,512,9.1,1084,19.2
10,02,05,17,9124,100.0,1352,14.8,8284,90.8,7772,85.2,512,5.6,840,9.2
10,02,05,18,5307,100.0,1112,21.0,4588,86.5,4195,79.0,393,7.4,719,13.5
10,02,05,19,6076,100.0,1838,30.3,4845,79.7,4238,69.7,607,10.0,1231,20.3
10,02,06,20,3349,100.0,576,17.2,3080,92.0,2773,82.8,307,9.2,269,8.0
10,02,06,21,6310,100.0,1308,20.7,5503,87.2,5002,79.3,501,7.9,807,12.8
10,02,06,22,8572,100.0,1163,13.6,8036,93.7,7409,86.4,627,7.3,536,6.3
10,02,06,23,6523,100.0,846,13.0,6164,94.5,5677,87.0,487,7.5,359,5.5
10,03,07,24,7836,100.0,1375,17.5,6938,88.5,6461,82.5,477,6.1,898,11.5
10,03,07,25,6487,100.0,1367,21.1,5699,87.9,5120,78.9,579,8.9,788,12.1
10,03,07,26,3553,100.0,653,18.4,3152,88.7,2900,81.6,252,7.1,401,11.3
10,03,07,27,9847,100.0,1060,10.8,9455,96.0,8787,89.2,668,6.8,392,4.0
10,04,08,28,7779,100.0,716,9.2,7448,95.7,7063,90.8,385,4.9,331,4.3
10,04,08,29,3960,100.0,432,10.9,3693,93.3,3528,89.1,165,4.2,267,6.7
10,04,08,30,7627,100.0,518,6.8,7446,97.6,7109,93.2,337,4.4,181,2.4
10,04,09,31,9697,100.0,804,8.3,9380,96.7,8893,91.7,487,5.0,317,3.3
10,04,09,32,4288,100.0,432,10.1,4080,95.1,3856,89.9,224,5.2,208,4.9
10,04,09,33,15251,100.0,1121,7.4,14813,97.1,14130,92.6,683,4.5,438,2.9
11,01,01,01,639,100.0,73,11.4,587,91.9,566,88.6,21,3.3,52,8.1
11,01,01,02,2624,100.0,182,6.9,2551,97.2,2442,93.1,109,4.2,73,2.8
11,01,01,03,1588,100.0,400,25.2,1283,80.8,1188,74.8,95,6.0,305,19.2
11,01,02,04,8934,100.0,2750,30.8,7297,81.7,6184,69.2,1113,12.5,1637,18.3
11,01,02,05,7020,100.0,2243,32.0,5658,80.6,4777,68.0,881,12.5,1362,19.4
11,01,02,06,6109,100.0,1585,25.9,5107,83.6,4524,74.1,583,9.5,1002,16.4
11,01,02,07,7501,100.0,1929,25.7,6185,82.5,5572,74.3,613,8.2,1316,17.5
11,01,03,08,11762,100.0,3423,29.1,9811,83.4,8339,70.9,1472,12.5,1951,16.6
11,01,03,09,9717,100.0,2695,27.7,8090,83.3,7022,72.3,1068,11.0,1627,16.7
11,01,03,10,5736,100.0,1126,19.6,5001,87.2,4610,80.4,391,6.8,735,12.8
11,02,04,11,9464,100.0,2617,27.7,7578,80.1,6847,72.3,731,7.7,1886,19.9
11,02,04,12,6823,100.0,1514,22.2,5911,86.6,5309,77.8,602,8.8,912,13.4
11,02,05,13,3978,100.0,835,21.0,3348,84.2,3143,79.0,205,5.2,630,15.8
11,02,05,14,9637,100.0,2367,24.6,7837,81.3,7270,75.4,567,5.9,1800,18.7
11,02,05,15,14752,100.0,3934,26.7,12413,84.1,10818,73.3,1595,10.8,2339,15.9
11,02,05,16,4074,100.0,697,17.1,3734,91.7,3377,82.9,357,8.8,340,8.3
11,03,06,17,6327,100.0,2299,36.3,4879,77.1,4028,63.7,851,13.5,1448,22.9
11,03,06,18,16313,100.0,4517,27.7,13586,83.3,11796,72.3,1790,11.0,2727,16.7
11,03,06,19,11050,100.0,3581,32.4,8932,80.8,7469,67.6,1463,13.2,2118,19.2
11,03,07,20,6187,100.0,3618,58.5,2962,47.9,2569,41.5,393,6.4,3225,52.1
11,03,07,21,24862,100.0,6483,26.1,20443,82.2,18379,73.9,2064,8.3,4419,17.8
11,03,08,24,10063,100.0,3647,36.2,7815,77.7,6416,63.8,1399,13.9,2248,22.3
11,04,09,25,4183,100.0,986,23.6,3546,84.8,3197,76.4,349,8.3,637,15.2
11,04,09,26,29331,100.0,6625,22.6,24883,84.8,22706,77.4,2177,7.4,4448,15.2
11,04,10,22,5488,100.0,1913,34.9,4124,75.1,3575,65.1,549,10.0,1364,24.9
11,04,10,23,6748,100.0,2329,34.5,5390,79.9,4419,65.5,971,14.4,1358,20.1
11,04,10,27,3099,100.0,884,28.5,2525,81.5,2215,71.5,310,10.0,574,18.5
11,04,11,28,25716,100.0,6409,24.9,21929,85.3,19307,75.1,2622,10.2,3787,14.7
11,05,12,29,4174,100.0,866,20.7,3673,88.0,3308,79.3,365,8.7,501,12.0
11,05,13,30,9909,100.0,1975,19.9,8543,86.2,7934,80.1,609,6.1,1366,13.8
11,05,13,31,10604,100.0,1327,12.5,9937,93.7,9277,87.5,660,6.2,667,6.3
11,05,13,32,7040,100.0,947,13.5,6571,93.3,6093,86.5,478,6.8,469,6.7
12,10,31,15,7714,100.0,3322,43.1,5843,75.7,4392,56.9,1451,18.8,1871,24.3
12,10,31,16,9987,100.0,4829,48.4,7079,70.9,5158,51.6,1921,19.2,2908,29.1
12,10,31,17,10916,100.0,5826,53.4,7387,67.7,5090,46.6,2297,21.0,3529,32.3
12,10,32,18,13910,100.0,6136,44.1,10497,75.5,7774,55.9,2723,19.6,3413,24.5
12,10,32,19,8829,100.0,3953,44.8,6656,75.4,4876,55.2,1780,20.2,2173,24.6
12,10,32,20,4643,100.0,1409,30.3,3910,84.2,3234,69.7,676,14.6,733,15.8
12,21,41,25,7760,100.0,2519,32.5,6390,82.3,5241,67.5,1149,14.8,1370,17.7
12,21,41,26,8117,100.0,3183,39.2,6468,79.7,4934,60.8,1534,18.9,1649,20.3
12,21,44,21,2754,100.0,1038,37.7,2119,76.9,1716,62.3,403,14.6,635,23.1
12,21,44,22,8229,100.0,4813,58.5,5459,66.3,3416,41.5,2043,24.8,2770,33.7
12,21,44,23,5609,100.0,2321,41.4,4422,78.8,3288,58.6,1134,20.2,1187,21.2
12,21,44,24,10856,100.0,5576,51.4,7418,68.3,5280,48.6,2138,19.7,3438,31.7
12,21,45,27,10938,100.0,2496,22.8,9517,87.0,8442,77.2,1075,9.8,1421,13.0
12,21,45,28,240,100.0,101,42.1,173,72.1,139,57.9,34,14.2,67,27.9
12,22,42,29,6029,100.0,829,13.8,5705,94.6,5200,86.2,505,8.4,324,5.4
12,22,42,30,18085,100.0,2434,13.5,17109,94.6,15651,86.5,1458,8.1,976,5.4
12,23,11,01,16598,100.0,2367,14.3,15470,93.2,14231,85.7,1239,7.5,1128,6.8
12,23,11,02,16757,100.0,2226,13.3,15849,94.6,14531,86.7,1318,7.9,908,5.4
12,30,12,03,14800,100.0,4338,29.3,12212,82.5,10462,70.7,1750,11.8,2588,17.5
12,30,12,04,6216,100.0,1394,22.4,5572,89.6,4822,77.6,750,12.1,644,10.4
12,30,12,05,4982,100.0,945,19.0,4567,91.7,4037,81.0,530,10.6,415,8.3
12,30,12,06,5174,100.0,862,16.7,4871,94.1,4312,83.3,559,10.8,303,5.9
12,30,21,07,3082,100.0,1313,42.6,2521,81.8,1769,57.4,752,24.4,561,18.2
12,30,21,08,14888,100.0,6617,44.4,11606,78.0,8271,55.6,3335,22.4,3282,22.0
12,30,21,09,11713,100.0,6087,52.0,8701,74.3,5626,48.0,3075,26.3,3012,25.7
12,30,21,10,10575,100.0,5910,55.9,7510,71.0,4665,44.1,2845,26.9,3065,29.0
12,30,22,11,3313,100.0,956,28.9,2893,87.3,2357,71.1,536,16.2,420,12.7
12,30,22,12,5976,100.0,2882,48.2,4163,69.7,3094,51.8,1069,17.9,1813,30.3
12,30,43,13,6803,100.0,1741,25.6,5680,83.5,5062,74.4,618,9.1,1123,16.5
12,30,43,14,9732,100.0,1475,15.2,9018,92.7,8257,84.8,761,7.8,714,7.3
