district_id,forecast_area_id,district_region_id,planning_area_id,inhabitants,inhabitants_percentage,inhabitants_with_migration_background,inhabitants_with_migration_background_percentage,inhabitants_germans,inhabitants_germans_percentage,inhabitants_germans_without_migration_background,inhabitants_germans_without_migration_background_percentage,inhabitants_germans_with_migration_background,inhabitants_germans_with_migration_background_percentage,inhabitants_foreigners,inhabitants_foreigners_percentage
01,01,11,01,3445,100.0,2075,60.2,2040,59.2,1370,39.8,670,19.4,1405,40.8
01,01,11,02,188,100.0,71,37.8,135,71.8,117,62.2,18,9.6,53,28.2
01,01,11,03,5159,100.0,2979,57.7,3349,64.9,2180,42.3,1169,22.7,1810,35.1
01,01,11,04,4626,100.0,3005,65.0,2816,60.9,1621,35.0,1195,25.8,1810,39.1
01,01,11,05,1567,100.0,1047,66.8,778,49.6,520,33.2,258,16.5,789,50.4
01,01,12,01,2456,100.0,1494,60.8,1420,57.8,962,39.2,458,18.6,1036,42.2
01,01,12,02,654,100.0,315,48.2,422,64.5,339,51.8,83,12.7,232,35.5
01,01,12,03,1171,100.0,637,54.4,738,63.0,534,45.6,204,17.4,433,37.0
01,01,12,04,8461,100.0,4341,51.3,5537,65.4,4120,48.7,1417,16.7,2924,34.6
01,01,13,01,6910,100.0,3009,43.5,4778,69.1,3901,56.5,877,12.7,2132,30.9
01,01,13,02,12540,100.0,5095,40.6,9140,72.9,7445,59.4,1695,13.5,3400,27.1
01,01,13,03,10011,100.0,4811,48.1,6529,65.2,5200,51.9,1329,13.3,3482,34.8
01,01,13,04,8813,100.0,3832,43.5,6386,72.5,4981,56.5,1405,15.9,2427,27.5
01,01,13,05,8778,100.0,3700,42.2,6308,71.9,5078,57.8,1230,14.0,2470,28.1
01,01,13,06,10831,100.0,4939,45.6,7480,69.1,5892,54.4,1588,14.7,3351,30.9
01,01,14,01,18200,100.0,8085,44.4,12424,68.3,10115,55.6,2309,12.7,5776,31.7
01,01,14,02,13640,100.0,5578,40.9,9882,72.4,8062,59.1,1820,13.3,3758,27.6
01,02,21,01,3524,100.0,1913,54.3,2221,63.0,1611,45.7,610,17.3,1303,37.0
01,02,21,02,6809,100.0,4258,62.5,3866,56.8,2551,37.5,1315,19.3,2943,43.2
01,02,21,03,295,100.0,248,84.1,106,35.9,47,15.9,59,20.0,189,64.1
01,02,21,04,18823,100.0,9559,50.8,12577,66.8,9264,49.2,3313,17.6,6246,33.2
01,02,21,05,5365,100.0,3154,58.8,3382,63.0,2211,41.2,1171,21.8,1983,37.0
01,02,21,06,11459,100.0,4120,36.0,9077,79.2,7339,64.0,1738,15.2,2382,20.8
01,02,22,01,11048,100.0,5627,50.9,7568,68.5,5421,49.1,2147,19.4,3480,31.5
01,02,22,02,3580,100.0,2277,63.6,2190,61.2,1303,36.4,887,24.8,1390,38.8
01,02,22,03,7150,100.0,4304,60.2,4690,65.6,2846,39.8,1844,25.8,2460,34.4
01,02,22,04,6081,100.0,2661,43.8,4443,73.1,3420,56.2,1023,16.8,1638,26.9
01,02,22,05,3316,100.0,2109,63.6,2226,67.1,1207,36.4,1019,30.7,1090,32.9
01,02,22,06,3045,100.0,1304,42.8,2334,76.7,1741,57.2,593,19.5,711,23.3
01,02,22,07,5822,100.0,2797,48.0,3790,65.1,3025,52.0,765,13.1,2032,34.9
01,03,31,01,26956,100.0,17239,64.0,15621,57.9,9717,36.0,5904,21.9,11335,42.1
01,03,31,02,11853,100.0,7311,61.7,7283,61.4,4542,38.3,2741,23.1,4570,38.6
01,03,32,01,14303,100.0,9580,67.0,9841,68.8,4723,33.0,5118,35.8,4462,31.2
01,03,32,02,10509,100.0,6219,59.2,7319,69.6,4290,40.8,3029,28.8,3190,30.4
01,03,32,03,14657,100.0,9473,64.6,8720,59.5,5184,35.4,3536,24.1,5937,40.5
01,04,41,01,20929,100.0,10472,50.0,14261,68.1,10457,50.0,3804,18.2,6668,31.9
01,04,41,02,16616,100.0,7011,42.2,12454,75.0,9605,57.8,2849,17.1,4162,25.0
01,04,41,03,8809,100.0,4756,54.0,5492,62.3,4053,46.0,1439,16.3,3317,37.7
01,04,42,01,24103,100.0,16538,68.6,13543,56.2,7565,31.4,5978,24.8,10560,43.8
01,04,42,02,17188,100.0,10170,59.2,10062,58.5,7018,40.8,3044,17.7,7126,41.5
01,04,42,03,16058,100.0,9636,60.0,9705,60.4,6422,40.0,3283,20.4,6353,39.6
02,01,01,01,6482,100.0,4568,70.5,3802,58.6547361925332,1914,29.5279234804073,1888,29.1,2680,41.3
02,01,01,02,13770,100.0,9442,68.6,9112,66.1728395061728,4328,31.4306463326071,4784,34.7,4658,33.8
02,01,01,03,15183,100.0,10751,70.8,9746,64.1902127379306,4432,29.1905420536126,5314,35.0,5437,35.8
02,01,01,04,5095,100.0,3291,64.6,3472,68.1452404317959,1804,35.4072620215898,1668,32.7,1623,31.9
02,02,02,01,1860,100.0,719,38.7,1447,77.7956989247312,1141,61.3440860215054,306,16.5,413,22.2
02,02,02,02,6037,100.0,2683,44.4,4326,71.6581083319529,3354,55.5573960576445,972,16.1,1711,28.3
02,02,02,03,10965,100.0,4411,40.2,8246,75.202918376653,6554,59.7720018239854,1692,15.4,2719,24.8
02,02,02,04,12657,100.0,5504,43.5,9151,72.2999130915699,7153,56.5141818756419,1998,15.8,3506,27.7
02,02,02,05,15140,100.0,6417,42.4,11204,74.002642007926,8723,57.6155878467635,2481,16.4,3936,26.0
02,02,02,06,18988,100.0,8998,47.4,13643,71.8506425110596,9990,52.6121761112282,3653,19.2,5345,28.1
02,03,03,01,8893,100.0,5614,63.1,5538,62.2736984144833,3279,36.8716968402114,2259,25.4,3355,37.7
02,03,03,02,13096,100.0,7151,54.6,8806,67.2419059254734,5945,45.395540623091,2861,21.8,4290,32.8
02,03,04,01,15168,100.0,7473,49.3,10361,68.3082805907173,7695,50.7318037974684,2666,17.6,4807,31.7
02,03,04,02,11017,100.0,5650,51.3,7337,66.5970772442589,5367,48.715621312517,1970,17.9,3680,33.4
02,04,05,01,5427,100.0,1619,29.8,4544,83.7295006449235,3808,70.1676801179289,736,13.6,883,16.3
02,04,05,02,7558,100.0,2458,32.5,5982,79.1479227308812,5100,67.4781688277322,882,11.7,1576,20.9
02,04,05,03,11351,100.0,3282,28.9,9199,81.0413179455555,8069,71.0862479076733,1130,10.0,2152,19.0
02,04,07,01,13406,100.0,5991,44.7,9465,70.6027152021483,7415,55.3110547516038,2050,15.3,3941,29.4
02,04,07,02,11314,100.0,3572,31.6,8774,77.5499381297508,7742,68.4284956690826,1032,9.1,2540,22.5
02,04,07,03,1160,100.0,804,69.3,454,39.1379310344828,356,30.6896551724138,98,8.4,706,60.9
02,05,06,01,9268,100.0,3128,33.8,7057,76.1437203280104,6140,66.2494605092792,917,9.9,2211,23.9
02,05,06,02,21899,100.0,7217,33.0,16861,76.9943833051738,14682,67.0441572674551,2179,10.0,5038,23.0
02,05,08,01,20636,100.0,7739,37.5,15062,72.9889513471603,12897,62.4975770498159,2165,10.5,5574,27.0
02,05,08,02,21625,100.0,7541,34.9,16099,74.4462427745665,14084,65.128323699422,2015,9.3,5526,25.6
02,05,08,03,7719,100.0,2823,36.6,5702,73.8696722373364,4896,63.4279051690634,806,10.4,2017,26.1
02,05,08,04,4672,100.0,1042,22.3,4167,89.1909246575342,3630,77.6969178082192,537,11.5,505,10.8
03,01,01,01,4259,100.0,702,16.5,3803,89.3,3557,83.5,246,5.8,456,10.7
03,01,01,02,12606,100.0,2834,22.5,10419,82.7,9772,77.5,647,5.1,2187,17.3
03,01,01,04,229,100.0,45,19.7,202,88.2,184,80.3,18,7.9,27,11.8
03,02,02,03,2064,100.0,138,6.7,2002,97.0,1926,93.3,76,3.7,62,3.0
03,02,02,09,15170,100.0,2631,17.3,13643,89.9,12539,82.7,1104,7.3,1527,10.1
03,02,02,10,11472,100.0,1807,15.8,10448,91.1,9665,84.2,783,6.8,1024,8.9
03,02,03,07,18259,100.0,2485,13.6,17211,94.3,15774,86.4,1437,7.9,1048,5.7
03,03,04,05,11444,100.0,2129,18.6,10213,89.2,9315,81.4,898,7.8,1231,10.8
03,03,04,06,8235,100.0,746,9.1,7913,96.1,7489,90.9,424,5.1,322,3.9
03,03,07,11,6875,100.0,524,7.6,6674,97.1,6351,92.4,323,4.7,201,2.9
03,03,07,15,7869,100.0,1666,21.2,6690,85.0,6203,78.8,487,6.2,1179,15.0
03,03,07,16,1120,100.0,33,2.9,1111,99.2,1087,97.1,24,2.1,9,0.8
03,04,05,08,4551,100.0,946,20.8,4251,93.4,3605,79.2,646,14.2,300,6.6
03,04,05,12,10354,100.0,1908,18.4,9403,90.8,8446,81.6,957,9.2,951,9.2
03,04,05,13,3424,100.0,563,16.4,3153,92.1,2861,83.6,292,8.5,271,7.9
03,04,06,14,37024,100.0,6151,16.6,33629,90.8,30873,83.4,2756,7.4,3395,9.2
03,04,08,18,35345,100.0,6528,18.5,31211,88.3,28817,81.5,2394,6.8,4134,11.7
03,05,09,19,5140,100.0,692,13.5,4662,90.7,4448,86.5,214,4.2,478,9.3
03,05,09,20,7517,100.0,1216,16.2,6804,90.5,6301,83.8,503,6.7,713,9.5
03,05,09,23,9762,100.0,2349,24.1,8200,84.0,7413,75.9,787,8.1,1562,16.0
03,05,09,24,6287,100.0,1523,24.2,5245,83.4,4764,75.8,481,7.7,1042,16.6
03,05,09,25,9822,100.0,1941,19.8,8575,87.3,7881,80.2,694,7.1,1247,12.7
03,05,10,17,4249,100.0,975,22.9,3576,84.2,3274,77.1,302,7.1,673,15.8
03,05,10,21,6591,100.0,871,13.2,6009,91.2,5720,86.8,289,4.4,582,8.8
03,05,10,22,4664,100.0,518,11.1,4349,93.2,4146,88.9,203,4.4,315,6.8
03,06,11,26,15939,100.0,4959,31.1,12590,79.0,10980,68.9,1610,10.1,3349,21.0
03,06,11,31,10597,100.0,3628,34.2,8066,76.1,6969,65.8,1097,10.4,2531,23.9
03,06,12,27,14641,100.0,3992,27.3,12018,82.1,10649,72.7,1369,9.4,2623,17.9
03,06,12,28,12803,100.0,3282,25.6,10607,82.8,9521,74.4,1086,8.5,2196,17.2
03,06,13,32,22757,100.0,7391,32.5,17826,78.3,15366,67.5,2460,10.8,4931,21.7
03,06,14,29,10002,100.0,1784,17.8,8938,89.4,8218,82.2,720,7.2,1064,10.6
03,06,14,30,4055,100.0,1737,42.8,2610,64.4,2318,57.2,292,7.2,1445,35.6
03,06,14,34,6491,100.0,1924,29.6,5130,79.0,4567,70.4,563,8.7,1361,21.0
03,06,14,35,4020,100.0,1202,29.9,3224,80.2,2818,70.1,406,10.1,796,19.8
03,06,14,41,2741,100.0,755,27.5,2340,85.4,1986,72.5,354,12.9,401,14.6
03,07,15,36,11281,100.0,4217,37.4,8447,74.9,7064,62.6,1383,12.3,2834,25.1
03,07,15,37,15902,100.0,5665,35.6,12002,75.5,10237,64.4,1765,11.1,3900,24.5
03,07,16,33,3196,100.0,1005,31.4,2528,79.1,2191,68.6,337,10.5,668,20.9
03,07,16,38,17710,100.0,5806,32.8,13865,78.3,11904,67.2,1961,11.1,3845,21.7
03,07,16,39,12868,100.0,3577,27.8,10643,82.7,9291,72.2,1352,10.5,2225,17.3
04,01,01,01,10801,100.0,5307,49.1,7713,71.4,5494,50.9,2219,20.5,3088,28.6
04,01,01,02,814,100.0,349,42.9,528,64.9,465,57.1,63,7.7,286,35.1
04,01,01,03,7964,100.0,4415,55.4,5745,72.1,3549,44.6,2196,27.6,2219,27.9
04,02,02,04,189,100.0,70,37.0,150,79.4,119,63.0,31,16.4,39,20.6
04,02,02,05,1296,100.0,324,25.0,1118,86.3,972,75.0,146,11.3,178,13.7
04,02,02,06,2896,100.0,871,30.1,2337,80.7,2025,69.9,312,10.8,559,19.3
04,02,02,07,2539,100.0,801,31.5,2056,81.0,1738,68.5,318,12.5,483,19.0
04,02,02,08,2978,100.0,811,27.2,2571,86.3,2167,72.8,404,13.6,407,13.7
04,02,02,09,3249,100.0,1300,40.0,2234,68.8,1949,60.0,285,8.8,1015,31.2
04,02,03,10,811,100.0,534,65.8,349,43.0,277,34.2,72,8.9,462,57.0
04,02,03,11,15119,100.0,5157,34.1,12018,79.5,9962,65.9,2056,13.6,3101,20.5
04,02,03,12,5547,100.0,1826,32.9,4437,80.0,3721,67.1,716,12.9,1110,20.0
04,02,03,13,7249,100.0,2766,38.2,5566,76.8,4483,61.8,1083,14.9,1683,23.2
04,02,03,14,9,100.0,9,100.0,0,0.0,0,0.0,0,0.0,9,100.0
04,03,04,15,3346,100.0,1879,56.2,1897,56.7,1467,43.8,430,12.9,1449,43.3
04,03,04,16,10593,100.0,5154,48.7,7747,73.1,5439,51.3,2308,21.8,2846,26.9
04,03,04,17,10954,100.0,4286,39.1,8367,76.4,6668,60.9,1699,15.5,2587,23.6
04,03,05,18,9561,100.0,4428,46.3,6897,72.1,5133,53.7,1764,18.4,2664,27.9
04,03,05,19,5908,100.0,2753,46.6,4287,72.6,3155,53.4,1132,19.2,1621,27.4
04,03,06,20,8928,100.0,4068,45.6,6503,72.8,4860,54.4,1643,18.4,2425,27.2
04,03,06,21,3172,100.0,1858,58.6,1995,62.9,1314,41.4,681,21.5,1177,37.1
04,03,06,22,10910,100.0,5285,48.4,7805,71.5,5625,51.6,2180,20.0,3105,28.5
04,03,06,23,5071,100.0,2924,57.7,3398,67.0,2147,42.3,1251,24.7,1673,33.0
04,03,07,24,6576,100.0,2575,39.2,5014,76.2,4001,60.8,1013,15.4,1562,23.8
04,03,07,25,12431,100.0,5206,41.9,9092,73.1,7225,58.1,1867,15.0,3339,26.9
04,03,07,26,5735,100.0,2627,45.8,4100,71.5,3108,54.2,992,17.3,1635,28.5
04,03,08,27,12303,100.0,6780,55.1,7871,64.0,5523,44.9,2348,19.1,4432,36.0
04,03,08,28,9671,100.0,4532,46.9,6719,69.5,5139,53.1,1580,16.3,2952,30.5
04,03,09,29,6061,100.0,2677,44.2,4420,72.9,3384,55.8,1036,17.1,1641,27.1
04,03,09,30,5736,100.0,2679,46.7,4039,70.4,3057,53.3,982,17.1,1697,29.6
04,03,09,31,3725,100.0,2171,58.3,2237,60.1,1554,41.7,683,18.3,1488,39.9
04,03,10,32,15756,100.0,6935,44.0,11561,73.4,8821,56.0,2740,17.4,4195,26.6
04,04,11,33,106,100.0,75,70.8,34,32.1,31,29.2,3,2.8,72,67.9
04,04,11,34,5323,100.0,2190,41.1,4134,77.7,3133,58.9,1001,18.8,1189,22.3
04,04,11,35,2811,100.0,1047,37.2,2237,79.6,1764,62.8,473,16.8,574,20.4
04,04,11,36,3130,100.0,1155,36.9,2500,79.9,1975,63.1,525,16.8,630,20.1
04,04,11,37,8338,100.0,3300,39.6,6531,78.3,5038,60.4,1493,17.9,1807,21.7
04,04,12,38,6114,100.0,2195,35.9,5064,82.8,3919,64.1,1145,18.7,1050,17.2
04,04,12,39,319,100.0,236,74.0,107,33.5,83,26.0,24,7.5,212,66.5
04,04,12,40,1544,100.0,428,27.7,1326,85.9,1116,72.3,210,13.6,218,14.1
04,04,12,41,7042,100.0,1854,26.3,6009,85.3,5188,73.7,821,11.7,1033,14.7
04,04,13,42,4200,100.0,1486,35.4,3397,80.9,2714,64.6,683,16.3,803,19.1
04,04,13,43,3579,100.0,1155,32.3,2972,83.0,2424,67.7,548,15.3,607,17.0
04,04,13,44,10771,100.0,3094,28.7,8971,83.3,7677,71.3,1294,12.0,1800,16.7
04,05,14,45,6437,100.0,2907,45.2,4870,75.7,3530,54.8,1340,20.8,1567,24.3
04,05,14,46,10980,100.0,4985,45.4,8062,73.4,5995,54.6,2067,18.8,2918,26.6
04,05,14,47,5348,100.0,2288,42.8,3996,74.7,3060,57.2,936,17.5,1352,25.3
04,05,14,48,9342,100.0,4477,47.9,6519,69.8,4865,52.1,1654,17.7,2823,30.2
04,05,15,49,4696,100.0,2109,44.9,3378,71.9,2587,55.1,791,16.8,1318,28.1
04,05,15,50,5690,100.0,2469,43.4,4189,73.6,3221,56.6,968,17.0,1501,26.4
04,05,15,51,4557,100.0,2018,44.3,3392,74.4,2539,55.7,853,18.7,1165,25.6
04,05,16,52,9945,100.0,4045,40.7,7432,74.7,5900,59.3,1532,15.4,2513,25.3
04,05,16,53,7037,100.0,3086,43.9,5162,73.4,3951,56.1,1211,17.2,1875,26.6
04,05,16,54,3081,100.0,1160,37.7,2397,77.8,1921,62.3,476,15.4,684,22.2
04,05,16,55,7497,100.0,3336,44.5,5533,73.8,4161,55.5,1372,18.3,1964,26.2
04,05,16,56,7739,100.0,2608,33.7,6215,80.3,5131,66.3,1084,14.0,1524,19.7
04,06,17,57,68,100.0,21,30.9,54,79.4,47,69.1,7,10.3,14,20.6
05,01,01,01,10658,100.0,3170,29.7,9117,85.5,7488,70.3,1629,15.3,1541,14.5
05,01,01,02,8438,100.0,3071,36.4,6504,77.1,5367,63.6,1137,13.5,1934,22.9
05,01,01,03,7630,100.0,1504,19.7,6928,90.8,6126,80.3,802,10.5,702,9.2
05,01,02,04,3584,100.0,1581,44.1,2700,75.3,2003,55.9,697,19.4,884,24.7
05,01,02,05,2283,100.0,635,27.8,2032,89.0,1648,72.2,384,16.8,251,11.0
05,01,02,06,10738,100.0,4552,42.4,8291,77.2,6186,57.6,2105,19.6,2447,22.8
05,01,02,07,11609,100.0,6013,51.8,8869,76.4,5596,48.2,3273,28.2,2740,23.6
05,01,02,08,7705,100.0,2785,36.1,6031,78.3,4920,63.9,1111,14.4,1674,21.7
05,01,02,09,6112,100.0,2007,32.8,5127,83.9,4105,67.2,1022,16.7,985,16.1
05,01,03,10,3953,100.0,1577,39.9,2989,75.6,2376,60.1,613,15.5,964,24.4
05,01,03,11,5633,100.0,2859,50.8,4252,75.5,2774,49.2,1478,26.2,1381,24.5
05,01,03,12,7463,100.0,4309,57.7,4344,58.2,3154,42.3,1190,15.9,3119,41.8
05,01,03,13,6834,100.0,2972,43.5,4953,72.5,3862,56.5,1091,16.0,1881,27.5
05,01,03,14,12366,100.0,4941,40.0,9563,77.3,7425,60.0,2138,17.3,2803,22.7
05,01,03,39,972,100.0,663,68.2,364,37.4,309,31.8,55,5.7,608,62.6
05,02,04,15,3835,100.0,816,21.3,3588,93.6,3019,78.7,569,14.8,247,6.4
05,02,04,16,1703,100.0,96,5.6,1679,98.6,1607,94.4,72,4.2,24,1.4
05,02,04,17,5862,100.0,1800,30.7,5007,85.4,4062,69.3,945,16.1,855,14.6
05,02,04,18,4395,100.0,1198,27.3,3679,83.7,3197,72.7,482,11.0,716,16.3
05,02,04,19,7250,100.0,2288,31.6,6015,83.0,4962,68.4,1053,14.5,1235,17.0
05,02,04,20,1027,100.0,198,19.3,936,91.1,829,80.7,107,10.4,91,8.9
05,02,05,21,3260,100.0,908,27.9,2938,90.1,2352,72.1,586,18.0,322,9.9
05,02,05,22,7636,100.0,3715,48.7,5248,68.7,3921,51.3,1327,17.4,2388,31.3
05,02,05,23,12731,100.0,7631,59.9,8641,67.9,5100,40.1,3541,27.8,4090,32.1
05,02,05,24,6292,100.0,1439,22.9,5603,89.0,4853,77.1,750,11.9,689,11.0
05,02,06,25,7689,100.0,2959,38.5,5892,76.6,4730,61.5,1162,15.1,1797,23.4
05,02,06,26,18244,100.0,6581,36.1,14184,77.7,11663,63.9,2521,13.8,4060,22.3
05,02,06,27,4382,100.0,2022,46.1,3098,70.7,2360,53.9,738,16.8,1284,29.3
05,02,06,28,2022,100.0,525,26.0,1780,88.0,1497,74.0,283,14.0,242,12.0
05,02,06,29,4435,100.0,710,16.0,4101,92.5,3725,84.0,376,8.5,334,7.5
05,03,07,30,4064,100.0,2233,54.9,3289,80.9,1831,45.1,1458,35.9,775,19.1
05,03,07,31,11616,100.0,5062,43.6,9177,79.0,6554,56.4,2623,22.6,2439,21.0
05,03,08,32,12327,100.0,5849,47.4,8953,72.6,6478,52.6,2475,20.1,3374,27.4
05,03,08,33,504,100.0,236,46.8,387,76.8,268,53.2,119,23.6,117,23.2
05,04,09,34,3457,100.0,882,25.5,2963,85.7,2575,74.5,388,11.2,494,14.3
05,04,09,35,457,100.0,113,24.7,390,85.3,344,75.3,46,10.1,67,14.7
05,04,09,36,10142,100.0,1804,17.8,9561,94.3,8338,82.2,1223,12.1,581,5.7
05,04,09,37,2203,100.0,354,16.1,2077,94.3,1849,83.9,228,10.3,126,5.7
05,04,09,38,3686,100.0,527,14.3,3483,94.5,3159,85.7,324,8.8,203,5.5
06,01,01,01,6958,100.0,1860,26.7,6009,86.4,5098,73.3,911,13.1,949,13.6
06,01,01,02,8835,100.0,3209,36.3,7111,80.5,5626,63.7,1485,16.8,1724,19.5
06,01,01,03,6428,100.0,2077,32.3,5357,83.3,4351,67.7,1006,15.7,1071,16.7
06,01,02,04,6873,100.0,2414,35.1,5682,82.7,4459,64.9,1223,17.8,1191,17.3
06,01,02,05,9820,100.0,3212,32.7,8145,82.9,6608,67.3,1537,15.7,1675,17.1
06,01,02,06,7787,100.0,2347,30.1,6563,84.3,5440,69.9,1123,14.4,1224,15.7
06,01,02,07,8021,100.0,2755,34.3,6560,81.8,5266,65.7,1294,16.1,1461,18.2
06,01,02,08,6867,100.0,2144,31.2,5759,83.9,4723,68.8,1036,15.1,1108,16.1
06,01,02,09,9318,100.0,3287,35.3,7556,81.1,6031,64.7,1525,16.4,1762,18.9
06,01,02,10,4896,100.0,1387,28.3,4147,84.7,3509,71.7,638,13.0,749,15.3
06,02,03,01,5004,100.0,1205,24.1,4436,88.6,3799,75.9,637,12.7,568,11.4
06,02,03,02,6083,100.0,1871,30.8,4985,81.9,4212,69.2,773,12.7,1098,18.1
06,02,03,03,7364,100.0,2273,30.9,6170,83.8,5091,69.1,1079,14.7,1194,16.2
06,02,03,04,7261,100.0,2158,29.7,6172,85.0,5103,70.3,1069,14.7,1089,15.0
06,02,03,05,11461,100.0,3946,34.4,9360,81.7,7515,65.6,1845,16.1,2101,18.3
06,02,03,06,6393,100.0,1260,19.7,5836,91.3,5133,80.3,703,11.0,557,8.7
06,02,04,07,4662,100.0,2338,50.2,3448,74.0,2324,49.8,1124,24.1,1214,26.0
06,02,04,08,6971,100.0,2009,28.8,5891,84.5,4962,71.2,929,13.3,1080,15.5
06,02,04,09,8455,100.0,2227,26.3,7199,85.1,6228,73.7,971,11.5,1256,14.9
06,02,04,10,7097,100.0,1456,20.5,6254,88.1,5641,79.5,613,8.6,843,11.9
06,02,04,11,8636,100.0,2267,26.3,7562,87.6,6369,73.7,1193,13.8,1074,12.4
06,03,05,01,5760,100.0,1405,24.4,4898,85.0,4355,75.6,543,9.4,862,15.0
06,03,05,02,5633,100.0,1375,24.4,4903,87.0,4258,75.6,645,11.5,730,13.0
06,03,05,03,11807,100.0,3496,29.6,9990,84.6,8311,70.4,1679,14.2,1817,15.4
06,03,05,04,11133,100.0,2554,22.9,9858,88.5,8579,77.1,1279,11.5,1275,11.5
06,03,06,05,7133,100.0,1997,28.0,6051,84.8,5136,72.0,915,12.8,1082,15.2
06,03,06,06,5623,100.0,2193,39.0,4215,75.0,3430,61.0,785,14.0,1408,25.0
06,03,06,07,3148,100.0,1179,37.5,2308,73.3,1969,62.5,339,10.8,840,26.7
06,03,06,08,13784,100.0,3954,28.7,11908,86.4,9830,71.3,2078,15.1,1876,13.6
06,03,06,09,12206,100.0,3077,25.2,10540,86.4,9129,74.8,1411,11.6,1666,13.6
06,03,06,10,8491,100.0,2039,24.0,7414,87.3,6452,76.0,962,11.3,1077,12.7
06,04,07,01,10334,100.0,2377,23.0,8999,87.1,7957,77.0,1042,10.1,1335,12.9
06,04,07,02,5517,100.0,1332,24.1,4848,87.9,4185,75.9,663,12.0,669,12.1
06,04,07,03,11178,100.0,3295,29.5,8919,79.8,7883,70.5,1036,9.3,2259,20.2
06,04,08,04,7591,100.0,1424,18.8,6904,90.9,6167,81.2,737,9.7,687,9.1
06,04,08,05,5298,100.0,1192,22.5,4709,88.9,4106,77.5,603,11.4,589,11.1
06,04,08,06,7345,100.0,1246,17.0,6717,91.4,6099,83.0,618,8.4,628,8.6
06,04,08,07,5971,100.0,1468,24.6,5226,87.5,4503,75.4,723,12.1,745,12.5
06,04,08,08,4762,100.0,1782,37.4,4080,85.7,2980,62.6,1100,23.1,682,14.3
06,04,08,09,5007,100.0,1570,31.4,4055,81.0,3437,68.6,618,12.3,952,19.0
06,04,08,10,7160,100.0,2327,32.5,5885,82.2,4833,67.5,1052,14.7,1275,17.8
07,01,01,01,10138,100.0,5110,50.4,7011,69.2,5028,49.6,1983,19.6,3127,30.8
07,01,01,02,16550,100.0,9485,57.3,10680,64.5,7065,42.7,3615,21.8,5870,35.5
07,01,01,03,10542,100.0,4213,40.0,8012,76.0,6329,60.0,1683,16.0,2530,24.0
07,01,01,04,13685,100.0,7758,56.7,9079,66.3,5927,43.3,3152,23.0,4606,33.7
07,02,02,01,10620,100.0,3813,35.9,8551,80.5,6807,64.1,1744,16.4,2069,19.5
07,02,02,02,10488,100.0,4754,45.3,7590,72.4,5734,54.7,1856,17.7,2898,27.6
07,02,02,03,17904,100.0,7956,44.4,13241,74.0,9948,55.6,3293,18.4,4663,26.0
07,02,02,04,12137,100.0,4500,37.1,9520,78.4,7637,62.9,1883,15.5,2617,21.6
07,03,03,01,24771,100.0,7089,28.6,20849,84.2,17682,71.4,3167,12.8,3922,15.8
07,03,03,02,9409,100.0,3040,32.3,7802,82.9,6369,67.7,1433,15.2,1607,17.1
07,03,03,03,12248,100.0,5390,44.0,9490,77.5,6858,56.0,2632,21.5,2758,22.5
07,04,04,01,17602,100.0,6738,38.3,14315,81.3,10864,61.7,3451,19.6,3287,18.7
07,04,04,02,2312,100.0,498,21.5,2076,89.8,1814,78.5,262,11.3,236,10.2
07,04,04,03,24643,100.0,9544,38.7,19382,78.7,15099,61.3,4283,17.4,5261,21.3
07,04,04,04,5153,100.0,1404,27.2,4472,86.8,3749,72.8,723,14.0,681,13.2
07,04,04,05,11315,100.0,5166,45.7,8304,73.4,6149,54.3,2155,19.0,3011,26.6
07,04,04,06,4069,100.0,2328,57.2,2601,63.9,1741,42.8,860,21.1,1468,36.1
07,05,05,01,17118,100.0,7076,41.3,13381,78.2,10042,58.7,3339,19.5,3737,21.8
07,05,05,02,8225,100.0,3245,39.5,6350,77.2,4980,60.5,1370,16.7,1875,22.8
07,05,05,03,9165,100.0,3041,33.2,7689,83.9,6124,66.8,1565,17.1,1476,16.1
07,05,05,04,5693,100.0,1884,33.1,4838,85.0,3809,66.9,1029,18.1,855,15.0
07,05,05,05,10651,100.0,3151,29.6,9181,86.2,7500,70.4,1681,15.8,1470,13.8
07,05,05,06,2254,100.0,558,24.8,2028,90.0,1696,75.2,332,14.7,226,10.0
07,06,06,01,10194,100.0,4314,42.3,7770,76.2,5880,57.7,1890,18.5,2424,23.8
07,06,06,02,4792,100.0,1199,25.0,4256,88.8,3593,75.0,663,13.8,536,11.2
07,06,06,03,2845,100.0,1095,38.5,2361,83.0,1750,61.5,611,21.5,484,17.0
07,06,06,04,14506,100.0,5593,38.6,12270,84.6,8913,61.4,3357,23.1,2236,15.4
07,07,07,01,10540,100.0,2381,22.6,9456,89.7,8159,77.4,1297,12.3,1084,10.3
07,07,07,02,10925,100.0,2413,22.1,9981,91.4,8512,77.9,1469,13.4,944,8.6
07,07,07,03,8096,100.0,2297,28.4,7050,87.1,5799,71.6,1251,15.5,1046,12.9
07,07,07,04,8521,100.0,3392,39.8,6595,77.4,5129,60.2,1466,17.2,1926,22.6
07,07,07,05,7014,100.0,1332,19.0,6426,91.6,5682,81.0,744,10.6,588,8.4
07,07,07,06,3866,100.0,858,22.2,3362,87.0,3008,77.8,354,9.2,504,13.0
07,07,07,07,2993,100.0,551,18.4,2718,90.8,2442,81.6,276,9.2,275,9.2
08,01,01,15,891,100.0,389,43.7,642,72.1,502,56.3,140,15.7,249,27.9
08,01,01,16,3677,100.0,2155,58.6,2230,60.6,1522,41.4,708,19.3,1447,39.4
08,01,01,17,16014,100.0,8259,51.6,10519,65.7,7755,48.4,2764,17.3,5495,34.3
08,01,01,18,11833,100.0,7201,60.9,7415,62.7,4632,39.1,2783,23.5,4418,37.3
08,01,02,11,9873,100.0,5796,58.7,6048,61.3,4077,41.3,1971,20.0,3825,38.7
08,01,02,12,7385,100.0,5020,68.0,4864,65.9,2365,32.0,2499,33.8,2521,34.1
08,01,02,13,12288,100.0,6766,55.1,7996,65.1,5522,44.9,2474,20.1,4292,34.9
08,01,02,14,8439,100.0,4957,58.7,5126,60.7,3482,41.3,1644,19.5,3313,39.3
08,01,03,01,27602,100.0,13687,49.6,18845,68.3,13915,50.4,4930,17.9,8757,31.7
08,01,03,02,3880,100.0,1481,38.2,3013,77.7,2399,61.8,614,15.8,867,22.3
08,01,03,03,8389,100.0,5140,61.3,4984,59.4,3249,38.7,1735,20.7,3405,40.6
08,01,04,04,23433,100.0,12494,53.3,15384,65.7,10939,46.7,4445,19.0,8049,34.3
08,01,04,05,8945,100.0,4270,47.7,6184,69.1,4675,52.3,1509,16.9,2761,30.9
08,01,04,06,7148,100.0,4277,59.8,4335,60.6,2871,40.2,1464,20.5,2813,39.4
08,01,04,07,798,100.0,362,45.4,562,70.4,436,54.6,126,15.8,236,29.6
08,01,05,08,5785,100.0,4224,73.0,3710,64.1,1561,27.0,2149,37.1,2075,35.9
08,01,05,09,9299,100.0,6167,66.3,6597,70.9,3132,33.7,3465,37.3,2702,29.1
08,01,05,10,478,100.0,324,67.8,230,48.1,154,32.2,76,15.9,248,51.9
08,02,06,19,11607,100.0,6454,55.6,7741,66.7,5153,44.4,2588,22.3,3866,33.3
08,02,06,20,9269,100.0,4253,45.9,7177,77.4,5016,54.1,2161,23.3,2092,22.6
08,02,06,21,2342,100.0,615,26.3,2145,91.6,1727,73.7,418,17.8,197,8.4
08,02,06,22,14334,100.0,4170,29.1,12376,86.3,10164,70.9,2212,15.4,1958,13.7
08,02,06,23,1247,100.0,392,31.4,1076,86.3,855,68.6,221,17.7,171,13.7
08,02,06,24,1402,100.0,519,37.0,1232,87.9,883,63.0,349,24.9,170,12.1
08,02,06,25,3313,100.0,1050,31.7,2793,84.3,2263,68.3,530,16.0,520,15.7
08,02,07,26,8410,100.0,2278,27.1,7427,88.3,6132,72.9,1295,15.4,983,11.7
08,02,07,27,11898,100.0,3792,31.9,10107,84.9,8106,68.1,2001,16.8,1791,15.1
08,02,07,28,8837,100.0,4001,45.3,6837,77.4,4836,54.7,2001,22.6,2000,22.6
08,03,08,29,12546,100.0,6540,52.1,9862,78.6,6006,47.9,3856,30.7,2684,21.4
08,03,08,30,7258,100.0,3047,42.0,6064,83.5,4211,58.0,1853,25.5,1194,16.5
08,03,08,31,17703,100.0,9277,52.4,13900,78.5,8426,47.6,5474,30.9,3803,21.5
08,04,09,32,2826,100.0,947,33.5,2449,86.7,1879,66.5,570,20.2,377,13.3
08,04,09,33,4174,100.0,1405,33.7,3570,85.5,2769,66.3,801,19.2,604,14.5
08,04,09,34,2653,100.0,870,32.8,2290,86.3,1783,67.2,507,19.1,363,13.7
08,04,10,35,8324,100.0,2930,35.2,7044,84.6,5394,64.8,1650,19.8,1280,15.4
08,04,10,36,6814,100.0,1689,24.8,6114,89.7,5125,75.2,989,14.5,700,10.3
08,04,10,37,9937,100.0,2828,28.5,8641,87.0,7109,71.5,1532,15.4,1296,13.0
08,04,10,38,7067,100.0,1685,23.8,6530,92.4,5382,76.2,1148,16.2,537,7.6
08,04,10,39,3837,100.0,1162,30.3,3434,89.5,2675,69.7,759,19.8,403,10.5
08,04,10,40,7962,100.0,2046,25.7,7124,89.5,5916,74.3,1208,15.2,838,10.5
09,01,01,01,12810,100.0,4132,32.3,10313,80.5,8678,67.7,1635,12.8,2497,19.5
09,01,01,02,68,100.0,22,32.4,55,80.9,46,67.6,9,13.2,13,19.1
09,01,02,01,4378,100.0,796,18.2,3947,90.2,3582,81.8,365,8.3,431,9.8
09,01,02,02,6987,100.0,1302,18.6,6149,88.0,5685,81.4,464,6.6,838,12.0
09,01,03,01,15730,100.0,2673,17.0,14151,90.0,13057,83.0,1094,7.0,1579,10.0
09,01,03,02,3112,100.0,929,29.9,2594,83.4,2183,70.1,411,13.2,518,16.6
09,01,04,01,8444,100.0,986,11.7,7881,93.3,7458,88.3,423,5.0,563,6.7
09,01,04,02,11409,100.0,1826,16.0,10516,92.2,9583,84.0,933,8.2,893,7.8
09,02,05,01,7575,100.0,2390,31.6,5770,76.2,5185,68.4,585,7.7,1805,23.8
09,02,05,02,15925,100.0,3650,22.9,13432,84.3,12275,77.1,1157,7.3,2493,15.7
09,02,06,01,9268,100.0,2806,30.3,7106,76.7,6462,69.7,644,6.9,2162,23.3
09,02,06,02,3582,100.0,323,9.0,3407,95.1,3259,91.0,148,4.1,175,4.9
09,02,07,01,2913,100.0,1200,41.2,2018,69.3,1713,58.8,305,10.5,895,30.7
09,02,07,02,17021,100.0,3221,18.9,14747,86.6,13800,81.1,947,5.6,2274,13.4
09,02,08,01,2957,100.0,295,10.0,2781,94.0,2662,90.0,119,4.0,176,6.0
09,02,08,02,8177,100.0,1752,21.4,6934,84.8,6425,78.6,509,6.2,1243,15.2
09,03,09,01,14125,100.0,2081,14.7,13224,93.6,12044,85.3,1180,8.4,901,6.4
09,03,09,02,5639,100.0,884,15.7,5138,91.1,4755,84.3,383,6.8,501,8.9
09,03,09,03,8161,100.0,1618,19.8,7416,90.9,6543,80.2,873,10.7,745,9.1
09,03,10,01,13103,100.0,1764,13.5,12032,91.8,11339,86.5,693,5.3,1071,8.2
09,03,11,01,6784,100.0,933,13.8,6218,91.7,5851,86.2,367,5.4,566,8.3
09,03,12,01,1852,100.0,199,10.7,1782,96.2,1653,89.3,129,7.0,70,3.8
09,03,12,02,2572,100.0,258,10.0,2444,95.0,2314,90.0,130,5.1,128,5.0
09,04,13,01,10107,100.0,662,6.5,9799,97.0,9445,93.5,354,3.5,308,3.0
09,04,13,02,1907,100.0,198,10.4,1818,95.3,1709,89.6,109,5.7,89,4.7
09,04,14,01,5447,100.0,489,9.0,5229,96.0,4958,91.0,271,5.0,218,4.0
09,04,14,02,1558,100.0,236,15.1,1430,91.8,1322,84.9,108,6.9,128,8.2
09,04,14,03,4441,100.0,590,13.3,4046,91.1,3851,86.7,195,4.4,395,8.9
09,04,15,01,7294,100.0,1431,19.6,6379,87.5,5863,80.4,516,7.1,915,12.5
09,04,16,01,6798,100.0,541,8.0,6572,96.7,6257,92.0,315,4.6,226,3.3
09,05,17,01,4094,100.0,439,10.7,3824,93.4,3655,89.3,169,4.1,270,6.6
09,05,17,02,15051,100.0,1304,8.7,14422,95.8,13747,91.3,675,4.5,629,4.2
09,05,18,01,9523,100.0,936,9.8,9026,94.8,8587,90.2,439,4.6,497,5.2
09,05,19,01,11604,100.0,1668,14.4,10539,90.8,9936,85.6,603,5.2,1065,9.2
09,05,20,01,13273,100.0,1217,9.2,12618,95.1,12056,90.8,562,4.2,655,4.9
10,01,01,01,5687,100.0,1519,26.7,4855,85.4,4168,73.3,687,12.1,832,14.6
10,01,01,02,18471,100.0,4965,26.9,16004,86.6,13506,73.1,2498,13.5,2467,13.4
10,01,02,03,1308,100.0,838,64.1,527,40.3,470,35.9,57,4.4,781,59.7
10,01,02,04,10616,100.0,2647,24.9,9340,88.0,7969,75.1,1371,12.9,1276,12.0
10,01,02,05,8165,100.0,1380,16.9,7382,90.4,6785,83.1,597,7.3,783,9.6
10,01,02,06,17293,100.0,4436,25.7,14673,84.8,12857,74.3,1816,10.5,2620,15.2
10,01,02,07,10626,100.0,2644,24.9,9408,88.5,7982,75.1,1426,13.4,1218,11.5
10,01,03,08,2214,100.0,615,27.8,1849,83.5,1599,72.2,250,11.3,365,16.5
10,01,03,09,14605,100.0,3518,24.1,13062,89.4,11087,75.9,1975,13.5,1543,10.6
10,01,03,10,18340,100.0,4363,23.8,16123,87.9,13977,76.2,2146,11.7,2217,12.1
10,01,03,11,3696,100.0,531,14.4,3513,95.0,3165,85.6,348,9.4,183,5.0
10,02,04,12,7230,100.0,2342,32.4,5904,81.7,4888,67.6,1016,14.1,1326,18.3
10,02,04,13,16007,100.0,3604,22.5,13584,84.9,12403,77.5,1181,7.4,2423,15.1
10,02,04,14,1728,100.0,815,47.2,1322,76.5,913,52.8,409,23.7,406,23.5
10,02,04,15,5854,100.0,1918,32.8,4358,74.4,3936,67.2,422,7.2,1496,25.6
10,02,04,16,5654,100.0,1652,29.2,4507,79.7,4002,70.8,505,8.9,1147,20.3
10,02,05,17,9486,100.0,1596,16.8,8468,89.3,7890,83.2,578,6.1,1018,10.7
10,02,05,18,5318,100.0,1192,22.4,4513,84.9,4126,77.6,387,7.3,805,15.1
10,02,05,19,6052,100.0,1918,31.7,4754,78.6,4134,68.3,620,10.2,1298,21.4
10,02,06,20,3379,100.0,626,18.5,3062,90.6,2753,81.5,309,9.1,317,9.4
10,02,06,21,6317,100.0,1389,22.0,5439,86.1,4928,78.0,511,8.1,878,13.9
10,02,06,22,8547,100.0,1197,14.0,7974,93.3,7350,86.0,624,7.3,573,6.7
10,02,06,23,6537,100.0,886,13.6,6157,94.2,5651,86.4,506,7.7,380,5.8
10,03,07,24,7820,100.0,1420,18.2,6897,88.2,6400,81.8,497,6.4,923,11.8
10,03,07,25,6671,100.0,1382,20.7,5913,88.6,5289,79.3,624,9.4,758,11.4
10,03,07,26,3494,100.0,524,15.0,3234,92.6,2970,85.0,264,7.6,260,7.4
10,03,07,27,10084,100.0,1147,11.4,9654,95.7,8937,88.6,717,7.1,430,4.3
10,04,08,28,7800,100.0,723,9.3,7466,95.7,7077,90.7,389,5.0,334,4.3
10,04,08,29,3938,100.0,435,11.0,3667,93.1,3503,89.0,164,4.2,271,6.9
10,04,08,30,7670,100.0,541,7.1,7472,97.4,7129,92.9,343,4.5,198,2.6
10,04,09,31,9753,100.0,852,8.7,9405,96.4,8901,91.3,504,5.2,348,3.6
10,04,09,32,4295,100.0,421,9.8,4095,95.3,3874,90.2,221,5.1,200,4.7
10,04,09,33,15312,100.0,1181,7.7,14825,96.8,14131,92.3,694,4.5,487,3.2
11,01,01,01,644,100.0,72,11.2,595,92.4,572,88.8,23,3.6,49,7.6
11,01,01,02,2620,100.0,174,6.6,2550,97.3,2446,93.4,104,4.0,70,2.7
11,01,01,03,1870,100.0,533,28.5,1462,78.2,1337,71.5,125,6.7,408,21.8
11,01,02,04,8985,100.0,2826,31.5,7260,80.8,6159,68.5,1101,12.3,1725,19.2
11,01,02,05,7069,100.0,2320,32.8,5637,79.7,4749,67.2,888,12.6,1432,20.3
11,01,02,06,6127,100.0,1679,27.4,5027,82.0,4448,72.6,579,9.4,1100,18.0
11,01,02,07,7494,100.0,1984,26.5,6123,81.7,5510,73.5,613,8.2,1371,18.3
11,01,03,08,11760,100.0,3475,29.5,9752,82.9,8285,70.5,1467,12.5,2008,17.1
11,01,03,09,9675,100.0,2728,28.2,8019,82.9,6947,71.8,1072,11.1,1656,17.1
11,01,03,10,5727,100.0,1162,20.3,4960,86.6,4565,79.7,395,6.9,767,13.4
11,02,04,11,9618,100.0,2755,28.6,7621,79.2,6863,71.4,758,7.9,1997,20.8
11,02,04,12,6825,100.0,1520,22.3,5919,86.7,5305,77.7,614,9.0,906,13.3
11,02,05,13,3938,100.0,831,21.1,3308,84.0,3107,78.9,201,5.1,630,16.0
11,02,05,14,9729,100.0,2396,24.6,7924,81.4,7333,75.4,591,6.1,1805,18.6
11,02,05,15,14760,100.0,4034,27.3,12330,83.5,10726,72.7,1604,10.9,2430,16.5
11,02,05,16,4109,100.0,770,18.7,3722,90.6,3339,81.3,383,9.3,387,9.4
11,03,06,17,6313,100.0,2317,36.7,4846,76.8,3996,63.3,850,13.5,1467,23.2
11,03,06,18,16629,100.0,4849,29.2,13589,81.7,11780,70.8,1809,10.9,3040,18.3
11,03,06,19,11132,100.0,3682,33.1,8939,80.3,7450,66.9,1489,13.4,2193,19.7
11,03,07,20,6406,100.0,3707,57.9,3105,48.5,2699,42.1,406,6.3,3301,51.5
11,03,07,21,25243,100.0,6925,27.4,20477,81.1,18318,72.6,2159,8.6,4766,18.9
11,03,08,24,10109,100.0,3743,37.0,7780,77.0,6366,63.0,1414,14.0,2329,23.0
11,04,09,25,4231,100.0,1048,24.8,3551,83.9,3183,75.2,368,8.7,680,16.1
11,04,09,26,29596,100.0,6963,23.5,24908,84.2,22633,76.5,2275,7.7,4688,15.8
11,04,10,22,5457,100.0,1949,35.7,4064,74.5,3508,64.3,556,10.2,1393,25.5
11,04,10,23,6739,100.0,2386,35.4,5343,79.3,4353,64.6,990,14.7,1396,20.7
11,04,10,27,3181,100.0,952,29.9,2541,79.9,2229,70.1,312,9.8,640,20.1
11,04,11,28,25967,100.0,6738,25.9,21893,84.3,19229,74.1,2664,10.3,4074,15.7
11,05,12,29,4254,100.0,900,21.2,3723,87.5,3354,78.8,369,8.7,531,12.5
11,05,13,30,10218,100.0,2165,21.2,8698,85.1,8053,78.8,645,6.3,1520,14.9
11,05,13,31,10623,100.0,1362,12.8,9939,93.6,9261,87.2,678,6.4,684,6.4
11,05,13,32,7153,100.0,1027,14.4,6636,92.8,6126,85.6,510,7.1,517,7.2
12,10,31,15,7755,100.0,3408,43.9,5803,74.8,4347,56.1,1456,18.8,1952,25.2
12,10,31,16,10059,100.0,4966,49.4,7013,69.7,5093,50.6,1920,19.1,3046,30.3
12,10,31,17,10983,100.0,5958,54.2,7378,67.2,5025,45.8,2353,21.4,3605,32.8
12,10,32,18,14069,100.0,6372,45.3,10420,74.1,7697,54.7,2723,19.4,3649,25.9
12,10,32,19,8901,100.0,4078,45.8,6605,74.2,4823,54.2,1782,20.0,2296,25.8
12,10,32,20,4624,100.0,1428,30.9,3870,83.7,3196,69.1,674,14.6,754,16.3
12,21,41,25,7833,100.0,2575,32.9,6439,82.2,5258,67.1,1181,15.1,1394,17.8
12,21,41,26,8132,100.0,3252,40.0,6403,78.7,4880,60.0,1523,18.7,1729,21.3
12,21,44,21,2753,100.0,1073,39.0,2103,76.4,1680,61.0,423,15.4,650,23.6
12,21,44,22,8304,100.0,4946,59.6,5392,64.9,3358,40.4,2034,24.5,2912,35.1
12,21,44,23,5669,100.0,2400,42.3,4400,77.6,3269,57.7,1131,20.0,1269,22.4
12,21,44,24,10792,100.0,5586,51.8,7377,68.4,5206,48.2,2171,20.1,3415,31.6
12,21,45,27,11006,100.0,2613,23.7,9489,86.2,8393,76.3,1096,10.0,1517,13.8
12,21,45,28,269,100.0,116,43.1,200,74.3,153,56.9,47,17.5,69,25.7
12,22,42,29,6004,100.0,839,14.0,5667,94.4,5165,86.0,502,8.4,337,5.6
12,22,42,30,18100,100.0,2504,13.8,17095,94.4,15596,86.2,1499,8.3,1005,5.6
12,23,11,01,16607,100.0,2448,14.7,15452,93.0,14159,85.3,1293,7.8,1155,7.0
12,23,11,02,16814,100.0,2293,13.6,15882,94.5,14521,86.4,1361,8.1,932,5.5
12,30,12,03,14999,100.0,4620,30.8,12141,80.9,10379,69.2,1762,11.7,2858,19.1
12,30,12,04,6387,100.0,1485,23.3,5680,88.9,4902,76.7,778,12.2,707,11.1
12,30,12,05,4990,100.0,949,19.0,4576,91.7,4041,81.0,535,10.7,414,8.3
12,30,12,06,5203,100.0,885,17.0,4883,93.8,4318,83.0,565,10.9,320,6.2
12,30,21,07,3080,100.0,1315,42.7,2503,81.3,1765,57.3,738,24.0,577,18.7
12,30,21,08,14877,100.0,6648,44.7,11590,77.9,8229,55.3,3361,22.6,3287,22.1
12,30,21,09,11714,100.0,6135,52.4,8636,73.7,5579,47.6,3057,26.1,3078,26.3
12,30,21,10,10708,100.0,6063,56.6,7521,70.2,4645,43.4,2876,26.9,3187,29.8
12,30,22,11,3291,100.0,948,28.8,2885,87.7,2343,71.2,542,16.5,406,12.3
12,30,22,12,5983,100.0,2947,49.3,4119,68.8,3036,50.7,1083,18.1,1864,31.2
12,30,43,13,6756,100.0,1796,26.6,5582,82.6,4960,73.4,622,9.2,1174,17.4
12,30,43,14,9746,100.0,1517,15.6,9004,92.4,8229,84.4,775,8.0,742,7.6
