district_id,forecast_area_id,district_region_id,planning_area_id,inhabitants,inhabitants_percentage,inhabitants_with_migration_background,inhabitants_with_migration_background_percentage,inhabitants_germans,inhabitants_germans_percentage,inhabitants_germans_without_migration_background,inhabitants_germans_without_migration_background_percentage,inhabitants_germans_with_migration_background,inhabitants_germans_with_migration_background_percentage,inhabitants_foreigners,inhabitants_foreigners_percentage
01,10,01,01,3436,100.0,2092,60.9,2015,58.6,1344,39.1,671,19.5,1421,41.4
01,10,01,02,1791,100.0,1199,66.9,890,49.7,592,33.1,298,16.6,901,50.3
01,10,01,03,5251,100.0,3096,59.0,3347,63.7,2155,41.0,1192,22.7,1904,36.3
01,10,01,04,4677,100.0,3038,65.0,2847,60.9,1639,35.0,1208,25.8,1830,39.1
01,10,02,05,2732,100.0,1734,63.5,1443,52.8,998,36.5,445,16.3,1289,47.2
01,10,02,06,1823,100.0,957,52.5,1166,64.0,866,47.5,300,16.5,657,36.0
01,10,02,07,8379,100.0,4324,51.6,5496,65.6,4055,48.4,1441,17.2,2883,34.4
01,10,03,08,7032,100.0,3133,44.6,4800,68.3,3899,55.4,901,12.8,2232,31.7
01,10,03,09,12314,100.0,5046,41.0,8998,73.1,7268,59.0,1730,14.0,3316,26.9
01,10,03,10,10043,100.0,4958,49.4,6441,64.1,5085,50.6,1356,13.5,3602,35.9
01,10,03,11,9197,100.0,4254,46.3,6393,69.5,4943,53.7,1450,15.8,2804,30.5
01,10,03,12,9772,100.0,4445,45.5,6752,69.1,5327,54.5,1425,14.6,3020,30.9
01,10,03,13,10715,100.0,4941,46.1,7385,68.9,5774,53.9,1611,15.0,3330,31.1
01,10,04,14,5185,100.0,2761,53.2,3136,60.5,2424,46.8,712,13.7,2049,39.5
01,10,04,15,12666,100.0,5133,40.5,9238,72.9,7533,59.5,1705,13.5,3428,27.1
01,10,04,16,13435,100.0,5466,40.7,9785,72.8,7969,59.3,1816,13.5,3650,27.2
01,20,05,17,3723,100.0,2176,58.4,2214,59.5,1547,41.6,667,17.9,1509,40.5
01,20,05,18,6851,100.0,4341,63.4,3837,56.0,2510,36.6,1327,19.4,3014,44.0
01,20,05,19,9097,100.0,4912,54.0,5774,63.5,4185,46.0,1589,17.5,3323,36.5
01,20,05,20,9375,100.0,4513,48.1,6601,70.4,4862,51.9,1739,18.5,2774,29.6
01,20,05,21,5208,100.0,3070,58.9,3275,62.9,2138,41.1,1137,21.8,1933,37.1
01,20,05,22,11365,100.0,4042,35.6,9079,79.9,7323,64.4,1756,15.5,2286,20.1
01,20,06,23,10763,100.0,5439,50.5,7461,69.3,5324,49.5,2137,19.9,3302,30.7
01,20,06,24,5709,100.0,3896,68.2,3026,53.0,1813,31.8,1213,21.2,2683,47.0
01,20,06,25,6910,100.0,4133,59.8,4561,66.0,2777,40.2,1784,25.8,2349,34.0
01,20,06,26,5873,100.0,2503,42.6,4373,74.5,3370,57.4,1003,17.1,1500,25.5
01,20,06,27,3263,100.0,2098,64.3,2188,67.1,1165,35.7,1023,31.4,1075,32.9
01,20,06,28,3182,100.0,1386,43.6,2414,75.9,1796,56.4,618,19.4,768,24.1
01,20,06,29,5913,100.0,2862,48.4,3874,65.5,3051,51.6,823,13.9,2039,34.5
01,30,07,30,7990,100.0,5725,71.7,4234,53.0,2265,28.3,1969,24.6,3756,47.0
01,30,07,31,8533,100.0,4962,58.2,5332,62.5,3571,41.8,1761,20.6,3201,37.5
01,30,07,32,9837,100.0,6128,62.3,5949,60.5,3709,37.7,2240,22.8,3888,39.5
01,30,07,33,11523,100.0,7082,61.5,7160,62.1,4441,38.5,2719,23.6,4363,37.9
01,30,08,34,14263,100.0,9475,66.4,9902,69.4,4788,33.6,5114,35.9,4361,30.6
01,30,08,35,10426,100.0,6195,59.4,7255,69.6,4231,40.6,3024,29.0,3171,30.4
01,30,08,36,14594,100.0,9425,64.6,8750,60.0,5169,35.4,3581,24.5,5844,40.0
01,40,09,37,10640,100.0,5169,48.6,7512,70.6,5471,51.4,2041,19.2,3128,29.4
01,40,09,38,9708,100.0,5113,52.7,6367,65.6,4595,47.3,1772,18.3,3341,34.4
01,40,09,39,5921,100.0,3056,51.6,3796,64.1,2865,48.4,931,15.7,2125,35.9
01,40,09,40,6748,100.0,2461,36.5,5635,83.5,4287,63.5,1348,20.0,1113,16.5
01,40,09,41,3761,100.0,1678,44.6,2822,75.0,2083,55.4,739,19.6,939,25.0
01,40,09,42,8599,100.0,4626,53.8,5451,63.4,3973,46.2,1478,17.2,3148,36.6
01,40,10,43,7627,100.0,5113,67.0,4521,59.3,2514,33.0,2007,26.3,3106,40.7
01,40,10,44,10115,100.0,6825,67.5,5682,56.2,3290,32.5,2392,23.6,4433,43.8
01,40,10,45,5667,100.0,4121,72.7,3090,54.5,1546,27.3,1544,27.2,2577,45.5
01,40,10,46,8745,100.0,4359,49.8,5967,68.2,4386,50.2,1581,18.1,2778,31.8
01,40,10,47,7945,100.0,5552,69.9,3891,49.0,2393,30.1,1498,18.9,4054,51.0
01,40,10,48,9181,100.0,5478,59.7,5664,61.7,3703,40.3,1961,21.4,3517,38.3
01,40,10,49,6666,100.0,4031,60.5,3877,58.2,2635,39.5,1242,18.6,2789,41.8
02,10,01,01,6257,100.0,4352,69.6,3750,59.9,1905,30.4,1845,29.5,2507,40.1
02,10,01,02,8633,100.0,6069,70.3,5629,65.2,2564,29.7,3065,35.5,3004,34.8
02,10,01,03,5385,100.0,3401,63.2,3668,68.1,1984,36.8,1684,31.3,1717,31.9
02,10,01,04,5587,100.0,3842,68.8,3513,62.9,1745,31.2,1768,31.6,2074,37.1
02,10,01,05,9527,100.0,6743,70.8,6237,65.5,2784,29.2,3453,36.2,3290,34.5
02,10,01,06,5028,100.0,3245,64.5,3403,67.7,1783,35.5,1620,32.2,1625,32.3
02,20,02,07,2083,100.0,837,40.2,1601,76.9,1246,59.8,355,17.0,482,23.1
02,20,02,08,5922,100.0,2585,43.7,4276,72.2,3337,56.3,939,15.9,1646,27.8
02,20,02,09,10906,100.0,4463,40.9,8201,75.2,6443,59.1,1758,16.1,2705,24.8
02,20,02,10,12299,100.0,5358,43.6,8932,72.6,6941,56.4,1991,16.2,3367,27.4
02,20,02,11,14747,100.0,6160,41.8,11126,75.4,8587,58.2,2539,17.2,3621,24.6
02,20,02,12,8528,100.0,4292,50.3,6238,73.1,4236,49.7,2002,23.5,2290,26.9
02,20,02,13,10185,100.0,4633,45.5,7226,70.9,5552,54.5,1674,16.4,2959,29.1
02,30,03,14,7502,100.0,4541,60.5,4763,63.5,2961,39.5,1802,24.0,2739,36.5
02,30,03,15,8626,100.0,4921,57.0,5686,65.9,3705,43.0,1981,23.0,2940,34.1
02,30,03,16,4214,100.0,2076,49.3,2973,70.6,2138,50.7,835,19.8,1241,29.4
02,30,04,17,8268,100.0,4516,54.6,5481,66.3,3752,45.4,1729,20.9,2787,33.7
02,30,04,18,7705,100.0,3673,47.7,5398,70.1,4032,52.3,1366,17.7,2307,29.9
02,30,04,19,10728,100.0,5462,50.9,7193,67.0,5266,49.1,1927,18.0,3535,33.0
02,40,05,20,5641,100.0,1864,33.0,4505,79.9,3777,67.0,728,12.9,1136,20.1
02,40,05,21,7799,100.0,2649,34.0,6105,78.3,5150,66.0,955,12.2,1694,21.7
02,40,05,22,11268,100.0,3336,29.6,9106,80.8,7932,70.4,1174,10.4,2162,19.2
02,40,06,23,13331,100.0,6094,45.7,9329,70.0,7237,54.3,2092,15.7,4002,30.0
02,40,06,24,11270,100.0,3759,33.4,8545,75.8,7511,66.6,1034,9.2,2725,24.2
02,40,06,25,1119,100.0,767,68.5,446,39.9,352,31.5,94,8.4,673,60.1
02,50,07,26,9116,100.0,3313,36.3,6798,74.6,5803,63.7,995,10.9,2318,25.4
02,50,07,27,6567,100.0,2343,35.7,4928,75.0,4224,64.3,704,10.7,1639,25.0
02,50,07,28,10078,100.0,3342,33.2,7718,76.6,6736,66.8,982,9.7,2360,23.4
02,50,07,29,5436,100.0,1834,33.7,4245,78.1,3602,66.3,643,11.8,1191,21.9
02,50,08,30,3928,100.0,1523,38.8,2858,72.8,2405,61.2,453,11.5,1070,27.2
02,50,08,31,7910,100.0,3035,38.4,5737,72.5,4875,61.6,862,10.9,2173,27.5
02,50,08,32,9029,100.0,3801,42.1,6293,69.7,5228,57.9,1065,11.8,2736,30.3
02,50,08,33,10145,100.0,3811,37.6,7263,71.6,6334,62.4,929,9.2,2882,28.4
02,50,08,34,11421,100.0,3999,35.0,8672,75.9,7422,65.0,1250,10.9,2749,24.1
02,50,08,35,7930,100.0,3123,39.4,5687,71.7,4807,60.6,880,11.1,2243,28.3
02,50,08,36,4788,100.0,1108,23.1,4260,89.0,3680,76.9,580,12.1,528,11.0
03,10,01,01,4536,100.0,761,16.8,4038,89.0,3775,83.2,263,5.8,498,11.0
03,10,01,02,3173,100.0,819,25.8,2555,80.5,2354,74.2,201,6.3,618,19.5
03,10,01,03,8897,100.0,1566,17.6,7722,86.8,7331,82.4,391,4.4,1175,13.2
03,20,02,04,2055,100.0,130,6.3,2003,97.5,1925,93.7,78,3.8,52,2.5
03,20,02,05,8690,100.0,1351,15.5,7954,91.5,7339,84.5,615,7.1,736,8.5
03,20,02,06,6326,100.0,1234,19.5,5539,87.6,5092,80.5,447,7.1,787,12.4
03,20,02,07,11452,100.0,1923,16.8,10352,90.4,9529,83.2,823,7.2,1100,9.6
03,20,03,08,5223,100.0,671,12.8,4932,94.4,4552,87.2,380,7.3,291,5.6
03,20,03,09,5239,100.0,806,15.4,4803,91.7,4433,84.6,370,7.1,436,8.3
03,20,03,10,7969,100.0,1214,15.2,7442,93.4,6755,84.8,687,8.6,527,6.6
03,30,04,11,11271,100.0,2073,18.4,10074,89.4,9198,81.6,876,7.8,1197,10.6
03,30,04,12,5139,100.0,455,8.9,4939,96.1,4684,91.1,255,5.0,200,3.9
03,30,04,13,3116,100.0,262,8.4,3000,96.3,2854,91.6,146,4.7,116,3.7
03,30,05,14,6820,100.0,552,8.1,6566,96.3,6268,91.9,298,4.4,254,3.7
03,30,05,15,51,100.0,7,13.7,44,86.3,44,86.3,0,0.0,7,13.7
03,30,05,16,7764,100.0,1545,19.9,6703,86.3,6219,80.1,484,6.2,1061,13.7
03,30,05,17,1110,100.0,48,4.3,1089,98.1,1062,95.7,27,2.4,21,1.9
03,40,06,18,4835,100.0,1031,21.3,4472,92.5,3804,78.7,668,13.8,363,7.5
03,40,06,19,10366,100.0,1921,18.5,9381,90.5,8445,81.5,936,9.0,985,9.5
03,40,06,20,3534,100.0,661,18.7,3193,90.4,2873,81.3,320,9.1,341,9.6
03,40,07,21,11419,100.0,2359,20.7,10101,88.5,9060,79.3,1041,9.1,1318,11.5
03,40,07,22,3624,100.0,558,15.4,3347,92.4,3066,84.6,281,7.8,277,7.6
03,40,07,23,7051,100.0,1621,23.0,6099,86.5,5430,77.0,669,9.5,952,13.5
03,40,07,24,7588,100.0,1012,13.3,7003,92.3,6576,86.7,427,5.6,585,7.7
03,40,07,25,7423,100.0,937,12.6,6867,92.5,6486,87.4,381,5.1,556,7.5
03,40,08,26,6672,100.0,1271,19.0,5770,86.5,5401,81.0,369,5.5,902,13.5
03,40,08,27,9624,100.0,2271,23.6,8134,84.5,7353,76.4,781,8.1,1490,15.5
03,40,08,28,4806,100.0,1169,24.3,3982,82.9,3637,75.7,345,7.2,824,17.1
03,40,08,29,5529,100.0,939,17.0,4956,89.6,4590,83.0,366,6.6,573,10.4
03,40,08,30,9256,100.0,1483,16.0,8363,90.4,7773,84.0,590,6.4,893,9.6
03,40,08,31,0,100.0,0,0.0,0,0.0,0,0.0,0,0.0,0,0.0
03,50,09,32,5336,100.0,931,17.4,4633,86.8,4405,82.6,228,4.3,703,13.2
03,50,09,33,7569,100.0,1289,17.0,6751,89.2,6280,83.0,471,6.2,818,10.8
03,50,09,34,10186,100.0,2732,26.8,8347,81.9,7454,73.2,893,8.8,1839,18.1
03,50,09,35,6471,100.0,1684,26.0,5340,82.5,4787,74.0,553,8.5,1131,17.5
03,50,09,36,9797,100.0,2101,21.4,8443,86.2,7696,78.6,747,7.6,1354,13.8
03,50,10,37,8510,100.0,1653,19.4,7343,86.3,6857,80.6,486,5.7,1167,13.7
03,50,10,38,7451,100.0,1150,15.4,6642,89.1,6301,84.6,341,4.6,809,10.9
03,60,11,39,3771,100.0,1306,34.6,2890,76.6,2465,65.4,425,11.3,881,23.4
03,60,11,40,5914,100.0,1824,30.8,4696,79.4,4090,69.2,606,10.2,1218,20.6
03,60,11,41,6547,100.0,2206,33.7,5040,77.0,4341,66.3,699,10.7,1507,23.0
03,60,11,42,10654,100.0,3762,35.3,8076,75.8,6892,64.7,1184,11.1,2578,24.2
03,60,12,43,6958,100.0,2023,29.1,5644,81.1,4935,70.9,709,10.2,1314,18.9
03,60,12,44,7549,100.0,2016,26.7,6244,82.7,5533,73.3,711,9.4,1305,17.3
03,60,12,45,12754,100.0,3476,27.3,10387,81.4,9278,72.7,1109,8.7,2367,18.6
03,60,13,46,5623,100.0,1928,34.3,4346,77.3,3695,65.7,651,11.6,1277,22.7
03,60,13,47,9433,100.0,3042,32.2,7478,79.3,6391,67.8,1087,11.5,1955,20.7
03,60,13,48,7439,100.0,2487,33.4,5780,77.7,4952,66.6,828,11.1,1659,22.3
03,60,14,49,9896,100.0,1828,18.5,8704,88.0,8068,81.5,636,6.4,1192,12.0
03,60,14,50,3971,100.0,1701,42.8,2550,64.2,2270,57.2,280,7.1,1421,35.8
03,60,14,51,6340,100.0,1910,30.1,4980,78.5,4430,69.9,550,8.7,1360,21.5
03,60,14,52,4203,100.0,1398,33.3,3235,77.0,2805,66.7,430,10.2,968,23.0
03,60,14,53,2820,100.0,836,29.6,2398,85.0,1984,70.4,414,14.7,422,15.0
03,70,15,54,11363,100.0,4340,38.2,8512,74.9,7023,61.8,1489,13.1,2851,25.1
03,70,15,55,7244,100.0,2354,32.5,5704,78.7,4890,67.5,814,11.2,1540,21.3
03,70,15,56,8645,100.0,3425,39.6,6251,72.3,5220,60.4,1031,11.9,2394,27.7
03,70,16,57,3220,100.0,1064,33.0,2488,77.3,2156,67.0,332,10.3,732,22.7
03,70,16,58,8390,100.0,2738,32.6,6545,78.0,5652,67.4,893,10.6,1845,22.0
03,70,16,59,9123,100.0,3122,34.2,7118,78.0,6001,65.8,1117,12.2,2005,22.0
03,70,16,60,12737,100.0,3607,28.3,10521,82.6,9130,71.7,1391,10.9,2216,17.4
04,10,01,01,11476,100.0,5695,49.6,8057,70.2,5781,50.4,2276,19.8,3419,29.8
04,10,01,02,7796,100.0,4373,56.1,5592,71.7,3423,43.9,2169,27.8,2204,28.3
04,20,02,03,1462,100.0,400,27.4,1249,85.4,1062,72.6,187,12.8,213,14.6
04,20,02,04,2799,100.0,876,31.3,2228,79.6,1923,68.7,305,10.9,571,20.4
04,20,02,05,2511,100.0,784,31.2,2063,82.2,1727,68.8,336,13.4,448,17.8
04,20,02,06,2912,100.0,792,27.2,2517,86.4,2120,72.8,397,13.6,395,13.6
04,20,02,07,3166,100.0,1202,38.0,2252,71.1,1964,62.0,288,9.1,914,28.9
04,20,03,08,6423,100.0,2421,37.7,4787,74.5,4002,62.3,785,12.2,1636,25.5
04,20,03,09,6939,100.0,1937,27.9,5885,84.8,5002,72.1,883,12.7,1054,15.2
04,20,03,10,7791,100.0,2890,37.1,6107,78.4,4901,62.9,1206,15.5,1684,21.6
04,20,03,11,7309,100.0,2882,39.4,5555,76.0,4427,60.6,1128,15.4,1754,24.0
04,30,04,12,3478,100.0,1892,54.4,2114,60.8,1586,45.6,528,15.2,1364,39.2
04,30,04,13,10225,100.0,4885,47.8,7563,74.0,5340,52.2,2223,21.7,2662,26.0
04,30,04,14,10695,100.0,4096,38.3,8328,77.9,6599,61.7,1729,16.2,2367,22.1
04,30,04,15,6389,100.0,2445,38.3,4941,77.3,3944,61.7,997,15.6,1448,22.7
04,30,04,16,11955,100.0,4879,40.8,8995,75.2,7076,59.2,1919,16.1,2960,24.8
04,30,05,17,9610,100.0,4471,46.5,6921,72.0,5139,53.5,1782,18.5,2689,28.0
04,30,05,18,5808,100.0,2704,46.6,4217,72.6,3104,53.4,1113,19.2,1591,27.4
04,30,06,19,8748,100.0,3963,45.3,6444,73.7,4785,54.7,1659,19.0,2304,26.3
04,30,06,20,3439,100.0,2027,58.9,2189,63.7,1412,41.1,777,22.6,1250,36.3
04,30,06,21,10659,100.0,5147,48.3,7672,72.0,5512,51.7,2160,20.3,2987,28.0
04,30,06,22,5215,100.0,3004,57.6,3479,66.7,2211,42.4,1268,24.3,1736,33.3
04,30,06,23,12054,100.0,6562,54.4,7812,64.8,5492,45.6,2320,19.2,4242,35.2
04,30,06,24,9384,100.0,4287,45.7,6636,70.7,5097,54.3,1539,16.4,2748,29.3
04,40,07,25,124,100.0,85,68.5,45,36.3,39,31.5,6,4.8,79,63.7
04,40,07,26,5440,100.0,2295,42.2,4162,76.5,3145,57.8,1017,18.7,1278,23.5
04,40,07,27,8250,100.0,3279,39.7,6456,78.3,4971,60.3,1485,18.0,1794,21.7
04,40,07,28,3132,100.0,1152,36.8,2512,80.2,1980,63.2,532,17.0,620,19.8
04,40,07,29,2850,100.0,1061,37.2,2283,80.1,1789,62.8,494,17.3,567,19.9
04,40,08,30,7080,100.0,2790,39.4,5601,79.1,4290,60.6,1311,18.5,1479,20.9
04,40,08,31,1495,100.0,407,27.2,1296,86.7,1088,72.8,208,13.9,199,13.3
04,40,08,32,6943,100.0,1811,26.1,5961,85.9,5132,73.9,829,11.9,982,14.1
04,40,08,33,4177,100.0,1521,36.4,3349,80.2,2656,63.6,693,16.6,828,19.8
04,40,08,34,3526,100.0,1131,32.1,2949,83.6,2395,67.9,554,15.7,577,16.4
04,40,08,35,10484,100.0,2961,28.2,8817,84.1,7523,71.8,1294,12.3,1667,15.9
04,50,09,36,5625,100.0,2523,44.9,4107,73.0,3102,55.1,1005,17.9,1518,27.0
04,50,09,37,7648,100.0,3223,42.1,5740,75.1,4425,57.9,1315,17.2,1908,24.9
04,50,09,38,7837,100.0,3546,45.2,5765,73.6,4291,54.8,1474,18.8,2072,26.4
04,50,09,39,6460,100.0,2973,46.0,4874,75.4,3487,54.0,1387,21.5,1586,24.6
04,50,10,40,5910,100.0,2572,43.5,4395,74.4,3338,56.5,1057,17.9,1515,25.6
04,50,10,41,5464,100.0,2491,45.6,3946,72.2,2973,54.4,973,17.8,1518,27.8
04,50,10,42,3588,100.0,2045,57.0,2222,61.9,1543,43.0,679,18.9,1366,38.1
04,50,10,43,11039,100.0,5029,45.6,8138,73.7,6010,54.4,2128,19.3,2901,26.3
04,50,10,44,5241,100.0,2206,42.1,3965,75.7,3035,57.9,930,17.7,1276,24.3
04,50,10,45,9135,100.0,4315,47.2,6462,70.7,4820,52.8,1642,18.0,2673,29.3
04,50,11,46,4701,100.0,2145,45.6,3382,71.9,2556,54.4,826,17.6,1319,28.1
04,50,11,47,5525,100.0,2397,43.4,4119,74.6,3128,56.6,991,17.9,1406,25.4
04,50,11,48,4420,100.0,1958,44.3,3313,75.0,2462,55.7,851,19.3,1107,25.0
04,50,11,49,9826,100.0,3945,40.1,7436,75.7,5881,59.9,1555,15.8,2390,24.3
04,50,11,50,3050,100.0,1156,37.9,2355,77.2,1894,62.1,461,15.1,695,22.8
04,50,11,51,7465,100.0,2461,33.0,6058,81.2,5004,67.0,1054,14.1,1407,18.8
04,50,11,52,6871,100.0,2977,43.3,5062,73.7,3894,56.7,1168,17.0,1809,26.3
04,50,11,53,7462,100.0,3357,45.0,5538,74.2,4105,55.0,1433,19.2,1924,25.8
05,10,01,01,4061,100.0,730,18.0,3742,92.1,3331,82.0,411,10.1,319,7.9
05,10,01,02,4330,100.0,1016,23.5,3744,86.5,3314,76.5,430,9.9,586,13.5
05,10,01,03,5908,100.0,2769,46.9,4227,71.5,3139,53.1,1088,18.4,1681,28.5
05,10,01,04,4812,100.0,1931,40.1,3891,80.9,2881,59.9,1010,21.0,921,19.1
05,10,01,05,7567,100.0,1521,20.1,6849,90.5,6046,79.9,803,10.6,718,9.5
05,10,02,06,3565,100.0,1576,44.2,2685,75.3,1989,55.8,696,19.5,880,24.7
05,10,02,07,2286,100.0,632,27.6,2040,89.2,1654,72.4,386,16.9,246,10.8
05,10,02,08,10663,100.0,4768,44.7,8007,75.1,5895,55.3,2112,19.8,2656,24.9
05,10,02,09,11687,100.0,6102,52.2,8854,75.8,5585,47.8,3269,28.0,2833,24.2
05,10,02,10,7681,100.0,2898,37.7,5888,76.7,4783,62.3,1105,14.4,1793,23.3
05,10,02,11,6112,100.0,2062,33.7,5094,83.3,4050,66.3,1044,17.1,1018,16.7
05,10,03,12,4019,100.0,1675,41.7,2952,73.5,2344,58.3,608,15.1,1067,26.5
05,10,03,13,6092,100.0,3272,53.7,4315,70.8,2820,46.3,1495,24.5,1777,29.2
05,10,03,14,7332,100.0,4331,59.1,4166,56.8,3001,40.9,1165,15.9,3166,43.2
05,10,03,15,6837,100.0,3114,45.5,4813,70.4,3723,54.5,1090,15.9,2024,29.6
05,10,03,16,10295,100.0,4239,41.2,7960,77.3,6056,58.8,1904,18.5,2335,22.7
05,10,03,17,3570,100.0,1703,47.7,2278,63.8,1867,52.3,411,11.5,1292,36.2
05,20,04,18,3828,100.0,846,22.1,3571,93.3,2982,77.9,589,15.4,257,6.7
05,20,04,19,1686,100.0,101,6.0,1659,98.4,1585,94.0,74,4.4,27,1.6
05,20,04,20,5792,100.0,1813,31.3,4957,85.6,3979,68.7,978,16.9,835,14.4
05,20,04,21,4370,100.0,1264,28.9,3608,82.6,3106,71.1,502,11.5,762,17.4
05,20,04,22,1091,100.0,224,20.5,989,90.7,867,79.5,122,11.2,102,9.3
05,20,04,23,6571,100.0,2211,33.6,5310,80.8,4360,66.4,950,14.5,1261,19.2
05,20,05,24,3338,100.0,964,28.9,2962,88.7,2374,71.1,588,17.6,376,11.3
05,20,05,25,2437,100.0,634,26.0,2223,91.2,1803,74.0,420,17.2,214,8.8
05,20,05,26,5647,100.0,3204,56.7,3434,60.8,2443,43.3,991,17.5,2213,39.2
05,20,05,27,11456,100.0,7087,61.9,7579,66.2,4369,38.1,3210,28.0,3877,33.8
05,20,05,28,6949,100.0,1841,26.5,6035,86.8,5108,73.5,927,13.3,914,13.2
05,20,06,29,7988,100.0,3208,40.2,6025,75.4,4780,59.8,1245,15.6,1963,24.6
05,20,06,30,9793,100.0,3651,37.3,7487,76.5,6142,62.7,1345,13.7,2306,23.5
05,20,06,31,8450,100.0,3243,38.4,6376,75.5,5207,61.6,1169,13.8,2074,24.5
05,20,06,32,3671,100.0,1697,46.2,2602,70.9,1974,53.8,628,17.1,1069,29.1
05,20,06,33,2015,100.0,546,27.1,1762,87.4,1469,72.9,293,14.5,253,12.6
05,20,06,34,4412,100.0,703,15.9,4073,92.3,3709,84.1,364,8.3,339,7.7
05,30,07,35,2049,100.0,1253,61.2,1644,80.2,796,38.8,848,41.4,405,19.8
05,30,07,36,3657,100.0,1940,53.0,2817,77.0,1717,47.0,1100,30.1,840,23.0
05,30,07,37,11349,100.0,5082,44.8,8846,77.9,6267,55.2,2579,22.7,2503,22.1
05,30,08,38,22,100.0,0,0.0,22,100.0,22,100.0,0,0.0,0,0.0
05,30,08,39,7595,100.0,3713,48.9,5399,71.1,3882,51.1,1517,20.0,2196,28.9
05,30,08,40,477,100.0,232,48.6,359,75.3,245,51.4,114,23.9,118,24.7
05,30,08,41,4588,100.0,2140,46.6,3356,73.1,2448,53.4,908,19.8,1232,26.9
05,40,09,42,3662,100.0,743,20.3,3342,91.3,2919,79.7,423,11.6,320,8.7
05,40,09,43,10412,100.0,1956,18.8,9779,93.9,8456,81.2,1323,12.7,633,6.1
05,40,09,44,2216,100.0,382,17.2,2053,92.6,1834,82.8,219,9.9,163,7.4
05,40,09,45,3639,100.0,556,15.3,3425,94.1,3083,84.7,342,9.4,214,5.9
06,10,01,01,6881,100.0,1800,26.2,5973,86.8,5081,73.8,892,13.0,908,13.2
06,10,01,02,8744,100.0,3189,36.5,7059,80.7,5555,63.5,1504,17.2,1685,19.3
06,10,01,03,6212,100.0,1997,32.1,5204,83.8,4215,67.9,989,15.9,1008,16.2
06,10,02,04,6845,100.0,2459,35.9,5594,81.7,4386,64.1,1208,17.6,1251,18.3
06,10,02,05,9819,100.0,3264,33.2,8144,82.9,6555,66.8,1589,16.2,1675,17.1
06,10,02,06,7630,100.0,2293,30.1,6422,84.2,5337,69.9,1085,14.2,1208,15.8
06,10,02,07,7907,100.0,2669,33.8,6478,81.9,5238,66.2,1240,15.7,1429,18.1
06,10,02,08,6765,100.0,2090,30.9,5689,84.1,4675,69.1,1014,15.0,1076,15.9
06,10,02,09,9238,100.0,3310,35.8,7459,80.7,5928,64.2,1531,16.6,1779,19.3
06,10,02,10,4842,100.0,1448,29.9,4068,84.0,3394,70.1,674,13.9,774,16.0
06,20,03,11,4918,100.0,1173,23.9,4354,88.5,3745,76.1,609,12.4,564,11.5
06,20,03,12,6063,100.0,1936,31.9,4932,81.3,4127,68.1,805,13.3,1131,18.7
06,20,03,13,7373,100.0,2391,32.4,6111,82.9,4982,67.6,1129,15.3,1262,17.1
06,20,03,14,7262,100.0,2194,30.2,6146,84.6,5068,69.8,1078,14.8,1116,15.4
06,20,03,15,5766,100.0,1724,29.9,4902,85.0,4042,70.1,860,14.9,864,15.0
06,20,03,16,5374,100.0,2238,41.6,4186,77.9,3136,58.4,1050,19.5,1188,22.1
06,20,03,17,6373,100.0,1312,20.6,5781,90.7,5061,79.4,720,11.3,592,9.3
06,20,04,18,0,100.0,0,0.0,0,0.0,0,0.0,0,0.0,0,0.0
06,20,04,19,4623,100.0,2336,50.5,3411,73.8,2287,49.5,1124,24.3,1212,26.2
06,20,04,20,7113,100.0,2031,28.6,6028,84.7,5082,71.4,946,13.3,1085,15.3
06,20,04,21,8281,100.0,2181,26.3,7077,85.5,6100,73.7,977,11.8,1204,14.5
06,20,04,22,7075,100.0,1534,21.7,6168,87.2,5541,78.3,627,8.9,907,12.8
06,20,04,23,8572,100.0,2334,27.2,7449,86.9,6238,72.8,1211,14.1,1123,13.1
06,30,05,24,5658,100.0,1352,23.9,4845,85.6,4306,76.1,539,9.5,813,14.4
06,30,05,25,5555,100.0,1366,24.6,4798,86.4,4189,75.4,609,11.0,757,13.6
06,30,05,26,3299,100.0,1040,31.5,2731,82.8,2259,68.5,472,14.3,568,17.2
06,30,05,27,8377,100.0,2372,28.3,7193,85.9,6005,71.7,1188,14.2,1184,14.1
06,30,05,28,10981,100.0,2548,23.2,9781,89.1,8433,76.8,1348,12.3,1200,10.9
06,30,06,29,6992,100.0,1923,27.5,5970,85.4,5069,72.5,901,12.9,1022,14.6
06,30,06,30,5590,100.0,2175,38.9,4217,75.4,3415,61.1,802,14.3,1373,24.6
06,30,06,31,2921,100.0,1002,34.3,2249,77.0,1919,65.7,330,11.3,672,23.0
06,30,06,32,13532,100.0,3835,28.3,11813,87.3,9697,71.7,2116,15.6,1719,12.7
06,30,06,33,11970,100.0,3051,25.5,10336,86.3,8919,74.5,1417,11.8,1634,13.7
06,30,06,34,8428,100.0,1989,23.6,7400,87.8,6439,76.4,961,11.4,1028,12.2
06,40,07,35,10134,100.0,2288,22.6,8856,87.4,7846,77.4,1010,10.0,1278,12.6
06,40,07,36,5245,100.0,1089,20.8,4789,91.3,4156,79.2,633,12.1,456,8.7
06,40,07,37,11375,100.0,3481,30.6,8941,78.6,7894,69.4,1047,9.2,2434,21.4
06,40,08,38,7394,100.0,1348,18.2,6746,91.2,6046,81.8,700,9.5,648,8.8
06,40,08,39,5252,100.0,1171,22.3,4682,89.1,4081,77.7,601,11.4,570,10.9
06,40,08,40,7210,100.0,1178,16.3,6632,92.0,6032,83.7,600,8.3,578,8.0
06,40,08,41,5927,100.0,1482,25.0,5205,87.8,4445,75.0,760,12.8,722,12.2
06,40,08,42,4784,100.0,1769,37.0,4088,85.5,3015,63.0,1073,22.4,696,14.5
06,40,08,43,4808,100.0,1445,30.1,3964,82.4,3363,69.9,601,12.5,844,17.6
06,40,08,44,7159,100.0,2298,32.1,5956,83.2,4861,67.9,1095,15.3,1203,16.8
07,10,01,01,9797,100.0,4713,48.1,7055,72.0,5084,51.9,1971,20.1,2742,28.0
07,10,01,02,8595,100.0,4343,50.5,5752,66.9,4252,49.5,1500,17.5,2843,33.1
07,10,01,03,7752,100.0,4898,63.2,4937,63.7,2854,36.8,2083,26.9,2815,36.3
07,10,02,04,10439,100.0,4140,39.7,7974,76.4,6299,60.3,1675,16.0,2465,23.6
07,10,02,05,5206,100.0,3515,67.5,3228,62.0,1691,32.5,1537,29.5,1978,38.0
07,10,02,06,8253,100.0,4048,49.0,5832,70.7,4205,51.0,1627,19.7,2421,29.3
07,20,03,07,10582,100.0,3846,36.3,8499,80.3,6736,63.7,1763,16.7,2083,19.7
07,20,03,08,10481,100.0,4777,45.6,7601,72.5,5704,54.4,1897,18.1,2880,27.5
07,20,04,09,9373,100.0,3563,38.0,7333,78.2,5810,62.0,1523,16.2,2040,21.8
07,20,04,10,5551,100.0,3012,54.3,3859,69.5,2539,45.7,1320,23.8,1692,30.5
07,20,04,11,2751,100.0,1219,44.3,2044,74.3,1532,55.7,512,18.6,707,25.7
07,20,04,12,1500,100.0,894,59.6,912,60.8,606,40.4,306,20.4,588,39.2
07,20,04,13,7847,100.0,2760,35.2,6245,79.6,5087,64.8,1158,14.8,1602,20.4
07,20,04,14,3721,100.0,1457,39.2,2924,78.6,2264,60.8,660,17.7,797,21.4
07,30,05,15,6852,100.0,1746,25.5,6021,87.9,5106,74.5,915,13.4,831,12.1
07,30,05,16,8806,100.0,2565,29.1,7401,84.0,6241,70.9,1160,13.2,1405,16.0
07,30,05,17,8755,100.0,2594,29.6,7305,83.4,6161,70.4,1144,13.1,1450,16.6
07,30,06,18,9355,100.0,3004,32.1,7769,83.0,6351,67.9,1418,15.2,1586,17.0
07,30,06,19,12293,100.0,5514,44.9,9441,76.8,6779,55.1,2662,21.7,2852,23.2
07,40,07,20,11960,100.0,4920,41.1,9587,80.2,7040,58.9,2547,21.3,2373,19.8
07,40,07,21,5394,100.0,1723,31.9,4626,85.8,3671,68.1,955,17.7,768,14.2
07,40,08,22,2229,100.0,482,21.6,2012,90.3,1747,78.4,265,11.9,217,9.7
07,40,08,23,9745,100.0,3555,36.5,7894,81.0,6190,63.5,1704,17.5,1851,19.0
07,40,08,24,7343,100.0,2960,40.3,5664,77.1,4383,59.7,1281,17.4,1679,22.9
07,40,08,25,7335,100.0,3109,42.4,5588,76.2,4226,57.6,1362,18.6,1747,23.8
07,40,08,26,5087,100.0,1415,27.8,4403,86.6,3672,72.2,731,14.4,684,13.4
07,40,09,27,11065,100.0,5037,45.5,8183,74.0,6028,54.5,2155,19.5,2882,26.0
07,40,09,28,3928,100.0,2244,57.1,2518,64.1,1684,42.9,834,21.2,1410,35.9
07,50,10,29,8134,100.0,3417,42.0,6380,78.4,4717,58.0,1663,20.4,1754,21.6
07,50,10,30,8831,100.0,3776,42.8,6845,77.5,5055,57.2,1790,20.3,1986,22.5
07,50,10,31,8957,100.0,3032,33.9,7505,83.8,5925,66.1,1580,17.6,1452,16.2
07,50,10,32,5616,100.0,1909,34.0,4737,84.3,3707,66.0,1030,18.3,879,15.7
07,50,11,33,8097,100.0,3239,40.0,6217,76.8,4858,60.0,1359,16.8,1880,23.2
07,50,11,34,10540,100.0,3154,29.9,9058,85.9,7386,70.1,1672,15.9,1482,14.1
07,50,11,35,2223,100.0,527,23.7,1990,89.5,1696,76.3,294,13.2,233,10.5
07,60,12,36,10150,100.0,4349,42.8,7757,76.4,5801,57.2,1956,19.3,2393,23.6
07,60,12,37,4767,100.0,1239,26.0,4206,88.2,3528,74.0,678,14.2,561,11.8
07,60,12,38,2856,100.0,1143,40.0,2324,81.4,1713,60.0,611,21.4,532,18.6
07,60,13,39,5716,100.0,2342,41.0,4813,84.2,3374,59.0,1439,25.2,903,15.8
07,60,13,40,6406,100.0,2747,42.9,5283,82.5,3659,57.1,1624,25.4,1123,17.5
07,60,13,41,2249,100.0,676,30.1,1892,84.1,1573,69.9,319,14.2,357,15.9
07,60,14,42,10457,100.0,2429,23.2,9323,89.2,8028,76.8,1295,12.4,1134,10.8
07,60,14,43,10915,100.0,2548,23.3,9895,90.7,8367,76.7,1528,14.0,1020,9.3
07,60,15,44,8661,100.0,2685,31.0,7359,85.0,5976,69.0,1383,16.0,1302,15.0
07,60,15,45,8367,100.0,3392,40.5,6415,76.7,4975,59.5,1440,17.2,1952,23.3
07,60,15,46,6965,100.0,1405,20.2,6346,91.1,5560,79.8,786,11.3,619,8.9
07,60,15,47,3850,100.0,818,21.2,3368,87.5,3032,78.8,336,8.7,482,12.5
07,60,15,48,2942,100.0,557,18.9,2679,91.1,2385,81.1,294,10.0,263,8.9
08,10,01,01,4643,100.0,2627,56.6,2860,61.6,2016,43.4,844,18.2,1783,38.4
08,10,01,02,8179,100.0,4316,52.8,5303,64.8,3863,47.2,1440,17.6,2876,35.2
08,10,01,03,7370,100.0,3677,49.9,4976,67.5,3693,50.1,1283,17.4,2394,32.5
08,10,01,04,6653,100.0,3813,57.3,4270,64.2,2840,42.7,1430,21.5,2383,35.8
08,10,01,05,5659,100.0,3646,64.4,3494,61.7,2013,35.6,1481,26.2,2165,38.3
08,10,02,06,9575,100.0,5567,58.1,5964,62.3,4008,41.9,1956,20.4,3611,37.7
08,10,02,07,7460,100.0,4983,66.8,4926,66.0,2477,33.2,2449,32.8,2534,34.0
08,10,02,08,12275,100.0,6824,55.6,7924,64.6,5451,44.4,2473,20.1,4351,35.4
08,10,02,09,8458,100.0,5044,59.6,5060,59.8,3414,40.4,1646,19.5,3398,40.2
08,10,03,10,7805,100.0,3944,50.5,5402,69.2,3861,49.5,1541,19.7,2403,30.8
08,10,03,11,7313,100.0,3475,47.5,5056,69.1,3838,52.5,1218,16.7,2257,30.9
08,10,03,12,11863,100.0,6113,51.5,7885,66.5,5750,48.5,2135,18.0,3978,33.5
08,10,03,13,3858,100.0,1460,37.8,3015,78.1,2398,62.2,617,16.0,843,21.9
08,10,03,14,8118,100.0,4953,61.0,4853,59.8,3165,39.0,1688,20.8,3265,40.2
08,10,04,15,6475,100.0,3398,52.5,4316,66.7,3077,47.5,1239,19.1,2159,33.3
08,10,04,16,6517,100.0,3404,52.2,4378,67.2,3113,47.8,1265,19.4,2139,32.8
08,10,04,17,9807,100.0,5334,54.4,6333,64.6,4473,45.6,1860,19.0,3474,35.4
08,10,04,18,9537,100.0,4526,47.5,6642,69.6,5011,52.5,1631,17.1,2895,30.4
08,10,04,19,7079,100.0,4323,61.1,4181,59.1,2756,38.9,1425,20.1,2898,40.9
08,10,05,20,5780,100.0,4287,74.2,3660,63.3,1493,25.8,2167,37.5,2120,36.7
08,10,05,21,9580,100.0,6318,65.9,6723,70.2,3262,34.1,3461,36.1,2857,29.8
08,20,06,22,5610,100.0,3833,68.3,3124,55.7,1777,31.7,1347,24.0,2486,44.3
08,20,06,23,6051,100.0,2788,46.1,4513,74.6,3263,53.9,1250,20.7,1538,25.4
08,20,06,24,8732,100.0,4112,47.1,6652,76.2,4620,52.9,2032,23.3,2080,23.8
08,20,07,25,2464,100.0,784,31.8,2174,88.2,1680,68.2,494,20.0,290,11.8
08,20,07,26,6226,100.0,1816,29.2,5396,86.7,4410,70.8,986,15.8,830,13.3
08,20,07,27,7962,100.0,2402,30.2,6853,86.1,5560,69.8,1293,16.2,1109,13.9
08,20,07,28,1226,100.0,391,31.9,1056,86.1,835,68.1,221,18.0,170,13.9
08,20,07,29,1841,100.0,669,36.3,1586,86.1,1172,63.7,414,22.5,255,13.9
08,20,07,30,3382,100.0,1137,33.6,2790,82.5,2245,66.4,545,16.1,592,17.5
08,20,08,31,8335,100.0,2381,28.6,7300,87.6,5954,71.4,1346,16.1,1035,12.4
08,20,08,32,11529,100.0,3662,31.8,9972,86.5,7867,68.2,2105,18.3,1557,13.5
08,20,08,33,8658,100.0,4057,46.9,6598,76.2,4601,53.1,1997,23.1,2060,23.8
08,30,09,34,12518,100.0,6615,52.8,9789,78.2,5903,47.2,3886,31.0,2729,21.8
08,30,09,35,7329,100.0,3244,44.3,6012,82.0,4085,55.7,1927,26.3,1317,18.0
08,30,10,36,7176,100.0,3476,48.4,5684,79.2,3700,51.6,1984,27.6,1492,20.8
08,30,10,37,10577,100.0,6135,58.0,8069,76.3,4442,42.0,3627,34.3,2508,23.7
08,40,11,38,2880,100.0,974,33.8,2481,86.1,1906,66.2,575,20.0,399,13.9
08,40,11,39,4121,100.0,1422,34.5,3513,85.2,2699,65.5,814,19.8,608,14.8
08,40,11,40,2664,100.0,938,35.2,2249,84.4,1726,64.8,523,19.6,415,15.6
08,40,12,41,8181,100.0,2950,36.1,6932,84.7,5231,63.9,1701,20.8,1249,15.3
08,40,12,42,6819,100.0,1768,25.9,6098,89.4,5051,74.1,1047,15.4,721,10.6
08,40,12,43,9982,100.0,3008,30.1,8567,85.8,6974,69.9,1593,16.0,1415,14.2
08,40,12,44,7133,100.0,1792,25.1,6554,91.9,5341,74.9,1213,17.0,579,8.1
08,40,12,45,3744,100.0,1160,31.0,3319,88.6,2584,69.0,735,19.6,425,11.4
08,40,12,46,7929,100.0,2167,27.3,7029,88.6,5762,72.7,1267,16.0,900,11.4
09,10,01,01,13153,100.0,4334,33.0,10586,80.5,8819,67.0,1767,13.4,2567,19.5
09,10,02,02,4334,100.0,852,19.7,3865,89.2,3482,80.3,383,8.8,469,10.8
09,10,02,03,6895,100.0,1342,19.5,5985,86.8,5553,80.5,432,6.3,910,13.2
09,10,03,04,11702,100.0,2051,17.5,10424,89.1,9651,82.5,773,6.6,1278,10.9
09,10,03,05,4030,100.0,801,19.9,3531,87.6,3229,80.1,302,7.5,499,12.4
09,10,03,06,3047,100.0,922,30.3,2538,83.3,2125,69.7,413,13.6,509,16.7
09,10,04,07,8426,100.0,1061,12.6,7775,92.3,7365,87.4,410,4.9,651,7.7
09,10,04,08,8168,100.0,1334,16.3,7370,90.2,6834,83.7,536,6.6,798,9.8
09,10,04,09,3572,100.0,771,21.6,3262,91.3,2801,78.4,461,12.9,310,8.7
09,20,05,10,7577,100.0,2546,33.6,5642,74.5,5031,66.4,611,8.1,1935,25.5
09,20,05,11,12604,100.0,3011,23.9,10536,83.6,9593,76.1,943,7.5,2068,16.4
09,20,05,12,3579,100.0,987,27.6,2876,80.4,2592,72.4,284,7.9,703,19.6
09,20,06,13,9613,100.0,3065,31.9,7224,75.1,6548,68.1,676,7.0,2389,24.9
09,20,06,14,3561,100.0,331,9.3,3349,94.0,3230,90.7,119,3.3,212,6.0
09,20,07,15,3100,100.0,1327,42.8,2111,68.1,1773,57.2,338,10.9,989,31.9
09,20,07,16,7592,100.0,1658,21.8,6354,83.7,5934,78.2,420,5.5,1238,16.3
09,20,07,17,9535,100.0,1839,19.3,8208,86.1,7696,80.7,512,5.4,1327,13.9
09,20,08,18,3187,100.0,400,12.6,2918,91.6,2787,87.4,131,4.1,269,8.4
09,20,08,19,8347,100.0,1917,23.0,6957,83.3,6430,77.0,527,6.3,1390,16.7
09,30,09,20,12163,100.0,2227,18.3,11039,90.8,9936,81.7,1103,9.1,1124,9.2
09,30,09,21,2721,100.0,357,13.1,2544,93.5,2364,86.9,180,6.6,177,6.5
09,30,09,22,5761,100.0,1121,19.5,5036,87.4,4640,80.5,396,6.9,725,12.6
09,30,09,23,8014,100.0,1603,20.0,7313,91.3,6411,80.0,902,11.3,701,8.7
09,30,10,24,2495,100.0,291,11.7,2359,94.5,2204,88.3,155,6.2,136,5.5
09,30,10,25,10898,100.0,1657,15.2,9810,90.0,9241,84.8,569,5.2,1088,10.0
09,30,11,26,7343,100.0,1157,15.8,6609,90.0,6186,84.2,423,5.8,734,10.0
09,30,12,27,1877,100.0,175,9.3,1808,96.3,1702,90.7,106,5.6,69,3.7
09,30,12,28,2627,100.0,281,10.7,2474,94.2,2346,89.3,128,4.9,153,5.8
09,40,13,29,10128,100.0,677,6.7,9732,96.1,9451,93.3,281,2.8,396,3.9
09,40,13,30,1900,100.0,198,10.4,1802,94.8,1702,89.6,100,5.3,98,5.2
09,40,14,31,5396,100.0,467,8.7,5153,95.5,4929,91.3,224,4.2,243,4.5
09,40,14,32,1570,100.0,253,16.1,1416,90.2,1317,83.9,99,6.3,154,9.8
09,40,14,33,4334,100.0,562,13.0,3931,90.7,3772,87.0,159,3.7,403,9.3
09,40,15,34,7340,100.0,1521,20.7,6323,86.1,5819,79.3,504,6.9,1017,13.9
09,40,16,35,6851,100.0,574,8.4,6599,96.3,6277,91.6,322,4.7,252,3.7
09,50,17,36,4597,100.0,495,10.8,4272,92.9,4102,89.2,170,3.7,325,7.1
09,50,17,37,14440,100.0,1203,8.3,13786,95.5,13237,91.7,549,3.8,654,4.5
09,50,18,38,9937,100.0,994,10.0,9393,94.5,8943,90.0,450,4.5,544,5.5
09,50,19,39,6402,100.0,1085,16.9,5669,88.6,5317,83.1,352,5.5,733,11.4
09,50,19,40,2684,100.0,440,16.4,2379,88.6,2244,83.6,135,5.0,305,11.4
09,50,19,41,2762,100.0,354,12.8,2529,91.6,2408,87.2,121,4.4,233,8.4
09,50,20,42,4150,100.0,439,10.6,3862,93.1,3711,89.4,151,3.6,288,6.9
09,50,20,43,9132,100.0,783,8.6,8670,94.9,8349,91.4,321,3.5,462,5.1
10,10,01,01,5666,100.0,1616,28.5,4720,83.3,4050,71.5,670,11.8,946,16.7
10,10,01,02,3400,100.0,990,29.1,2713,79.8,2410,70.9,303,8.9,687,20.2
10,10,01,03,7647,100.0,2009,26.3,6535,85.5,5638,73.7,897,11.7,1112,14.5
10,10,01,04,7606,100.0,2211,29.1,6621,87.0,5395,70.9,1226,16.1,985,13.0
10,10,02,05,1203,100.0,790,65.7,466,38.7,413,34.3,53,4.4,737,61.3
10,10,02,06,10956,100.0,2890,26.4,9382,85.6,8066,73.6,1316,12.0,1574,14.4
10,10,02,07,8220,100.0,1438,17.5,7339,89.3,6782,82.5,557,6.8,881,10.7
10,10,02,08,9283,100.0,2355,25.4,7919,85.3,6928,74.6,991,10.7,1364,14.7
10,10,02,09,8067,100.0,2096,26.0,6770,83.9,5971,74.0,799,9.9,1297,16.1
10,10,02,10,10704,100.0,2808,26.2,9249,86.4,7896,73.8,1353,12.6,1455,13.6
10,10,03,11,2228,100.0,635,28.5,1842,82.7,1593,71.5,249,11.2,386,17.3
10,10,03,12,15039,100.0,4069,27.1,12851,85.5,10970,72.9,1881,12.5,2188,14.5
10,10,03,13,4729,100.0,1414,29.9,3841,81.2,3315,70.1,526,11.1,888,18.8
10,10,03,14,6318,100.0,1227,19.4,5682,89.9,5091,80.6,591,9.4,636,10.1
10,10,03,15,7132,100.0,1859,26.1,6237,87.5,5273,73.9,964,13.5,895,12.5
10,10,03,16,3726,100.0,544,14.6,3510,94.2,3182,85.4,328,8.8,216,5.8
10,20,04,17,7185,100.0,2436,33.9,5774,80.4,4749,66.1,1025,14.3,1411,19.6
10,20,04,18,5418,100.0,710,13.1,4994,92.2,4708,86.9,286,5.3,424,7.8
10,20,04,19,3558,100.0,1460,41.0,2537,71.3,2098,59.0,439,12.3,1021,28.7
10,20,04,20,7188,100.0,1931,26.9,5685,79.1,5257,73.1,428,6.0,1503,20.9
10,20,04,21,1741,100.0,895,51.4,1212,69.6,846,48.6,366,21.0,529,30.4
10,20,04,22,6548,100.0,2544,38.9,4490,68.6,4004,61.1,486,7.4,2058,31.4
10,20,04,23,5888,100.0,1860,31.6,4590,78.0,4028,68.4,562,9.5,1298,22.0
10,20,05,24,10436,100.0,2283,21.9,8830,84.6,8153,78.1,677,6.5,1606,15.4
10,20,05,25,5306,100.0,1388,26.2,4303,81.1,3918,73.8,385,7.3,1003,18.9
10,20,05,26,6071,100.0,2090,34.4,4569,75.3,3981,65.6,588,9.7,1502,24.7
10,20,06,27,3450,100.0,742,21.5,3010,87.2,2708,78.5,302,8.8,440,12.8
10,20,06,28,6438,100.0,1640,25.5,5332,82.8,4798,74.5,534,8.3,1106,17.2
10,20,06,29,8987,100.0,1529,17.0,8111,90.3,7458,83.0,653,7.3,876,9.7
10,20,06,30,6476,100.0,883,13.6,6027,93.1,5593,86.4,434,6.7,449,6.9
10,30,07,31,7653,100.0,1224,16.0,6894,90.1,6429,84.0,465,6.1,759,9.9
10,30,07,32,6923,100.0,1529,22.1,6062,87.6,5394,77.9,668,9.6,861,12.4
10,30,07,33,4229,100.0,844,20.0,3775,89.3,3385,80.0,390,9.2,454,10.7
10,30,07,34,10323,100.0,1239,12.0,9778,94.7,9084,88.0,694,6.7,545,5.3
10,40,08,35,7812,100.0,711,9.1,7449,95.4,7101,90.9,348,4.5,363,4.6
10,40,08,36,3858,100.0,418,10.8,3585,92.9,3440,89.2,145,3.8,273,7.1
10,40,08,37,7736,100.0,516,6.7,7550,97.6,7220,93.3,330,4.3,186,2.4
10,40,09,38,9938,100.0,807,8.1,9611,96.7,9131,91.9,480,4.8,327,3.3
10,40,09,39,4438,100.0,506,11.4,4165,93.8,3932,88.6,233,5.3,273,6.2
10,40,09,40,5727,100.0,371,6.5,5548,96.9,5356,93.5,192,3.4,179,3.1
10,40,09,41,9680,100.0,786,8.1,9364,96.7,8894,91.9,470,4.9,316,3.3
11,10,01,01,3260,100.0,258,7.9,3125,95.9,3002,92.1,123,3.8,135,4.1
11,10,01,02,2087,100.0,564,27.0,1671,80.1,1523,73.0,148,7.1,416,19.9
11,10,02,03,8939,100.0,2997,33.5,7018,78.5,5942,66.5,1076,12.0,1921,21.5
11,10,02,04,7055,100.0,2373,33.6,5528,78.4,4682,66.4,846,12.0,1527,21.6
11,10,02,05,6133,100.0,1788,29.2,4927,80.3,4345,70.8,582,9.5,1206,19.7
11,10,02,06,7604,100.0,2234,29.4,5966,78.5,5370,70.6,596,7.8,1638,21.5
11,10,03,07,11724,100.0,3588,30.6,9539,81.4,8136,69.4,1403,12.0,2185,18.6
11,10,03,08,9573,100.0,2783,29.1,7773,81.2,6790,70.9,983,10.3,1800,18.8
11,10,03,09,5996,100.0,1379,23.0,5005,83.5,4617,77.0,388,6.5,991,16.5
11,20,04,10,10046,100.0,3099,30.8,7746,77.1,6947,69.2,799,8.0,2300,22.9
11,20,04,11,6800,100.0,1575,23.2,5826,85.7,5225,76.8,601,8.8,974,14.3
11,20,05,12,3860,100.0,749,19.4,3277,84.9,3111,80.6,166,4.3,583,15.1
11,20,05,13,10112,100.0,2800,27.7,7927,78.4,7312,72.3,615,6.1,2185,21.6
11,20,05,14,15428,100.0,4571,29.6,12506,81.1,10857,70.4,1649,10.7,2922,18.9
11,20,05,15,4119,100.0,856,20.8,3653,88.7,3263,79.2,390,9.5,466,11.3
11,30,06,16,5998,100.0,2143,35.7,4681,78.0,3855,64.3,826,13.8,1317,22.0
11,30,06,17,4254,100.0,1101,25.9,3643,85.6,3153,74.1,490,11.5,611,14.4
11,30,06,18,3686,100.0,1008,27.3,2993,81.2,2678,72.7,315,8.5,693,18.8
11,30,06,19,8388,100.0,2839,33.8,6468,77.1,5549,66.2,919,11.0,1920,22.9
11,30,06,20,11235,100.0,3823,34.0,8827,78.6,7412,66.0,1415,12.6,2408,21.4
11,30,07,21,5243,100.0,3231,61.6,2321,44.3,2012,38.4,309,5.9,2922,55.7
11,30,07,22,10089,100.0,2497,24.7,8663,85.9,7592,75.3,1071,10.6,1426,14.1
11,30,07,23,2285,100.0,1479,64.7,1035,45.3,806,35.3,229,10.0,1250,54.7
11,30,07,24,3995,100.0,1048,26.2,3288,82.3,2947,73.8,341,8.5,707,17.7
11,30,07,25,9771,100.0,2180,22.3,8331,85.3,7591,77.7,740,7.6,1440,14.7
11,30,08,26,9851,100.0,3651,37.1,7528,76.4,6200,62.9,1328,13.5,2323,23.6
11,40,09,27,4212,100.0,1050,24.9,3536,84.0,3162,75.1,374,8.9,676,16.0
11,40,09,28,2383,100.0,754,31.6,1865,78.3,1629,68.4,236,9.9,518,21.7
11,40,09,29,16154,100.0,4264,26.4,13099,81.1,11890,73.6,1209,7.5,3055,18.9
11,40,09,30,4664,100.0,761,16.3,4217,90.4,3903,83.7,314,6.7,447,9.6
11,40,09,31,6743,100.0,1814,26.9,5559,82.4,4929,73.1,630,9.3,1184,17.6
11,40,10,32,5942,100.0,2171,36.5,4347,73.2,3771,63.5,576,9.7,1595,26.8
11,40,10,33,6728,100.0,2490,37.0,5233,77.8,4238,63.0,995,14.8,1495,22.2
11,40,10,34,3310,100.0,1044,31.5,2587,78.2,2266,68.5,321,9.7,723,21.8
11,40,11,35,10496,100.0,3252,31.0,8450,80.5,7244,69.0,1206,11.5,2046,19.5
11,40,11,36,8041,100.0,1790,22.3,6688,83.2,6251,77.7,437,5.4,1353,16.8
11,40,11,37,8693,100.0,2835,32.6,6908,79.5,5858,67.4,1050,12.1,1785,20.5
11,50,12,38,4254,100.0,945,22.2,3704,87.1,3309,77.8,395,9.3,550,12.9
11,50,13,39,10271,100.0,2302,22.4,8664,84.4,7969,77.6,695,6.8,1607,15.6
11,50,13,40,10543,100.0,1346,12.8,9842,93.4,9197,87.2,645,6.1,701,6.6
11,50,13,41,7343,100.0,1126,15.3,6712,91.4,6217,84.7,495,6.7,631,8.6
12,10,01,01,10927,100.0,6061,55.5,7250,66.3,4866,44.5,2384,21.8,3677,33.7
12,10,01,02,9911,100.0,5009,50.5,6800,68.6,4902,49.5,1898,19.2,3111,31.4
12,10,01,03,7624,100.0,3407,44.7,5640,74.0,4217,55.3,1423,18.7,1984,26.0
12,10,02,04,8844,100.0,4200,47.5,6467,73.1,4644,52.5,1823,20.6,2377,26.9
12,10,02,05,14024,100.0,6555,46.7,10207,72.8,7469,53.3,2738,19.5,3817,27.2
12,10,02,06,4634,100.0,1515,32.7,3810,82.2,3119,67.3,691,14.9,824,17.8
12,20,03,07,2727,100.0,1098,40.3,2040,74.8,1629,59.7,411,15.1,687,25.2
12,20,03,08,5644,100.0,2469,43.7,4313,76.4,3175,56.3,1138,20.2,1331,23.6
12,20,03,09,10740,100.0,5819,54.2,7087,66.0,4921,45.8,2166,20.2,3653,34.0
12,20,03,10,8241,100.0,4985,60.5,5229,63.5,3256,39.5,1973,23.9,3012,36.5
12,20,04,11,364,100.0,257,70.6,199,54.7,107,29.4,92,25.3,165,45.3
12,20,04,12,6313,100.0,2191,34.7,5123,81.2,4122,65.3,1001,15.9,1190,18.8
12,20,04,13,8016,100.0,3333,41.6,6216,77.5,4683,58.4,1533,19.1,1800,22.5
12,20,04,14,1407,100.0,372,26.4,1219,86.6,1035,73.6,184,13.1,188,13.4
12,20,05,15,10928,100.0,2591,23.7,9411,86.1,8337,76.3,1074,9.8,1517,13.9
12,40,06,16,5973,100.0,847,14.2,5624,94.2,5126,85.8,498,8.3,349,5.8
12,40,06,17,6822,100.0,946,13.9,6469,94.8,5876,86.1,593,8.7,353,5.2
12,40,06,18,3744,100.0,598,16.0,3507,93.7,3146,84.0,361,9.6,237,6.3
12,40,06,19,7706,100.0,1097,14.2,7218,93.7,6609,85.8,609,7.9,488,6.3
12,40,07,20,8592,100.0,1135,13.2,8157,94.9,7457,86.8,700,8.1,435,5.1
12,40,07,21,8000,100.0,1157,14.5,7481,93.5,6843,85.5,638,8.0,519,6.5
12,40,07,22,8562,100.0,1211,14.1,8006,93.5,7351,85.9,655,7.7,556,6.5
12,40,07,23,8096,100.0,1295,16.0,7490,92.5,6801,84.0,689,8.5,606,7.5
12,50,08,24,9670,100.0,1588,16.4,8898,92.0,8082,83.6,816,8.4,772,8.0
12,50,08,25,6735,100.0,1865,27.7,5492,81.5,4870,72.3,622,9.2,1243,18.5
12,50,09,26,5071,100.0,1428,28.2,4246,83.7,3643,71.8,603,11.9,825,16.3
12,50,09,27,6355,100.0,1537,24.2,5615,88.4,4818,75.8,797,12.5,740,11.6
12,50,09,28,5148,100.0,1011,19.6,4688,91.1,4137,80.4,551,10.7,460,8.9
12,50,09,29,5147,100.0,882,17.1,4824,93.7,4265,82.9,559,10.9,323,6.3
12,50,09,30,10181,100.0,3627,35.6,7795,76.6,6554,64.4,1241,12.2,2386,23.4
12,60,10,31,3263,100.0,964,29.5,2820,86.4,2299,70.5,521,16.0,443,13.6
12,60,10,32,5910,100.0,2986,50.5,4040,68.4,2924,49.5,1116,18.9,1870,31.6
12,60,11,33,11520,100.0,6043,52.5,8469,73.5,5477,47.5,2992,26.0,3051,26.5
12,60,11,34,15181,100.0,7066,46.5,11607,76.5,8115,53.5,3492,23.0,3574,23.5
12,60,12,35,10583,100.0,6123,57.9,7339,69.3,4460,42.1,2879,27.2,3244,30.7
12,60,12,36,3127,100.0,1346,43.0,2555,81.7,1781,57.0,774,24.8,572,18.3
