district_id,forecast_area_id,district_region_id,planning_area_id,inhabitants,inhabitants_percentage,inhabitants_with_migration_background,inhabitants_with_migration_background_percentage,inhabitants_germans,inhabitants_germans_percentage,inhabitants_germans_without_migration_background,inhabitants_germans_without_migration_background_percentage,inhabitants_germans_with_migration_background,inhabitants_germans_with_migration_background_percentage,inhabitants_foreigners,inhabitants_foreigners_percentage
01,10,01,01,3561,100.0,2282,64.1,2019,56.7,1279,35.9,740,20.8,1542,43.3
01,10,01,02,2002,100.0,1418,70.8,912,45.6,584,29.2,328,16.4,1090,54.4
01,10,01,03,5662,100.0,3472,61.3,3475,61.4,2190,38.7,1285,22.7,2187,38.6
01,10,01,04,5029,100.0,3363,66.9,2928,58.2,1666,33.1,1262,25.1,2101,41.8
01,10,02,05,3009,100.0,2046,68.0,1435,47.7,963,32.0,472,15.7,1574,52.3
01,10,02,06,1915,100.0,1072,56.0,1170,61.1,843,44.0,327,17.1,745,38.9
01,10,02,07,8801,100.0,4924,55.9,5500,62.5,3877,44.1,1623,18.4,3301,37.5
01,10,03,08,7384,100.0,3591,48.6,4837,65.5,3793,51.4,1044,14.1,2547,34.5
01,10,03,09,12559,100.0,5427,43.2,8979,71.5,7132,56.8,1847,14.7,3580,28.5
01,10,03,10,10332,100.0,5465,52.9,6362,61.6,4867,47.1,1495,14.5,3970,38.4
01,10,03,11,9649,100.0,4986,51.7,6353,65.8,4663,48.3,1690,17.5,3296,34.2
01,10,03,12,10213,100.0,5087,49.8,6799,66.6,5126,50.2,1673,16.4,3414,33.4
01,10,03,13,11160,100.0,5494,49.2,7378,66.1,5666,50.8,1712,15.3,3782,33.9
01,10,04,14,5556,100.0,3232,58.2,3112,56.0,2324,41.8,788,14.2,2444,44.0
01,10,04,15,13339,100.0,5950,44.6,9245,69.3,7389,55.4,1856,13.9,4094,30.7
01,10,04,16,13527,100.0,5860,43.3,9593,70.9,7667,56.7,1926,14.2,3934,29.1
01,20,05,17,4078,100.0,2573,63.1,2177,53.4,1505,36.9,672,16.5,1901,46.6
01,20,05,18,6970,100.0,4503,64.6,3851,55.3,2467,35.4,1384,19.9,3119,44.7
01,20,05,19,9533,100.0,5408,56.7,5787,60.7,4125,43.3,1662,17.4,3746,39.3
01,20,05,20,9548,100.0,4724,49.5,6614,69.3,4824,50.5,1790,18.7,2934,30.7
01,20,05,21,5307,100.0,3238,61.0,3243,61.1,2069,39.0,1174,22.1,2064,38.9
01,20,05,22,11621,100.0,4456,38.3,8975,77.2,7165,61.7,1810,15.6,2646,22.8
01,20,06,23,10969,100.0,5810,53.0,7364,67.1,5159,47.0,2205,20.1,3605,32.9
01,20,06,24,6504,100.0,4691,72.1,3168,48.7,1813,27.9,1355,20.8,3336,51.3
01,20,06,25,6970,100.0,4236,60.8,4520,64.8,2734,39.2,1786,25.6,2450,35.2
01,20,06,26,5949,100.0,2661,44.7,4290,72.1,3288,55.3,1002,16.8,1659,27.9
01,20,06,27,3424,100.0,2314,67.6,2194,64.1,1110,32.4,1084,31.7,1230,35.9
01,20,06,28,3275,100.0,1499,45.8,2432,74.3,1776,54.2,656,20.0,843,25.7
01,20,06,29,5956,100.0,2948,49.5,3918,65.8,3008,50.5,910,15.3,2038,34.2
01,30,07,30,7967,100.0,5796,72.8,4167,52.3,2171,27.2,1996,25.1,3800,47.7
01,30,07,31,8826,100.0,5411,61.3,5276,59.8,3415,38.7,1861,21.1,3550,40.2
01,30,07,32,9949,100.0,6367,64.0,5846,58.8,3582,36.0,2264,22.8,4103,41.2
01,30,07,33,11658,100.0,7362,63.1,7096,60.9,4296,36.9,2800,24.0,4562,39.1
01,30,08,34,14379,100.0,9694,67.4,9866,68.6,4685,32.6,5181,36.0,4513,31.4
01,30,08,35,10872,100.0,6726,61.9,7287,67.0,4146,38.1,3141,28.9,3585,33.0
01,30,08,36,15051,100.0,10035,66.7,8710,57.9,5016,33.3,3694,24.5,6341,42.1
01,40,09,37,10885,100.0,5618,51.6,7357,67.6,5267,48.4,2090,19.2,3528,32.4
01,40,09,38,9695,100.0,5259,54.2,6291,64.9,4436,45.8,1855,19.1,3404,35.1
01,40,09,39,6003,100.0,3279,54.6,3686,61.4,2724,45.4,962,16.0,2317,38.6
01,40,09,40,6882,100.0,2772,40.3,5624,81.7,4110,59.7,1514,22.0,1258,18.3
01,40,09,41,3898,100.0,1887,48.4,2815,72.2,2011,51.6,804,20.6,1083,27.8
01,40,09,42,8746,100.0,4910,56.1,5385,61.6,3836,43.9,1549,17.7,3361,38.4
01,40,10,43,7768,100.0,5329,68.6,4466,57.5,2439,31.4,2027,26.1,3302,42.5
01,40,10,44,10274,100.0,7122,69.3,5619,54.7,3152,30.7,2467,24.0,4655,45.3
01,40,10,45,5682,100.0,4179,73.5,3083,54.3,1503,26.5,1580,27.8,2599,45.7
01,40,10,46,8933,100.0,4607,51.6,5941,66.5,4326,48.4,1615,18.1,2992,33.5
01,40,10,47,8054,100.0,5668,70.4,3934,48.8,2386,29.6,1548,19.2,4120,51.2
01,40,10,48,9488,100.0,5853,61.7,5642,59.5,3635,38.3,2007,21.2,3846,40.5
01,40,10,49,6787,100.0,4220,62.2,3888,57.3,2567,37.8,1321,19.5,2899,42.7
02,10,01,01,6923,100.0,5123,74.0,3668,53.0,1800,26.0,1868,27.0,3255,47.0
02,10,01,02,8816,100.0,6331,71.8,5555,63.0,2485,28.2,3070,34.8,3261,37.0
02,10,01,03,5521,100.0,3524,63.8,3717,67.3,1997,36.2,1720,31.2,1804,32.7
02,10,01,04,5723,100.0,3974,69.4,3543,61.9,1749,30.6,1794,31.3,2180,38.1
02,10,01,05,9512,100.0,6852,72.0,6092,64.0,2660,28.0,3432,36.1,3420,36.0
02,10,01,06,4962,100.0,3261,65.7,3350,67.5,1701,34.3,1649,33.2,1612,32.5
02,20,02,07,2406,100.0,1048,43.6,1775,73.8,1358,56.4,417,17.3,631,26.2
02,20,02,08,5845,100.0,2688,46.0,4149,71.0,3157,54.0,992,17.0,1696,29.0
02,20,02,09,10908,100.0,4655,42.7,8100,74.3,6253,57.3,1847,16.9,2808,25.7
02,20,02,10,12221,100.0,5524,45.2,8803,72.0,6697,54.8,2106,17.2,3418,28.0
02,20,02,11,14783,100.0,6483,43.9,10939,74.0,8300,56.1,2639,17.9,3844,26.0
02,20,02,12,8510,100.0,4324,50.8,6204,72.9,4186,49.2,2018,23.7,2306,27.1
02,20,02,13,10173,100.0,4726,46.5,7137,70.2,5447,53.5,1690,16.6,3036,29.8
02,30,03,14,7376,100.0,4498,61.0,4700,63.7,2878,39.0,1822,24.7,2676,36.3
02,30,03,15,8484,100.0,4904,57.8,5553,65.5,3580,42.2,1973,23.3,2931,34.5
02,30,03,16,4220,100.0,2146,50.9,2934,69.5,2074,49.1,860,20.4,1286,30.5
02,30,04,17,8171,100.0,4524,55.4,5411,66.2,3647,44.6,1764,21.6,2760,33.8
02,30,04,18,7755,100.0,3834,49.4,5335,68.8,3921,50.6,1414,18.2,2420,31.2
02,30,04,19,10610,100.0,5558,52.4,7048,66.4,5052,47.6,1996,18.8,3562,33.6
02,40,05,20,5856,100.0,2291,39.1,4452,76.0,3565,60.9,887,15.1,1404,24.0
02,40,05,21,8278,100.0,3238,39.1,6178,74.6,5040,60.9,1138,13.7,2100,25.4
02,40,05,22,11375,100.0,3773,33.2,8985,79.0,7602,66.8,1383,12.2,2390,21.0
02,40,06,23,13602,100.0,6853,50.4,9070,66.7,6749,49.6,2321,17.1,4532,33.3
02,40,06,24,11907,100.0,4681,39.3,8452,71.0,7226,60.7,1226,10.3,3455,29.0
02,40,06,25,1114,100.0,767,68.9,471,42.3,347,31.1,124,11.1,643,57.7
02,50,07,26,9345,100.0,3727,39.9,6727,72.0,5618,60.1,1109,11.9,2618,28.0
02,50,07,27,6642,100.0,2644,39.8,4823,72.6,3998,60.2,825,12.4,1819,27.4
02,50,07,28,10138,100.0,3660,36.1,7554,74.5,6478,63.9,1076,10.6,2584,25.5
02,50,07,29,5520,100.0,2062,37.4,4175,75.6,3458,62.6,717,13.0,1345,24.4
02,50,08,30,4047,100.0,1734,42.8,2795,69.1,2313,57.2,482,11.9,1252,30.9
02,50,08,31,7970,100.0,3344,42.0,5584,70.1,4626,58.0,958,12.0,2386,29.9
02,50,08,32,9569,100.0,4396,45.9,6411,67.0,5173,54.1,1238,12.9,3158,33.0
02,50,08,33,10280,100.0,4175,40.6,7150,69.6,6105,59.4,1045,10.2,3130,30.4
02,50,08,34,11466,100.0,4292,37.4,8524,74.3,7174,62.6,1350,11.8,2942,25.7
02,50,08,35,8211,100.0,3590,43.7,5584,68.0,4621,56.3,963,11.7,2627,32.0
02,50,08,36,4992,100.0,1311,26.3,4339,86.9,3681,73.7,658,13.2,653,13.1
03,10,01,01,4697,100.0,915,19.5,4109,87.5,3782,80.5,327,7.0,588,12.5
03,10,01,02,3335,100.0,1068,32.0,2498,74.9,2267,68.0,231,6.9,837,25.1
03,10,01,03,9671,100.0,2577,26.6,7591,78.5,7094,73.4,497,5.1,2080,21.5
03,20,02,04,2403,100.0,501,20.8,1982,82.5,1902,79.2,80,3.3,421,17.5
03,20,02,05,8800,100.0,1693,19.2,7817,88.8,7107,80.8,710,8.1,983,11.2
03,20,02,06,6735,100.0,1650,24.5,5609,83.3,5085,75.5,524,7.8,1126,16.7
03,20,02,07,11448,100.0,2271,19.8,10113,88.3,9177,80.2,936,8.2,1335,11.7
03,20,03,08,5283,100.0,840,15.9,4862,92.0,4443,84.1,419,7.9,421,8.0
03,20,03,09,5386,100.0,1019,18.9,4801,89.1,4367,81.1,434,8.1,585,10.9
03,20,03,10,8056,100.0,1430,17.8,7400,91.9,6626,82.2,774,9.6,656,8.1
03,30,04,11,11765,100.0,2844,24.2,9940,84.5,8921,75.8,1019,8.7,1825,15.5
03,30,04,12,5247,100.0,654,12.5,4923,93.8,4593,87.5,330,6.3,324,6.2
03,30,04,13,3140,100.0,320,10.2,3000,95.5,2820,89.8,180,5.7,140,4.5
03,30,05,14,6964,100.0,808,11.6,6512,93.5,6156,88.4,356,5.1,452,6.5
03,30,05,15,50,100.0,0,0.0,50,100.0,50,100.0,0,0.0,0,0.0
03,30,05,16,8446,100.0,2259,26.7,6809,80.6,6187,73.3,622,7.4,1637,19.4
03,30,05,17,1114,100.0,75,6.7,1071,96.1,1039,93.3,32,2.9,43,3.9
03,40,06,18,4809,100.0,1097,22.8,4400,91.5,3712,77.2,688,14.3,409,8.5
03,40,06,19,10593,100.0,2320,21.9,9347,88.2,8273,78.1,1074,10.1,1246,11.8
03,40,06,20,3517,100.0,752,21.4,3120,88.7,2765,78.6,355,10.1,397,11.3
03,40,07,21,11782,100.0,2843,24.1,10163,86.3,8939,75.9,1224,10.4,1619,13.7
03,40,07,22,3622,100.0,656,18.1,3294,90.9,2966,81.9,328,9.1,328,9.1
03,40,07,23,7146,100.0,1821,25.5,6020,84.2,5325,74.5,695,9.7,1126,15.8
03,40,07,24,7691,100.0,1255,16.3,6954,90.4,6436,83.7,518,6.7,737,9.6
03,40,07,25,7511,100.0,1140,15.2,6852,91.2,6371,84.8,481,6.4,659,8.8
03,40,08,26,6998,100.0,1698,24.3,5769,82.4,5300,75.7,469,6.7,1229,17.6
03,40,08,27,9683,100.0,2573,26.6,8007,82.7,7110,73.4,897,9.3,1676,17.3
03,40,08,28,4903,100.0,1391,28.4,3922,80.0,3512,71.6,410,8.4,981,20.0
03,40,08,29,6000,100.0,1454,24.2,4980,83.0,4546,75.8,434,7.2,1020,17.0
03,40,08,30,9313,100.0,1748,18.8,8223,88.3,7565,81.2,658,7.1,1090,11.7
03,40,08,31,0,100.0,0,0.0,0,0.0,0,0.0,0,0.0,0,0.0
03,50,09,32,6349,100.0,1855,29.2,4834,76.1,4494,70.8,340,5.4,1515,23.9
03,50,09,33,7667,100.0,1570,20.5,6622,86.4,6097,79.5,525,6.8,1045,13.6
03,50,09,34,10321,100.0,3118,30.2,8173,79.2,7203,69.8,970,9.4,2148,20.8
03,50,09,35,6621,100.0,1910,28.8,5323,80.4,4711,71.2,612,9.2,1298,19.6
03,50,09,36,10008,100.0,2458,24.6,8373,83.7,7550,75.4,823,8.2,1635,16.3
03,50,10,37,8527,100.0,1928,22.6,7172,84.1,6599,77.4,573,6.7,1355,15.9
03,50,10,38,7360,100.0,1362,18.5,6416,87.2,5998,81.5,418,5.7,944,12.8
03,60,11,39,3792,100.0,1422,37.5,2824,74.5,2370,62.5,454,12.0,968,25.5
03,60,11,40,6025,100.0,2048,34.0,4600,76.3,3977,66.0,623,10.3,1425,23.7
03,60,11,41,6722,100.0,2504,37.3,4968,73.9,4218,62.7,750,11.2,1754,26.1
03,60,11,42,10967,100.0,4150,37.8,8071,73.6,6817,62.2,1254,11.4,2896,26.4
03,60,12,43,6943,100.0,2149,31.0,5524,79.6,4794,69.0,730,10.5,1419,20.4
03,60,12,44,7624,100.0,2238,29.4,6162,80.8,5386,70.6,776,10.2,1462,19.2
03,60,12,45,13038,100.0,4010,30.8,10295,79.0,9028,69.2,1267,9.7,2743,21.0
03,60,13,46,6000,100.0,2329,38.8,4367,72.8,3671,61.2,696,11.6,1633,27.2
03,60,13,47,9431,100.0,3262,34.6,7347,77.9,6169,65.4,1178,12.5,2084,22.1
03,60,13,48,7561,100.0,2689,35.6,5763,76.2,4872,64.4,891,11.8,1798,23.8
03,60,14,49,9939,100.0,2205,22.2,8541,85.9,7734,77.8,807,8.1,1398,14.1
03,60,14,50,4345,100.0,2175,50.1,2502,57.6,2170,49.9,332,7.6,1843,42.4
03,60,14,51,6408,100.0,2159,33.7,4865,75.9,4249,66.3,616,9.6,1543,24.1
03,60,14,52,4722,100.0,1968,41.7,3341,70.8,2754,58.3,587,12.4,1381,29.2
03,60,14,53,3061,100.0,1043,34.1,2466,80.6,2018,65.9,448,14.6,595,19.4
03,70,15,54,11507,100.0,4647,40.4,8362,72.7,6860,59.6,1502,13.1,3145,27.3
03,70,15,55,7288,100.0,2568,35.2,5601,76.9,4720,64.8,881,12.1,1687,23.1
03,70,15,56,8711,100.0,3603,41.4,6225,71.5,5108,58.6,1117,12.8,2486,28.5
03,70,16,57,3170,100.0,1072,33.8,2462,77.7,2098,66.2,364,11.5,708,22.3
03,70,16,58,8445,100.0,2938,34.8,6443,76.3,5507,65.2,936,11.1,2002,23.7
03,70,16,59,9204,100.0,3401,37.0,6994,76.0,5803,63.0,1191,12.9,2210,24.0
03,70,16,60,12904,100.0,3947,30.6,10408,80.7,8957,69.4,1451,11.2,2496,19.3
04,10,01,01,11546,100.0,6058,52.5,7827,67.8,5488,47.5,2339,20.3,3719,32.2
04,10,01,02,7804,100.0,4506,57.7,5547,71.1,3298,42.3,2249,28.8,2257,28.9
04,20,02,03,1528,100.0,474,31.0,1239,81.1,1054,69.0,185,12.1,289,18.9
04,20,02,04,3096,100.0,1230,39.7,2244,72.5,1866,60.3,378,12.2,852,27.5
04,20,02,05,2543,100.0,870,34.2,2018,79.4,1673,65.8,345,13.6,525,20.6
04,20,02,06,2904,100.0,868,29.9,2465,84.9,2036,70.1,429,14.8,439,15.1
04,20,02,07,2958,100.0,1070,36.2,2201,74.4,1888,63.8,313,10.6,757,25.6
04,20,03,08,6174,100.0,2259,36.6,4737,76.7,3915,63.4,822,13.3,1437,23.3
04,20,03,09,6843,100.0,2013,29.4,5809,84.9,4830,70.6,979,14.3,1034,15.1
04,20,03,10,7685,100.0,2904,37.8,6088,79.2,4781,62.2,1307,17.0,1597,20.8
04,20,03,11,7320,100.0,3039,41.5,5465,74.7,4281,58.5,1184,16.2,1855,25.3
04,30,04,12,4442,100.0,2628,59.2,2468,55.6,1814,40.8,654,14.7,1974,44.4
04,30,04,13,10010,100.0,4824,48.2,7520,75.1,5186,51.8,2334,23.3,2490,24.9
04,30,04,14,10664,100.0,4324,40.5,8132,76.3,6340,59.5,1792,16.8,2532,23.7
04,30,04,15,6358,100.0,2537,39.9,4909,77.2,3821,60.1,1088,17.1,1449,22.8
04,30,04,16,11868,100.0,5013,42.2,8871,74.7,6855,57.8,2016,17.0,2997,25.3
04,30,05,17,9476,100.0,4636,48.9,6661,70.3,4840,51.1,1821,19.2,2815,29.7
04,30,05,18,5800,100.0,2731,47.1,4244,73.2,3069,52.9,1175,20.3,1556,26.8
04,30,06,19,8798,100.0,4147,47.1,6342,72.1,4651,52.9,1691,19.2,2456,27.9
04,30,06,20,3631,100.0,2239,61.7,2229,61.4,1392,38.3,837,23.1,1402,38.6
04,30,06,21,10599,100.0,5268,49.7,7586,71.6,5331,50.3,2255,21.3,3013,28.4
04,30,06,22,5238,100.0,3114,59.5,3493,66.7,2124,40.5,1369,26.1,1745,33.3
04,30,06,23,12147,100.0,6829,56.2,7790,64.1,5318,43.8,2472,20.4,4357,35.9
04,30,06,24,9224,100.0,4211,45.7,6653,72.1,5013,54.3,1640,17.8,2571,27.9
04,40,07,25,98,100.0,72,73.5,38,38.8,26,26.5,12,12.2,60,61.2
04,40,07,26,5449,100.0,2457,45.1,4081,74.9,2992,54.9,1089,20.0,1368,25.1
04,40,07,27,8276,100.0,3526,42.6,6316,76.3,4750,57.4,1566,18.9,1960,23.7
04,40,07,28,3216,100.0,1288,40.0,2545,79.1,1928,60.0,617,19.2,671,20.9
04,40,07,29,2854,100.0,1149,40.3,2229,78.1,1705,59.7,524,18.4,625,21.9
04,40,08,30,8273,100.0,3963,47.9,5892,71.2,4310,52.1,1582,19.1,2381,28.8
04,40,08,31,1541,100.0,472,30.6,1303,84.6,1069,69.4,234,15.2,238,15.4
04,40,08,32,6891,100.0,1849,26.8,5925,86.0,5042,73.2,883,12.8,966,14.0
04,40,08,33,4088,100.0,1590,38.9,3267,79.9,2498,61.1,769,18.8,821,20.1
04,40,08,34,3490,100.0,1188,34.0,2872,82.3,2302,66.0,570,16.3,618,17.7
04,40,08,35,10292,100.0,2971,28.9,8679,84.3,7321,71.1,1358,13.2,1613,15.7
04,50,09,36,5517,100.0,2510,45.5,4094,74.2,3007,54.5,1087,19.7,1423,25.8
04,50,09,37,7599,100.0,3315,43.6,5625,74.0,4284,56.4,1341,17.6,1974,26.0
04,50,09,38,8216,100.0,3919,47.7,5921,72.1,4297,52.3,1624,19.8,2295,27.9
04,50,09,39,6741,100.0,3374,50.1,4844,71.9,3367,49.9,1477,21.9,1897,28.1
04,50,10,40,5942,100.0,2718,45.7,4363,73.4,3224,54.3,1139,19.2,1579,26.6
04,50,10,41,5429,100.0,2510,46.2,3929,72.4,2919,53.8,1010,18.6,1500,27.6
04,50,10,42,3669,100.0,2148,58.5,2294,62.5,1521,41.5,773,21.1,1375,37.5
04,50,10,43,11018,100.0,5226,47.4,7971,72.3,5792,52.6,2179,19.8,3047,27.7
04,50,10,44,5441,100.0,2511,46.1,3911,71.9,2930,53.9,981,18.0,1530,28.1
04,50,10,45,9115,100.0,4489,49.2,6384,70.0,4626,50.8,1758,19.3,2731,30.0
04,50,11,46,4613,100.0,2094,45.4,3363,72.9,2519,54.6,844,18.3,1250,27.1
04,50,11,47,5488,100.0,2406,43.8,4122,75.1,3082,56.2,1040,19.0,1366,24.9
04,50,11,48,4545,100.0,2198,48.4,3241,71.3,2347,51.6,894,19.7,1304,28.7
04,50,11,49,9996,100.0,4236,42.4,7468,74.7,5760,57.6,1708,17.1,2528,25.3
04,50,11,50,3048,100.0,1212,39.8,2306,75.7,1836,60.2,470,15.4,742,24.3
04,50,11,51,7404,100.0,2560,34.6,5967,80.6,4844,65.4,1123,15.2,1437,19.4
04,50,11,52,6840,100.0,3084,45.1,5026,73.5,3756,54.9,1270,18.6,1814,26.5
04,50,11,53,7410,100.0,3399,45.9,5447,73.5,4011,54.1,1436,19.4,1963,26.5
05,10,01,01,4348,100.0,1057,24.3,3841,88.3,3291,75.7,550,12.6,507,11.7
05,10,01,02,4329,100.0,1177,27.2,3627,83.8,3152,72.8,475,11.0,702,16.2
05,10,01,03,6068,100.0,3073,50.6,4188,69.0,2995,49.4,1193,19.7,1880,31.0
05,10,01,04,5790,100.0,2859,49.4,4127,71.3,2931,50.6,1196,20.7,1663,28.7
05,10,01,05,7659,100.0,1695,22.1,6815,89.0,5964,77.9,851,11.1,844,11.0
05,10,02,06,3687,100.0,1697,46.0,2692,73.0,1990,54.0,702,19.0,995,27.0
05,10,02,07,2322,100.0,671,28.9,2055,88.5,1651,71.1,404,17.4,267,11.5
05,10,02,08,10902,100.0,5330,48.9,7769,71.3,5572,51.1,2197,20.2,3133,28.7
05,10,02,09,11797,100.0,6483,55.0,8641,73.2,5314,45.0,3327,28.2,3156,26.8
05,10,02,10,7853,100.0,3266,41.6,5737,73.1,4587,58.4,1150,14.6,2116,26.9
05,10,02,11,6167,100.0,2262,36.7,5032,81.6,3905,63.3,1127,18.3,1135,18.4
05,10,03,12,4125,100.0,1874,45.4,2899,70.3,2251,54.6,648,15.7,1226,29.7
05,10,03,13,6341,100.0,3505,55.3,4365,68.8,2836,44.7,1529,24.1,1976,31.2
05,10,03,14,7450,100.0,4660,62.6,3975,53.4,2790,37.4,1185,15.9,3475,46.6
05,10,03,15,6942,100.0,3313,47.7,4735,68.2,3629,52.3,1106,15.9,2207,31.8
05,10,03,16,10468,100.0,4682,44.7,7717,73.7,5786,55.3,1931,18.4,2751,26.3
05,10,03,17,3989,100.0,2192,55.0,2219,55.6,1797,45.0,422,10.6,1770,44.4
05,20,04,18,3913,100.0,984,25.1,3579,91.5,2929,74.9,650,16.6,334,8.5
05,20,04,19,1654,100.0,97,5.9,1633,98.7,1557,94.1,76,4.6,21,1.3
05,20,04,20,5889,100.0,2037,34.6,4884,82.9,3852,65.4,1032,17.5,1005,17.1
05,20,04,21,4405,100.0,1428,32.4,3491,79.3,2977,67.6,514,11.7,914,20.7
05,20,04,22,1114,100.0,276,24.8,962,86.4,838,75.2,124,11.1,152,13.6
05,20,04,23,6666,100.0,2471,37.1,5178,77.7,4195,62.9,983,14.7,1488,22.3
05,20,05,24,3433,100.0,1039,30.3,2998,87.3,2394,69.7,604,17.6,435,12.7
05,20,05,25,2450,100.0,659,26.9,2205,90.0,1791,73.1,414,16.9,245,10.0
05,20,05,26,5667,100.0,3396,59.9,3306,58.3,2271,40.1,1035,18.3,2361,41.7
05,20,05,27,11966,100.0,7767,64.9,7379,61.7,4199,35.1,3180,26.6,4587,38.3
05,20,05,28,7148,100.0,2201,30.8,6014,84.1,4947,69.2,1067,14.9,1134,15.9
05,20,06,29,8456,100.0,3792,44.8,6002,71.0,4664,55.2,1338,15.8,2454,29.0
05,20,06,30,9957,100.0,4073,40.9,7305,73.4,5884,59.1,1421,14.3,2652,26.6
05,20,06,31,8545,100.0,3571,41.8,6216,72.7,4974,58.2,1242,14.5,2329,27.3
05,20,06,32,3738,100.0,1872,50.1,2518,67.4,1866,49.9,652,17.4,1220,32.6
05,20,06,33,2025,100.0,600,29.6,1730,85.4,1425,70.4,305,15.1,295,14.6
05,20,06,34,4429,100.0,849,19.2,3964,89.5,3580,80.8,384,8.7,465,10.5
05,30,07,35,3962,100.0,2471,62.4,2890,72.9,1491,37.6,1399,35.3,1072,27.1
05,30,07,36,3619,100.0,2019,55.8,2717,75.1,1600,44.2,1117,30.9,902,24.9
05,30,07,37,11733,100.0,5573,47.5,8842,75.4,6160,52.5,2682,22.9,2891,24.6
05,30,08,38,32,100.0,22,68.8,13,40.6,10,31.3,3,9.4,19,59.4
05,30,08,39,7783,100.0,4107,52.8,5268,67.7,3676,47.2,1592,20.5,2515,32.3
05,30,08,40,483,100.0,244,50.5,345,71.4,239,49.5,106,21.9,138,28.6
05,30,08,41,4644,100.0,2310,49.7,3271,70.4,2334,50.3,937,20.2,1373,29.6
05,40,09,42,3793,100.0,858,22.6,3384,89.2,2935,77.4,449,11.8,409,10.8
05,40,09,43,10545,100.0,2164,20.5,9759,92.5,8381,79.5,1378,13.1,786,7.5
05,40,09,44,2217,100.0,433,19.5,2028,91.5,1784,80.5,244,11.0,189,8.5
05,40,09,45,3672,100.0,637,17.3,3398,92.5,3035,82.7,363,9.9,274,7.5
06,10,01,01,6869,100.0,1918,27.9,5887,85.7,4951,72.1,936,13.6,982,14.3
06,10,01,02,9124,100.0,3722,40.8,6979,76.5,5402,59.2,1577,17.3,2145,23.5
06,10,01,03,6200,100.0,2099,33.9,5139,82.9,4101,66.1,1038,16.7,1061,17.1
06,10,02,04,6866,100.0,2605,37.9,5497,80.1,4261,62.1,1236,18.0,1369,19.9
06,10,02,05,9998,100.0,3601,36.0,8072,80.7,6397,64.0,1675,16.8,1926,19.3
06,10,02,06,7734,100.0,2525,32.6,6366,82.3,5209,67.4,1157,15.0,1368,17.7
06,10,02,07,8124,100.0,2997,36.9,6484,79.8,5127,63.1,1357,16.7,1640,20.2
06,10,02,08,6964,100.0,2371,34.0,5663,81.3,4593,66.0,1070,15.4,1301,18.7
06,10,02,09,9349,100.0,3582,38.3,7362,78.7,5767,61.7,1595,17.1,1987,21.3
06,10,02,10,4987,100.0,1633,32.7,4098,82.2,3354,67.3,744,14.9,889,17.8
06,20,03,11,4923,100.0,1308,26.6,4281,87.0,3615,73.4,666,13.5,642,13.0
06,20,03,12,6164,100.0,2159,35.0,4843,78.6,4005,65.0,838,13.6,1321,21.4
06,20,03,13,7383,100.0,2580,34.9,5996,81.2,4803,65.1,1193,16.2,1387,18.8
06,20,03,14,7176,100.0,2300,32.1,5948,82.9,4876,67.9,1072,14.9,1228,17.1
06,20,03,15,6687,100.0,2376,35.5,5493,82.1,4311,64.5,1182,17.7,1194,17.9
06,20,03,16,5417,100.0,2367,43.7,4079,75.3,3050,56.3,1029,19.0,1338,24.7
06,20,03,17,6357,100.0,1422,22.4,5705,89.7,4935,77.6,770,12.1,652,10.3
06,20,04,18,0,100.0,0,0.0,0,0.0,0,0.0,0,0.0,0,0.0
06,20,04,19,4529,100.0,2392,52.8,3299,72.8,2137,47.2,1162,25.7,1230,27.2
06,20,04,20,7205,100.0,2259,31.4,5925,82.2,4946,68.6,979,13.6,1280,17.8
06,20,04,21,8400,100.0,2485,29.6,6946,82.7,5915,70.4,1031,12.3,1454,17.3
06,20,04,22,7125,100.0,1761,24.7,6042,84.8,5364,75.3,678,9.5,1083,15.2
06,20,04,23,8670,100.0,2612,30.1,7351,84.8,6058,69.9,1293,14.9,1319,15.2
06,30,05,24,5762,100.0,1569,27.2,4789,83.1,4193,72.8,596,10.3,973,16.9
06,30,05,25,5746,100.0,1571,27.3,4860,84.6,4175,72.7,685,11.9,886,15.4
06,30,05,26,3370,100.0,1134,33.6,2740,81.3,2236,66.4,504,15.0,630,18.7
06,30,05,27,8419,100.0,2558,30.4,7108,84.4,5861,69.6,1247,14.8,1311,15.6
06,30,05,28,11019,100.0,2803,25.4,9629,87.4,8216,74.6,1413,12.8,1390,12.6
06,30,06,29,7037,100.0,2080,29.6,5909,84.0,4957,70.4,952,13.5,1128,16.0
06,30,06,30,5643,100.0,2366,41.9,4111,72.9,3277,58.1,834,14.8,1532,27.1
06,30,06,31,2989,100.0,1115,37.3,2227,74.5,1874,62.7,353,11.8,762,25.5
06,30,06,32,14040,100.0,4454,31.7,11850,84.4,9586,68.3,2264,16.1,2190,15.6
06,30,06,33,12070,100.0,3367,27.9,10220,84.7,8703,72.1,1517,12.6,1850,15.3
06,30,06,34,8489,100.0,2195,25.9,7297,86.0,6294,74.1,1003,11.8,1192,14.0
06,40,07,35,10343,100.0,2674,25.9,8781,84.9,7669,74.1,1112,10.8,1562,15.1
06,40,07,36,5243,100.0,1193,22.8,4748,90.6,4050,77.2,698,13.3,495,9.4
06,40,07,37,11357,100.0,3723,32.8,8802,77.5,7634,67.2,1168,10.3,2555,22.5
06,40,08,38,7539,100.0,1609,21.3,6726,89.2,5930,78.7,796,10.6,813,10.8
06,40,08,39,5307,100.0,1300,24.5,4620,87.1,4007,75.5,613,11.6,687,12.9
06,40,08,40,7216,100.0,1315,18.2,6543,90.7,5901,81.8,642,8.9,673,9.3
06,40,08,41,6262,100.0,1822,29.1,5243,83.7,4440,70.9,803,12.8,1019,16.3
06,40,08,42,4880,100.0,1885,38.6,4111,84.2,2995,61.4,1116,22.9,769,15.8
06,40,08,43,4751,100.0,1461,30.8,3949,83.1,3290,69.2,659,13.9,802,16.9
06,40,08,44,7307,100.0,2568,35.1,5909,80.9,4739,64.9,1170,16.0,1398,19.1
07,10,01,01,9904,100.0,4961,50.1,7010,70.8,4943,49.9,2067,20.9,2894,29.2
07,10,01,02,8643,100.0,4550,52.6,5673,65.6,4093,47.4,1580,18.3,2970,34.4
07,10,01,03,7812,100.0,5014,64.2,4923,63.0,2798,35.8,2125,27.2,2889,37.0
07,10,02,04,10446,100.0,4277,40.9,7841,75.1,6169,59.1,1672,16.0,2605,24.9
07,10,02,05,5250,100.0,3580,68.2,3208,61.1,1670,31.8,1538,29.3,2042,38.9
07,10,02,06,8410,100.0,4274,50.8,5860,69.7,4136,49.2,1724,20.5,2550,30.3
07,20,03,07,10566,100.0,3998,37.8,8373,79.2,6568,62.2,1805,17.1,2193,20.8
07,20,03,08,10560,100.0,5034,47.7,7521,71.2,5526,52.3,1995,18.9,3039,28.8
07,20,04,09,9313,100.0,3582,38.5,7291,78.3,5731,61.5,1560,16.8,2022,21.7
07,20,04,10,5599,100.0,3080,55.0,3908,69.8,2519,45.0,1389,24.8,1691,30.2
07,20,04,11,2747,100.0,1238,45.1,2034,74.0,1509,54.9,525,19.1,713,26.0
07,20,04,12,2025,100.0,1211,59.8,1263,62.4,814,40.2,449,22.2,762,37.6
07,20,04,13,7758,100.0,2817,36.3,6137,79.1,4941,63.7,1196,15.4,1621,20.9
07,20,04,14,3775,100.0,1580,41.9,2865,75.9,2195,58.1,670,17.7,910,24.1
07,30,05,15,6911,100.0,1939,28.1,5918,85.6,4972,71.9,946,13.7,993,14.4
07,30,05,16,8942,100.0,2814,31.5,7364,82.4,6128,68.5,1236,13.8,1578,17.6
07,30,05,17,9519,100.0,3400,35.7,7609,79.9,6119,64.3,1490,15.7,1910,20.1
07,30,06,18,9338,100.0,3235,34.6,7598,81.4,6103,65.4,1495,16.0,1740,18.6
07,30,06,19,12255,100.0,5694,46.5,9288,75.8,6561,53.5,2727,22.3,2967,24.2
07,40,07,20,11962,100.0,5149,43.0,9474,79.2,6813,57.0,2661,22.2,2488,20.8
07,40,07,21,6191,100.0,2576,41.6,4589,74.1,3615,58.4,974,15.7,1602,25.9
07,40,08,22,3030,100.0,1056,34.9,2431,80.2,1974,65.1,457,15.1,599,19.8
07,40,08,23,9775,100.0,3737,38.2,7831,80.1,6038,61.8,1793,18.3,1944,19.9
07,40,08,24,7334,100.0,3036,41.4,5615,76.6,4298,58.6,1317,18.0,1719,23.4
07,40,08,25,7384,100.0,3323,45.0,5488,74.3,4061,55.0,1427,19.3,1896,25.7
07,40,08,26,5108,100.0,1502,29.4,4389,85.9,3606,70.6,783,15.3,719,14.1
07,40,09,27,11336,100.0,5549,49.0,8088,71.3,5787,51.0,2301,20.3,3248,28.7
07,40,09,28,3937,100.0,2327,59.1,2447,62.2,1610,40.9,837,21.3,1490,37.8
07,50,10,29,8443,100.0,3865,45.8,6375,75.5,4578,54.2,1797,21.3,2068,24.5
07,50,10,30,8749,100.0,3841,43.9,6757,77.2,4908,56.1,1849,21.1,1992,22.8
07,50,10,31,9107,100.0,3259,35.8,7508,82.4,5848,64.2,1660,18.2,1599,17.6
07,50,10,32,5824,100.0,2138,36.7,4836,83.0,3686,63.3,1150,19.7,988,17.0
07,50,11,33,8097,100.0,3488,43.1,6013,74.3,4609,56.9,1404,17.3,2084,25.7
07,50,11,34,10588,100.0,3391,32.0,8974,84.8,7197,68.0,1777,16.8,1614,15.2
07,50,11,35,2224,100.0,609,27.4,1954,87.9,1615,72.6,339,15.2,270,12.1
07,60,12,36,10345,100.0,4755,46.0,7610,73.6,5590,54.0,2020,19.5,2735,26.4
07,60,12,37,4761,100.0,1340,28.1,4156,87.3,3421,71.9,735,15.4,605,12.7
07,60,12,38,2838,100.0,1188,41.9,2323,81.9,1650,58.1,673,23.7,515,18.1
07,60,13,39,5722,100.0,2487,43.5,4750,83.0,3235,56.5,1515,26.5,972,17.0
07,60,13,40,6558,100.0,2958,45.1,5238,79.9,3600,54.9,1638,25.0,1320,20.1
07,60,13,41,2252,100.0,733,32.5,1862,82.7,1519,67.5,343,15.2,390,17.3
07,60,14,42,10436,100.0,2642,25.3,9194,88.1,7794,74.7,1400,13.4,1242,11.9
07,60,14,43,10960,100.0,2812,25.7,9778,89.2,8148,74.3,1630,14.9,1182,10.8
07,60,15,44,8990,100.0,3127,34.8,7446,82.8,5863,65.2,1583,17.6,1544,17.2
07,60,15,45,8286,100.0,3442,41.5,6361,76.8,4844,58.5,1517,18.3,1925,23.2
07,60,15,46,7029,100.0,1531,21.8,6330,90.1,5498,78.2,832,11.8,699,9.9
07,60,15,47,3928,100.0,998,25.4,3328,84.7,2930,74.6,398,10.1,600,15.3
07,60,15,48,2946,100.0,603,20.5,2654,90.1,2343,79.5,311,10.6,292,9.9
08,10,01,01,4718,100.0,2714,57.5,2880,61.0,2004,42.5,876,18.6,1838,39.0
08,10,01,02,8301,100.0,4533,54.6,5244,63.2,3768,45.4,1476,17.8,3057,36.8
08,10,01,03,7408,100.0,3834,51.8,4895,66.1,3574,48.2,1321,17.8,2513,33.9
08,10,01,04,6595,100.0,3880,58.8,4155,63.0,2715,41.2,1440,21.8,2440,37.0
08,10,01,05,6047,100.0,3851,63.7,3736,61.8,2196,36.3,1540,25.5,2311,38.2
08,10,02,06,9574,100.0,5727,59.8,5807,60.7,3847,40.2,1960,20.5,3767,39.3
08,10,02,07,7506,100.0,5087,67.8,4850,64.6,2419,32.2,2431,32.4,2656,35.4
08,10,02,08,12305,100.0,7069,57.4,7721,62.7,5236,42.6,2485,20.2,4584,37.3
08,10,02,09,8669,100.0,5227,60.3,5128,59.2,3442,39.7,1686,19.4,3541,40.8
08,10,03,10,7806,100.0,4038,51.7,5293,67.8,3768,48.3,1525,19.5,2513,32.2
08,10,03,11,7249,100.0,3569,49.2,4902,67.6,3680,50.8,1222,16.9,2347,32.4
08,10,03,12,11874,100.0,6273,52.8,7793,65.6,5601,47.2,2192,18.5,4081,34.4
08,10,03,13,3854,100.0,1511,39.2,2981,77.3,2343,60.8,638,16.6,873,22.7
08,10,03,14,8020,100.0,4933,61.5,4794,59.8,3087,38.5,1707,21.3,3226,40.2
08,10,04,15,6531,100.0,3577,54.8,4193,64.2,2954,45.2,1239,19.0,2338,35.8
08,10,04,16,6473,100.0,3457,53.4,4247,65.6,3016,46.6,1231,19.0,2226,34.4
08,10,04,17,9686,100.0,5422,56.0,6163,63.6,4264,44.0,1899,19.6,3523,36.4
08,10,04,18,9474,100.0,4624,48.8,6497,68.6,4850,51.2,1647,17.4,2977,31.4
08,10,04,19,7270,100.0,4581,63.0,4143,57.0,2689,37.0,1454,20.0,3127,43.0
08,10,05,20,5867,100.0,4445,75.8,3579,61.0,1422,24.2,2157,36.8,2288,39.0
08,10,05,21,9582,100.0,6450,67.3,6607,69.0,3132,32.7,3475,36.3,2975,31.0
08,20,06,22,5707,100.0,4016,70.4,3045,53.4,1691,29.6,1354,23.7,2662,46.6
08,20,06,23,6291,100.0,3089,49.1,4481,71.2,3202,50.9,1279,20.3,1810,28.8
08,20,06,24,8855,100.0,4443,50.2,6503,73.4,4412,49.8,2091,23.6,2352,26.6
08,20,07,25,2526,100.0,885,35.0,2171,85.9,1641,65.0,530,21.0,355,14.1
08,20,07,26,6209,100.0,1963,31.6,5292,85.2,4246,68.4,1046,16.8,917,14.8
08,20,07,27,7961,100.0,2645,33.2,6677,83.9,5316,66.8,1361,17.1,1284,16.1
08,20,07,28,1204,100.0,417,34.6,1018,84.6,787,65.4,231,19.2,186,15.4
08,20,07,29,1897,100.0,704,37.1,1611,84.9,1193,62.9,418,22.0,286,15.1
08,20,07,30,3347,100.0,1167,34.9,2751,82.2,2180,65.1,571,17.1,596,17.8
08,20,08,31,8365,100.0,2616,31.3,7198,86.0,5749,68.7,1449,17.3,1167,14.0
08,20,08,32,11733,100.0,4176,35.6,9833,83.8,7557,64.4,2276,19.4,1900,16.2
08,20,08,33,8488,100.0,4104,48.4,6447,76.0,4384,51.6,2063,24.3,2041,24.0
08,30,09,34,12605,100.0,6935,55.0,9769,77.5,5670,45.0,4099,32.5,2836,22.5
08,30,09,35,7401,100.0,3543,47.9,5881,79.5,3858,52.1,2023,27.3,1520,20.5
08,30,10,36,7164,100.0,3609,50.4,5655,78.9,3555,49.6,2100,29.3,1509,21.1
08,30,10,37,10979,100.0,6605,60.2,8255,75.2,4374,39.8,3881,35.3,2724,24.8
08,40,11,38,2862,100.0,1027,35.9,2424,84.7,1835,64.1,589,20.6,438,15.3
08,40,11,39,4166,100.0,1574,37.8,3458,83.0,2592,62.2,866,20.8,708,17.0
08,40,11,40,2697,100.0,1014,37.6,2247,83.3,1683,62.4,564,20.9,450,16.7
08,40,12,41,8337,100.0,3299,39.6,6858,82.3,5038,60.4,1820,21.8,1479,17.7
08,40,12,42,6870,100.0,2008,29.2,6013,87.5,4862,70.8,1151,16.8,857,12.5
08,40,12,43,10085,100.0,3330,33.0,8476,84.0,6755,67.0,1721,17.1,1609,16.0
08,40,12,44,7300,100.0,2026,27.8,6609,90.5,5274,72.2,1335,18.3,691,9.5
08,40,12,45,3716,100.0,1202,32.3,3290,88.5,2514,67.7,776,20.9,426,11.5
08,40,12,46,7902,100.0,2294,29.0,6946,87.9,5608,71.0,1338,16.9,956,12.1
09,10,01,01,13336,100.0,4756,35.7,10424,78.2,8580,64.3,1844,13.8,2912,21.8
09,10,02,02,4349,100.0,1000,23.0,3772,86.7,3349,77.0,423,9.7,577,13.3
09,10,02,03,7048,100.0,1685,23.9,5852,83.0,5363,76.1,489,6.9,1196,17.0
09,10,03,04,11852,100.0,2543,21.5,10285,86.8,9309,78.5,976,8.2,1567,13.2
09,10,03,05,4275,100.0,1090,25.5,3582,83.8,3185,74.5,397,9.3,693,16.2
09,10,03,06,3163,100.0,1089,34.4,2533,80.1,2074,65.6,459,14.5,630,19.9
09,10,04,07,8601,100.0,1423,16.5,7724,89.8,7178,83.5,546,6.3,877,10.2
09,10,04,08,8439,100.0,1775,21.0,7311,86.6,6664,79.0,647,7.7,1128,13.4
09,10,04,09,3984,100.0,1077,27.0,3480,87.3,2907,73.0,573,14.4,504,12.7
09,20,05,10,7767,100.0,2931,37.7,5503,70.9,4836,62.3,667,8.6,2264,29.1
09,20,05,11,13199,100.0,3864,29.3,10425,79.0,9335,70.7,1090,8.3,2774,21.0
09,20,05,12,3968,100.0,1268,32.0,3003,75.7,2700,68.0,303,7.6,965,24.3
09,20,06,13,10576,100.0,4093,38.7,7353,69.5,6483,61.3,870,8.2,3223,30.5
09,20,06,14,3759,100.0,570,15.2,3360,89.4,3189,84.8,171,4.5,399,10.6
09,20,07,15,3641,100.0,1732,47.6,2355,64.7,1909,52.4,446,12.2,1286,35.3
09,20,07,16,8021,100.0,2251,28.1,6265,78.1,5770,71.9,495,6.2,1756,21.9
09,20,07,17,9677,100.0,2334,24.1,7955,82.2,7343,75.9,612,6.3,1722,17.8
09,20,08,18,3754,100.0,820,21.8,3128,83.3,2934,78.2,194,5.2,626,16.7
09,20,08,19,8523,100.0,2304,27.0,6826,80.1,6219,73.0,607,7.1,1697,19.9
09,30,09,20,12632,100.0,2692,21.3,11243,89.0,9940,78.7,1303,10.3,1389,11.0
09,30,09,21,2776,100.0,453,16.3,2562,92.3,2323,83.7,239,8.6,214,7.7
09,30,09,22,5929,100.0,1387,23.4,5030,84.8,4542,76.6,488,8.2,899,15.2
09,30,09,23,8319,100.0,2104,25.3,7208,86.6,6215,74.7,993,11.9,1111,13.4
09,30,10,24,3575,100.0,918,25.7,3021,84.5,2657,74.3,364,10.2,554,15.5
09,30,10,25,11619,100.0,2371,20.4,10067,86.6,9248,79.6,819,7.0,1552,13.4
09,30,11,26,8019,100.0,1595,19.9,6988,87.1,6424,80.1,564,7.0,1031,12.9
09,30,12,27,1924,100.0,237,12.3,1819,94.5,1687,87.7,132,6.9,105,5.5
09,30,12,28,2658,100.0,345,13.0,2489,93.6,2313,87.0,176,6.6,169,6.4
09,40,13,29,10244,100.0,1005,9.8,9612,93.8,9239,90.2,373,3.6,632,6.2
09,40,13,30,1905,100.0,252,13.2,1775,93.2,1653,86.8,122,6.4,130,6.8
09,40,14,31,5909,100.0,1093,18.5,5116,86.6,4816,81.5,300,5.1,793,13.4
09,40,14,32,1554,100.0,289,18.6,1374,88.4,1265,81.4,109,7.0,180,11.6
09,40,14,33,4606,100.0,962,20.9,3876,84.2,3644,79.1,232,5.0,730,15.8
09,40,15,34,7531,100.0,1862,24.7,6227,82.7,5669,75.3,558,7.4,1304,17.3
09,40,16,35,6970,100.0,698,10.0,6644,95.3,6272,90.0,372,5.3,326,4.7
09,50,17,36,4619,100.0,589,12.8,4223,91.4,4030,87.2,193,4.2,396,8.6
09,50,17,37,14438,100.0,1544,10.7,13568,94.0,12894,89.3,674,4.7,870,6.0
09,50,18,38,10622,100.0,1529,14.4,9660,90.9,9093,85.6,567,5.3,962,9.1
09,50,19,39,6561,100.0,1465,22.3,5534,84.3,5096,77.7,438,6.7,1027,15.7
09,50,19,40,2709,100.0,535,19.7,2329,86.0,2174,80.3,155,5.7,380,14.0
09,50,19,41,2767,100.0,465,16.8,2464,89.0,2302,83.2,162,5.9,303,11.0
09,50,20,42,4185,100.0,582,13.9,3784,90.4,3603,86.1,181,4.3,401,9.6
09,50,20,43,9177,100.0,1003,10.9,8574,93.4,8174,89.1,400,4.4,603,6.6
10,10,01,01,5835,100.0,1870,32.0,4640,79.5,3965,68.0,675,11.6,1195,20.5
10,10,01,02,3645,100.0,1249,34.3,2739,75.1,2396,65.7,343,9.4,906,24.9
10,10,01,03,7805,100.0,2210,28.3,6483,83.1,5595,71.7,888,11.4,1322,16.9
10,10,01,04,7500,100.0,2330,31.1,6396,85.3,5170,68.9,1226,16.3,1104,14.7
10,10,02,05,1320,100.0,903,68.4,463,35.1,417,31.6,46,3.5,857,64.9
10,10,02,06,11348,100.0,3368,29.7,9362,82.5,7980,70.3,1382,12.2,1986,17.5
10,10,02,07,8243,100.0,1632,19.8,7191,87.2,6611,80.2,580,7.0,1052,12.8
10,10,02,08,9643,100.0,2790,28.9,7913,82.1,6853,71.1,1060,11.0,1730,17.9
10,10,02,09,9335,100.0,3233,34.6,7113,76.2,6102,65.4,1011,10.8,2222,23.8
10,10,02,10,10865,100.0,3229,29.7,9102,83.8,7636,70.3,1466,13.5,1763,16.2
10,10,03,11,2234,100.0,730,32.7,1777,79.5,1504,67.3,273,12.2,457,20.5
10,10,03,12,15293,100.0,4733,30.9,12583,82.3,10560,69.1,2023,13.2,2710,17.7
10,10,03,13,4915,100.0,1706,34.7,3751,76.3,3209,65.3,542,11.0,1164,23.7
10,10,03,14,6418,100.0,1453,22.6,5633,87.8,4965,77.4,668,10.4,785,12.2
10,10,03,15,7545,100.0,2278,30.2,6351,84.2,5267,69.8,1084,14.4,1194,15.8
10,10,03,16,3743,100.0,618,16.5,3488,93.2,3125,83.5,363,9.7,255,6.8
10,20,04,17,7644,100.0,2959,38.7,5745,75.2,4685,61.3,1060,13.9,1899,24.8
10,20,04,18,6558,100.0,1534,23.4,5454,83.2,5024,76.6,430,6.6,1104,16.8
10,20,04,19,4325,100.0,2000,46.2,2831,65.5,2325,53.8,506,11.7,1494,34.5
10,20,04,20,7292,100.0,2249,30.8,5522,75.7,5043,69.2,479,6.6,1770,24.3
10,20,04,21,1774,100.0,932,52.5,1199,67.6,842,47.5,357,20.1,575,32.4
10,20,04,22,6701,100.0,2888,43.1,4339,64.8,3813,56.9,526,7.8,2362,35.2
10,20,04,23,6111,100.0,2294,37.5,4444,72.7,3817,62.5,627,10.3,1667,27.3
10,20,05,24,11334,100.0,3191,28.2,8982,79.2,8143,71.8,839,7.4,2352,20.8
10,20,05,25,5382,100.0,1659,30.8,4152,77.1,3723,69.2,429,8.0,1230,22.9
10,20,05,26,6189,100.0,2364,38.2,4427,71.5,3825,61.8,602,9.7,1762,28.5
10,20,06,27,3626,100.0,900,24.8,3045,84.0,2726,75.2,319,8.8,581,16.0
10,20,06,28,6557,100.0,1946,29.7,5166,78.8,4611,70.3,555,8.5,1391,21.2
10,20,06,29,9112,100.0,1863,20.4,8022,88.0,7249,79.6,773,8.5,1090,12.0
10,20,06,30,6525,100.0,1091,16.7,5926,90.8,5434,83.3,492,7.5,599,9.2
10,30,07,31,7777,100.0,1499,19.3,6853,88.1,6278,80.7,575,7.4,924,11.9
10,30,07,32,7122,100.0,1789,25.1,6073,85.3,5333,74.9,740,10.4,1049,14.7
10,30,07,33,5246,100.0,1602,30.5,4189,79.9,3644,69.5,545,10.4,1057,20.1
10,30,07,34,10596,100.0,1601,15.1,9834,92.8,8995,84.9,839,7.9,762,7.2
10,40,08,35,7907,100.0,891,11.3,7448,94.2,7016,88.7,432,5.5,459,5.8
10,40,08,36,3962,100.0,521,13.1,3642,91.9,3441,86.9,201,5.1,320,8.1
10,40,08,37,7771,100.0,698,9.0,7496,96.5,7073,91.0,423,5.4,275,3.5
10,40,09,38,10262,100.0,1064,10.4,9759,95.1,9198,89.6,561,5.5,503,4.9
10,40,09,39,4482,100.0,598,13.3,4158,92.8,3884,86.7,274,6.1,324,7.2
10,40,09,40,5919,100.0,552,9.3,5617,94.9,5367,90.7,250,4.2,302,5.1
10,40,09,41,9817,100.0,944,9.6,9413,95.9,8873,90.4,540,5.5,404,4.1
11,10,01,01,3347,100.0,343,10.2,3163,94.5,3004,89.8,159,4.8,184,5.5
11,10,01,02,3045,100.0,1260,41.4,2092,68.7,1785,58.6,307,10.1,953,31.3
11,10,02,03,9093,100.0,3255,35.8,6936,76.3,5838,64.2,1098,12.1,2157,23.7
11,10,02,04,7207,100.0,2646,36.7,5432,75.4,4561,63.3,871,12.1,1775,24.6
11,10,02,05,6228,100.0,2102,33.8,4744,76.2,4126,66.2,618,9.9,1484,23.8
11,10,02,06,7699,100.0,2560,33.3,5798,75.3,5139,66.7,659,8.6,1901,24.7
11,10,03,07,11773,100.0,3941,33.5,9335,79.3,7832,66.5,1503,12.8,2438,20.7
11,10,03,08,9665,100.0,3222,33.3,7521,77.8,6443,66.7,1078,11.2,2144,22.2
11,10,03,09,6491,100.0,1919,29.6,5072,78.1,4572,70.4,500,7.7,1419,21.9
11,20,04,10,10296,100.0,3531,34.3,7656,74.4,6765,65.7,891,8.7,2640,25.6
11,20,04,11,6913,100.0,1884,27.3,5673,82.1,5029,72.7,644,9.3,1240,17.9
11,20,05,12,3981,100.0,899,22.6,3295,82.8,3082,77.4,213,5.4,686,17.2
11,20,05,13,10191,100.0,3004,29.5,7955,78.1,7187,70.5,768,7.5,2236,21.9
11,20,05,14,15790,100.0,5246,33.2,12378,78.4,10544,66.8,1834,11.6,3412,21.6
11,20,05,15,4272,100.0,1120,26.2,3635,85.1,3152,73.8,483,11.3,637,14.9
11,30,06,16,6004,100.0,2342,39.0,4602,76.6,3662,61.0,940,15.7,1402,23.4
11,30,06,17,4355,100.0,1335,30.7,3579,82.2,3020,69.3,559,12.8,776,17.8
11,30,06,18,3798,100.0,1265,33.3,2891,76.1,2533,66.7,358,9.4,907,23.9
11,30,06,19,8676,100.0,3401,39.2,6231,71.8,5275,60.8,956,11.0,2445,28.2
11,30,06,20,11376,100.0,4296,37.8,8581,75.4,7080,62.2,1501,13.2,2795,24.6
11,30,07,21,6502,100.0,4438,68.3,2523,38.8,2064,31.7,459,7.1,3979,61.2
11,30,07,22,10232,100.0,2986,29.2,8448,82.6,7246,70.8,1202,11.7,1784,17.4
11,30,07,23,2728,100.0,1915,70.2,1031,37.8,813,29.8,218,8.0,1697,62.2
11,30,07,24,4159,100.0,1273,30.6,3275,78.7,2886,69.4,389,9.4,884,21.3
11,30,07,25,10059,100.0,2607,25.9,8250,82.0,7452,74.1,798,7.9,1809,18.0
11,30,08,26,10285,100.0,4272,41.5,7484,72.8,6013,58.5,1471,14.3,2801,27.2
11,40,09,27,4252,100.0,1156,27.2,3493,82.1,3096,72.8,397,9.3,759,17.9
11,40,09,28,2725,100.0,1098,40.3,1887,69.2,1627,59.7,260,9.5,838,30.8
11,40,09,29,16644,100.0,5044,30.3,12918,77.6,11600,69.7,1318,7.9,3726,22.4
11,40,09,30,4718,100.0,943,20.0,4143,87.8,3775,80.0,368,7.8,575,12.2
11,40,09,31,6861,100.0,2078,30.3,5451,79.4,4783,69.7,668,9.7,1410,20.6
11,40,10,32,6149,100.0,2392,38.9,4403,71.6,3757,61.1,646,10.5,1746,28.4
11,40,10,33,6823,100.0,2793,40.9,5042,73.9,4030,59.1,1012,14.8,1781,26.1
11,40,10,34,3388,100.0,1207,35.6,2540,75.0,2181,64.4,359,10.6,848,25.0
11,40,11,35,10925,100.0,3904,35.7,8423,77.1,7021,64.3,1402,12.8,2502,22.9
11,40,11,36,8159,100.0,2206,27.0,6506,79.7,5953,73.0,553,6.8,1653,20.3
11,40,11,37,8748,100.0,3196,36.5,6730,76.9,5552,63.5,1178,13.5,2018,23.1
11,50,12,38,4427,100.0,1199,27.1,3715,83.9,3228,72.9,487,11.0,712,16.1
11,50,13,39,10405,100.0,2654,25.5,8562,82.3,7751,74.5,811,7.8,1843,17.7
11,50,13,40,11192,100.0,2088,18.7,9870,88.2,9104,81.3,766,6.8,1322,11.8
11,50,13,41,8705,100.0,2257,25.9,7201,82.7,6448,74.1,753,8.7,1504,17.3
12,10,01,01,11058,100.0,6434,58.2,7142,64.6,4624,41.8,2518,22.8,3916,35.4
12,10,01,02,9842,100.0,5150,52.3,6647,67.5,4692,47.7,1955,19.9,3195,32.5
12,10,01,03,7615,100.0,3534,46.4,5572,73.2,4081,53.6,1491,19.6,2043,26.8
12,10,02,04,8964,100.0,4609,51.4,6256,69.8,4355,48.6,1901,21.2,2708,30.2
12,10,02,05,13841,100.0,6761,48.8,9854,71.2,7080,51.2,2774,20.0,3987,28.8
12,10,02,06,4691,100.0,1740,37.1,3739,79.7,2951,62.9,788,16.8,952,20.3
12,20,03,07,2757,100.0,1203,43.6,2004,72.7,1554,56.4,450,16.3,753,27.3
12,20,03,08,5744,100.0,2689,46.8,4275,74.4,3055,53.2,1220,21.2,1469,25.6
12,20,03,09,10923,100.0,6191,56.7,6999,64.1,4732,43.3,2267,20.8,3924,35.9
12,20,03,10,8146,100.0,4961,60.9,5193,63.7,3185,39.1,2008,24.7,2953,36.3
12,20,04,11,331,100.0,223,67.4,189,57.1,108,32.6,81,24.5,142,42.9
12,20,04,12,6361,100.0,2404,37.8,5031,79.1,3957,62.2,1074,16.9,1330,20.9
12,20,04,13,8145,100.0,3575,43.9,6152,75.5,4570,56.1,1582,19.4,1993,24.5
12,20,04,14,1833,100.0,817,44.6,1209,66.0,1016,55.4,193,10.5,624,34.0
12,20,05,15,11036,100.0,2931,26.6,9306,84.3,8105,73.4,1201,10.9,1730,15.7
12,40,06,16,6054,100.0,1040,17.2,5574,92.1,5014,82.8,560,9.3,480,7.9
12,40,06,17,6826,100.0,1063,15.6,6383,93.5,5763,84.4,620,9.1,443,6.5
12,40,06,18,3787,100.0,699,18.5,3480,91.9,3088,81.5,392,10.4,307,8.1
12,40,06,19,7744,100.0,1255,16.2,7126,92.0,6489,83.8,637,8.2,618,8.0
12,40,07,20,8540,100.0,1297,15.2,7998,93.7,7243,84.8,755,8.8,542,6.3
12,40,07,21,8042,100.0,1305,16.2,7414,92.2,6737,83.8,677,8.4,628,7.8
12,40,07,22,8555,100.0,1400,16.4,7867,92.0,7155,83.6,712,8.3,688,8.0
12,40,07,23,8171,100.0,1475,18.1,7449,91.2,6696,81.9,753,9.2,722,8.8
12,50,08,24,9614,100.0,1773,18.4,8727,90.8,7841,81.6,886,9.2,887,9.2
12,50,08,25,6896,100.0,2166,31.4,5437,78.8,4730,68.6,707,10.3,1459,21.2
12,50,09,26,5087,100.0,1554,30.5,4209,82.7,3533,69.5,676,13.3,878,17.3
12,50,09,27,6791,100.0,1929,28.4,5824,85.8,4862,71.6,962,14.2,967,14.2
12,50,09,28,5186,100.0,1151,22.2,4609,88.9,4035,77.8,574,11.1,577,11.1
12,50,09,29,5092,100.0,934,18.3,4748,93.2,4158,81.7,590,11.6,344,6.8
12,50,09,30,10232,100.0,3951,38.6,7619,74.5,6281,61.4,1338,13.1,2613,25.5
12,60,10,31,3251,100.0,1068,32.9,2760,84.9,2183,67.1,577,17.7,491,15.1
12,60,10,32,6054,100.0,3247,53.6,4042,66.8,2807,46.4,1235,20.4,2012,33.2
12,60,11,33,11448,100.0,6172,53.9,8331,72.8,5276,46.1,3055,26.7,3117,27.2
12,60,11,34,15841,100.0,7802,49.3,11761,74.2,8039,50.7,3722,23.5,4080,25.8
12,60,12,35,10676,100.0,6384,59.8,7355,68.9,4292,40.2,3063,28.7,3321,31.1
12,60,12,36,3134,100.0,1428,45.6,2498,79.7,1706,54.4,792,25.3,636,20.3
