district_id,forecast_area_id,district_region_id,planning_area_id,inhabitants,inhabitants_percentage,inhabitants_with_migration_background,inhabitants_with_migration_background_percentage,inhabitants_germans,inhabitants_germans_percentage,inhabitants_germans_without_migration_background,inhabitants_germans_without_migration_background_percentage,inhabitants_germans_with_migration_background,inhabitants_germans_with_migration_background_percentage,inhabitants_foreigners,inhabitants_foreigners_percentage
01,10,01,01,3667,100.0,2432,66.3,2004,54.6,1235,33.7,769,21.0,1663,45.4
01,10,01,02,2025,100.0,1440,71.1,929,45.9,585,28.9,344,17.0,1096,54.1
01,10,01,03,5695,100.0,3486,61.2,3524,61.9,2209,38.8,1315,23.1,2171,38.1
01,10,01,04,4955,100.0,3301,66.6,2931,59.2,1654,33.4,1277,25.8,2024,40.8
01,10,02,05,2932,100.0,2009,68.5,1430,48.8,923,31.5,507,17.3,1502,51.2
01,10,02,06,1862,100.0,999,53.7,1186,63.7,863,46.3,323,17.3,676,36.3
01,10,02,07,8804,100.0,5019,57.0,5514,62.6,3785,43.0,1729,19.6,3290,37.4
01,10,03,08,7326,100.0,3655,49.9,4750,64.8,3671,50.1,1079,14.7,2576,35.2
01,10,03,09,12526,100.0,5564,44.4,8904,71.1,6962,55.6,1942,15.5,3622,28.9
01,10,03,10,10139,100.0,5496,54.2,6255,61.7,4643,45.8,1612,15.9,3884,38.3
01,10,03,11,9782,100.0,5284,54.0,6293,64.3,4498,46.0,1795,18.4,3489,35.7
01,10,03,12,10574,100.0,5464,51.7,6906,65.3,5110,48.3,1796,17.0,3668,34.7
01,10,03,13,11466,100.0,5891,51.4,7358,64.2,5575,48.6,1783,15.6,4108,35.8
01,10,04,14,5523,100.0,3289,59.6,3032,54.9,2234,40.4,798,14.4,2491,45.1
01,10,04,15,13468,100.0,6227,46.2,9156,68.0,7241,53.8,1915,14.2,4312,32.0
01,10,04,16,13587,100.0,6077,44.7,9542,70.2,7510,55.3,2032,15.0,4045,29.8
01,20,05,17,3882,100.0,2433,62.7,2133,54.9,1449,37.3,684,17.6,1749,45.1
01,20,05,18,6981,100.0,4566,65.4,3808,54.5,2415,34.6,1393,20.0,3173,45.5
01,20,05,19,9531,100.0,5510,57.8,5709,59.9,4021,42.2,1688,17.7,3822,40.1
01,20,05,20,9459,100.0,4753,50.2,6488,68.6,4706,49.8,1782,18.8,2971,31.4
01,20,05,21,5354,100.0,3314,61.9,3178,59.4,2040,38.1,1138,21.3,2176,40.6
01,20,05,22,11536,100.0,4494,39.0,8894,77.1,7042,61.0,1852,16.1,2642,22.9
01,20,06,23,10988,100.0,5922,53.9,7251,66.0,5066,46.1,2185,19.9,3737,34.0
01,20,06,24,6620,100.0,4854,73.3,3189,48.2,1766,26.7,1423,21.5,3431,51.8
01,20,06,25,6882,100.0,4221,61.3,4445,64.6,2661,38.7,1784,25.9,2437,35.4
01,20,06,26,6055,100.0,2807,46.4,4292,70.9,3248,53.6,1044,17.2,1763,29.1
01,20,06,27,3344,100.0,2270,67.9,2147,64.2,1074,32.1,1073,32.1,1197,35.8
01,20,06,28,3285,100.0,1537,46.8,2393,72.8,1748,53.2,645,19.6,892,27.2
01,20,06,29,5960,100.0,2969,49.8,3888,65.2,2991,50.2,897,15.1,2072,34.8
01,30,07,30,7940,100.0,5755,72.5,4071,51.3,2185,27.5,1886,23.8,3869,48.7
01,30,07,31,8904,100.0,5593,62.8,5176,58.1,3311,37.2,1865,20.9,3728,41.9
01,30,07,32,10069,100.0,6403,63.6,5929,58.9,3666,36.4,2263,22.5,4140,41.1
01,30,07,33,11592,100.0,7366,63.5,6986,60.3,4226,36.5,2760,23.8,4606,39.7
01,30,08,34,14381,100.0,9724,67.6,9819,68.3,4657,32.4,5162,35.9,4562,31.7
01,30,08,35,10813,100.0,6727,62.2,7202,66.6,4086,37.8,3116,28.8,3611,33.4
01,30,08,36,14893,100.0,10006,67.2,8532,57.3,4887,32.8,3645,24.5,6361,42.7
01,40,09,37,10922,100.0,5854,53.6,7164,65.6,5068,46.4,2096,19.2,3758,34.4
01,40,09,38,9636,100.0,5277,54.8,6215,64.5,4359,45.2,1856,19.3,3421,35.5
01,40,09,39,6157,100.0,3552,57.7,3608,58.6,2605,42.3,1003,16.3,2549,41.4
01,40,09,40,7075,100.0,3006,42.5,5676,80.2,4069,57.5,1607,22.7,1399,19.8
01,40,09,41,3836,100.0,1890,49.3,2741,71.5,1946,50.7,795,20.7,1095,28.5
01,40,09,42,8646,100.0,4895,56.6,5302,61.3,3751,43.4,1551,17.9,3344,38.7
01,40,10,43,7680,100.0,5257,68.5,4430,57.7,2423,31.5,2007,26.1,3250,42.3
01,40,10,44,10235,100.0,7173,70.1,5535,54.1,3062,29.9,2473,24.2,4700,45.9
01,40,10,45,5518,100.0,4080,73.9,3038,55.1,1438,26.1,1600,29.0,2480,44.9
01,40,10,46,8856,100.0,4712,53.2,5703,64.4,4144,46.8,1559,17.6,3153,35.6
01,40,10,47,8094,100.0,5729,70.8,3892,48.1,2365,29.2,1527,18.9,4202,51.9
01,40,10,48,9542,100.0,6001,62.9,5496,57.6,3541,37.1,1955,20.5,4046,42.4
01,40,10,49,6659,100.0,4158,62.4,3804,57.1,2501,37.6,1303,19.6,2855,42.9
02,10,01,01,7241,100.0,5476,75.6,3621,50.0,1765,24.4,1856,25.6,3620,50.0
02,10,01,02,8796,100.0,6356,72.3,5491,62.4,2440,27.7,3051,34.7,3305,37.6
02,10,01,03,5500,100.0,3539,64.3,3673,66.8,1961,35.7,1712,31.1,1827,33.2
02,10,01,04,5590,100.0,3907,69.9,3456,61.8,1683,30.1,1773,31.7,2134,38.2
02,10,01,05,9368,100.0,6741,72.0,5978,63.8,2627,28.0,3351,35.8,3390,36.2
02,10,01,06,4874,100.0,3178,65.2,3276,67.2,1696,34.8,1580,32.4,1598,32.8
02,20,02,07,2707,100.0,1347,49.8,1830,67.6,1360,50.2,470,17.4,877,32.4
02,20,02,08,5769,100.0,2701,46.8,4038,70.0,3068,53.2,970,16.8,1731,30.0
02,20,02,09,10961,100.0,4720,43.1,8132,74.2,6241,56.9,1891,17.3,2829,25.8
02,20,02,10,12305,100.0,5765,46.9,8688,70.6,6540,53.1,2148,17.5,3617,29.4
02,20,02,11,14516,100.0,6346,43.7,10815,74.5,8170,56.3,2645,18.2,3701,25.5
02,20,02,12,8362,100.0,4239,50.7,6129,73.3,4123,49.3,2006,24.0,2233,26.7
02,20,02,13,10074,100.0,4707,46.7,7074,70.2,5367,53.3,1707,16.9,3000,29.8
02,30,03,14,7065,100.0,4221,59.7,4584,64.9,2844,40.3,1740,24.6,2481,35.1
02,30,03,15,8203,100.0,4712,57.4,5380,65.6,3491,42.6,1889,23.0,2823,34.4
02,30,03,16,4212,100.0,2162,51.3,2952,70.1,2050,48.7,902,21.4,1260,29.9
02,30,04,17,8315,100.0,4638,55.8,5420,65.2,3677,44.2,1743,21.0,2895,34.8
02,30,04,18,7611,100.0,3791,49.8,5207,68.4,3820,50.2,1387,18.2,2404,31.6
02,30,04,19,10459,100.0,5508,52.7,6902,66.0,4951,47.3,1951,18.7,3557,34.0
02,40,05,20,5878,100.0,2475,42.1,4393,74.7,3403,57.9,990,16.8,1485,25.3
02,40,05,21,8630,100.0,3700,42.9,6215,72.0,4930,57.1,1285,14.9,2415,28.0
02,40,05,22,11358,100.0,4001,35.2,8788,77.4,7357,64.8,1431,12.6,2570,22.6
02,40,06,23,13793,100.0,7251,52.6,9036,65.5,6542,47.4,2494,18.1,4757,34.5
02,40,06,24,11875,100.0,4873,41.0,8295,69.9,7002,59.0,1293,10.9,3580,30.1
02,40,06,25,1309,100.0,923,70.5,549,41.9,386,29.5,163,12.5,760,58.1
02,50,07,26,9243,100.0,3795,41.1,6567,71.0,5448,58.9,1119,12.1,2676,29.0
02,50,07,27,6566,100.0,2682,40.8,4742,72.2,3884,59.2,858,13.1,1824,27.8
02,50,07,28,10090,100.0,3834,38.0,7397,73.3,6256,62.0,1141,11.3,2693,26.7
02,50,07,29,5453,100.0,2104,38.6,4124,75.6,3349,61.4,775,14.2,1329,24.4
02,50,08,30,4154,100.0,1877,45.2,2790,67.2,2277,54.8,513,12.3,1364,32.8
02,50,08,31,7865,100.0,3410,43.4,5459,69.4,4455,56.6,1004,12.8,2406,30.6
02,50,08,32,9544,100.0,4622,48.4,6248,65.5,4922,51.6,1326,13.9,3296,34.5
02,50,08,33,10192,100.0,4309,42.3,6973,68.4,5883,57.7,1090,10.7,3219,31.6
02,50,08,34,11341,100.0,4331,38.2,8376,73.9,7010,61.8,1366,12.0,2965,26.1
02,50,08,35,8558,100.0,3991,46.6,5648,66.0,4567,53.4,1081,12.6,2910,34.0
02,50,08,36,5089,100.0,1396,27.4,4395,86.4,3693,72.6,702,13.8,694,13.6
03,10,01,01,4653,100.0,967,20.8,4037,86.8,3686,79.2,351,7.5,616,13.2
03,10,01,02,3507,100.0,1287,36.7,2501,71.3,2220,63.3,281,8.0,1006,28.7
03,10,01,03,9591,100.0,2671,27.8,7410,77.3,6920,72.2,490,5.1,2181,22.7
03,20,02,04,2481,100.0,580,23.4,1988,80.1,1901,76.6,87,3.5,493,19.9
03,20,02,05,8964,100.0,1907,21.3,7812,87.1,7057,78.7,755,8.4,1152,12.9
03,20,02,06,6810,100.0,1737,25.5,5602,82.3,5073,74.5,529,7.8,1208,17.7
03,20,02,07,11838,100.0,2728,23.0,10086,85.2,9110,77.0,976,8.2,1752,14.8
03,20,03,08,5264,100.0,875,16.6,4834,91.8,4389,83.4,445,8.5,430,8.2
03,20,03,09,5477,100.0,1115,20.4,4829,88.2,4362,79.6,467,8.5,648,11.8
03,20,03,10,8115,100.0,1565,19.3,7346,90.5,6550,80.7,796,9.8,769,9.5
03,30,04,11,11829,100.0,3105,26.2,9753,82.4,8724,73.8,1029,8.7,2076,17.6
03,30,04,12,5237,100.0,676,12.9,4899,93.5,4561,87.1,338,6.5,338,6.5
03,30,04,13,3159,100.0,326,10.3,3016,95.5,2833,89.7,183,5.8,143,4.5
03,30,05,14,6945,100.0,854,12.3,6409,92.3,6091,87.7,318,4.6,536,7.7
03,30,05,15,42,100.0,3,7.1,39,92.9,39,92.9,0,0.0,3,7.1
03,30,05,16,9235,100.0,3050,33.0,6876,74.5,6185,67.0,691,7.5,2359,25.5
03,30,05,17,1097,100.0,66,6.0,1065,97.1,1031,94.0,34,3.1,32,2.9
03,40,06,18,4765,100.0,1130,23.7,4337,91.0,3635,76.3,702,14.7,428,9.0
03,40,06,19,10593,100.0,2477,23.4,9246,87.3,8116,76.6,1130,10.7,1347,12.7
03,40,06,20,3528,100.0,793,22.5,3104,88.0,2735,77.5,369,10.5,424,12.0
03,40,07,21,11893,100.0,3086,25.9,10078,84.7,8807,74.1,1271,10.7,1815,15.3
03,40,07,22,3834,100.0,881,23.0,3286,85.7,2953,77.0,333,8.7,548,14.3
03,40,07,23,7484,100.0,2113,28.2,6197,82.8,5371,71.8,826,11.0,1287,17.2
03,40,07,24,8349,100.0,1730,20.7,7276,87.1,6619,79.3,657,7.9,1073,12.9
03,40,07,25,7508,100.0,1228,16.4,6803,90.6,6280,83.6,523,7.0,705,9.4
03,40,08,26,7195,100.0,1875,26.1,5843,81.2,5320,73.9,523,7.3,1352,18.8
03,40,08,27,9690,100.0,2710,28.0,7906,81.6,6980,72.0,926,9.6,1784,18.4
03,40,08,28,4881,100.0,1467,30.1,3824,78.3,3414,69.9,410,8.4,1057,21.7
03,40,08,29,6020,100.0,1545,25.7,4941,82.1,4475,74.3,466,7.7,1079,17.9
03,40,08,30,9310,100.0,1946,20.9,8056,86.5,7364,79.1,692,7.4,1254,13.5
03,40,08,31,0,100.0,0,0.0,0,0.0,0,0.0,0,0.0,0,0.0
03,50,09,32,6616,100.0,2198,33.2,4810,72.7,4418,66.8,392,5.9,1806,27.3
03,50,09,33,7655,100.0,1751,22.9,6479,84.6,5904,77.1,575,7.5,1176,15.4
03,50,09,34,10396,100.0,3397,32.7,8029,77.2,6999,67.3,1030,9.9,2367,22.8
03,50,09,35,6750,100.0,2107,31.2,5289,78.4,4643,68.8,646,9.6,1461,21.6
03,50,09,36,10081,100.0,2683,26.6,8280,82.1,7398,73.4,882,8.7,1801,17.9
03,50,10,37,8479,100.0,2042,24.1,7013,82.7,6437,75.9,576,6.8,1466,17.3
03,50,10,38,7373,100.0,1485,20.1,6338,86.0,5888,79.9,450,6.1,1035,14.0
03,60,11,39,3894,100.0,1550,39.8,2837,72.9,2344,60.2,493,12.7,1057,27.1
03,60,11,40,6060,100.0,2212,36.5,4505,74.3,3848,63.5,657,10.8,1555,25.7
03,60,11,41,6820,100.0,2667,39.1,4965,72.8,4153,60.9,812,11.9,1855,27.2
03,60,11,42,10894,100.0,4321,39.7,7917,72.7,6573,60.3,1344,12.3,2977,27.3
03,60,12,43,6912,100.0,2254,32.6,5463,79.0,4658,67.4,805,11.6,1449,21.0
03,60,12,44,7661,100.0,2372,31.0,6104,79.7,5289,69.0,815,10.6,1557,20.3
03,60,12,45,13511,100.0,4635,34.3,10293,76.2,8876,65.7,1417,10.5,3218,23.8
03,60,13,46,5947,100.0,2338,39.3,4308,72.4,3609,60.7,699,11.8,1639,27.6
03,60,13,47,9475,100.0,3321,35.1,7350,77.6,6154,64.9,1196,12.6,2125,22.4
03,60,13,48,7459,100.0,2713,36.4,5675,76.1,4746,63.6,929,12.5,1784,23.9
03,60,14,49,9901,100.0,2381,24.0,8349,84.3,7520,76.0,829,8.4,1552,15.7
03,60,14,50,5121,100.0,3046,59.5,2420,47.3,2075,40.5,345,6.7,2701,52.7
03,60,14,51,6465,100.0,2307,35.7,4832,74.7,4158,64.3,674,10.4,1633,25.3
03,60,14,52,4748,100.0,2054,43.3,3293,69.4,2694,56.7,599,12.6,1455,30.6
03,60,14,53,3297,100.0,1226,37.2,2546,77.2,2071,62.8,475,14.4,751,22.8
03,70,15,54,11373,100.0,4737,41.7,8200,72.1,6636,58.3,1564,13.8,3173,27.9
03,70,15,55,7301,100.0,2639,36.1,5569,76.3,4662,63.9,907,12.4,1732,23.7
03,70,15,56,8675,100.0,3647,42.0,6180,71.2,5028,58.0,1152,13.3,2495,28.8
03,70,16,57,3188,100.0,1106,34.7,2449,76.8,2082,65.3,367,11.5,739,23.2
03,70,16,58,8309,100.0,3012,36.2,6290,75.7,5297,63.8,993,12.0,2019,24.3
03,70,16,59,9463,100.0,3711,39.2,7003,74.0,5752,60.8,1251,13.2,2460,26.0
03,70,16,60,12722,100.0,3956,31.1,10258,80.6,8766,68.9,1492,11.7,2464,19.4
04,10,01,01,11719,100.0,6432,54.9,7662,65.4,5287,45.1,2375,20.3,4057,34.6
04,10,01,02,7813,100.0,4667,59.7,5429,69.5,3146,40.3,2283,29.2,2384,30.5
04,20,02,03,1458,100.0,428,29.4,1211,83.1,1030,70.6,181,12.4,247,16.9
04,20,02,04,3277,100.0,1405,42.9,2282,69.6,1872,57.1,410,12.5,995,30.4
04,20,02,05,2554,100.0,858,33.6,2024,79.2,1696,66.4,328,12.8,530,20.8
04,20,02,06,2863,100.0,879,30.7,2412,84.2,1984,69.3,428,14.9,451,15.8
04,20,02,07,3009,100.0,1128,37.5,2208,73.4,1881,62.5,327,10.9,801,26.6
04,20,03,08,6113,100.0,2285,37.4,4681,76.6,3828,62.6,853,14.0,1432,23.4
04,20,03,09,6831,100.0,2114,30.9,5724,83.8,4717,69.1,1007,14.7,1107,16.2
04,20,03,10,7532,100.0,2888,38.3,5933,78.8,4644,61.7,1289,17.1,1599,21.2
04,20,03,11,7464,100.0,3213,43.0,5492,73.6,4251,57.0,1241,16.6,1972,26.4
04,30,04,12,4520,100.0,2714,60.0,2498,55.3,1806,40.0,692,15.3,2022,44.7
04,30,04,13,9952,100.0,4854,48.8,7426,74.6,5098,51.2,2328,23.4,2526,25.4
04,30,04,14,10588,100.0,4326,40.9,8093,76.4,6262,59.1,1831,17.3,2495,23.6
04,30,04,15,6249,100.0,2513,40.2,4790,76.7,3736,59.8,1054,16.9,1459,23.3
04,30,04,16,11752,100.0,5062,43.1,8727,74.3,6690,56.9,2037,17.3,3025,25.7
04,30,05,17,9442,100.0,4730,50.1,6482,68.7,4712,49.9,1770,18.7,2960,31.3
04,30,05,18,6487,100.0,3526,54.4,4204,64.8,2961,45.6,1243,19.2,2283,35.2
04,30,06,19,8993,100.0,4390,48.8,6361,70.7,4603,51.2,1758,19.5,2632,29.3
04,30,06,20,4056,100.0,2619,64.6,2427,59.8,1437,35.4,990,24.4,1629,40.2
04,30,06,21,10832,100.0,5472,50.5,7642,70.6,5360,49.5,2282,21.1,3190,29.4
04,30,06,22,5247,100.0,3166,60.3,3458,65.9,2081,39.7,1377,26.2,1789,34.1
04,30,06,23,12219,100.0,7019,57.4,7682,62.9,5200,42.6,2482,20.3,4537,37.1
04,30,06,24,9493,100.0,4507,47.5,6644,70.0,4986,52.5,1658,17.5,2849,30.0
04,40,07,25,63,100.0,41,65.1,28,44.4,22,34.9,6,9.5,35,55.6
04,40,07,26,5419,100.0,2463,45.5,4057,74.9,2956,54.5,1101,20.3,1362,25.1
04,40,07,27,8328,100.0,3661,44.0,6260,75.2,4667,56.0,1593,19.1,2068,24.8
04,40,07,28,3194,100.0,1315,41.2,2510,78.6,1879,58.8,631,19.8,684,21.4
04,40,07,29,2785,100.0,1104,39.6,2215,79.5,1681,60.4,534,19.2,570,20.5
04,40,08,30,8410,100.0,4093,48.7,5969,71.0,4317,51.3,1652,19.6,2441,29.0
04,40,08,31,1547,100.0,505,32.6,1305,84.4,1042,67.4,263,17.0,242,15.6
04,40,08,32,7005,100.0,1989,28.4,5891,84.1,5016,71.6,875,12.5,1114,15.9
04,40,08,33,3919,100.0,1541,39.3,3140,80.1,2378,60.7,762,19.4,779,19.9
04,40,08,34,3416,100.0,1170,34.3,2807,82.2,2246,65.7,561,16.4,609,17.8
04,40,08,35,10167,100.0,2932,28.8,8582,84.4,7235,71.2,1347,13.2,1585,15.6
04,50,09,36,5601,100.0,2636,47.1,4041,72.1,2965,52.9,1076,19.2,1560,27.9
04,50,09,37,7574,100.0,3373,44.5,5538,73.1,4201,55.5,1337,17.7,2036,26.9
04,50,09,38,8325,100.0,4055,48.7,5932,71.3,4270,51.3,1662,20.0,2393,28.7
04,50,09,39,6667,100.0,3428,51.4,4721,70.8,3239,48.6,1482,22.2,1946,29.2
04,50,10,40,5871,100.0,2707,46.1,4360,74.3,3164,53.9,1196,20.4,1511,25.7
04,50,10,41,5431,100.0,2575,47.4,3867,71.2,2856,52.6,1011,18.6,1564,28.8
04,50,10,42,3739,100.0,2235,59.8,2279,61.0,1504,40.2,775,20.7,1460,39.0
04,50,10,43,11019,100.0,5296,48.1,7888,71.6,5723,51.9,2165,19.6,3131,28.4
04,50,10,44,5309,100.0,2403,45.3,3836,72.3,2906,54.7,930,17.5,1473,27.7
04,50,10,45,9257,100.0,4732,51.1,6268,67.7,4525,48.9,1743,18.8,2989,32.3
04,50,11,46,4743,100.0,2261,47.7,3333,70.3,2482,52.3,851,17.9,1410,29.7
04,50,11,47,5436,100.0,2365,43.5,4121,75.8,3071,56.5,1050,19.3,1315,24.2
04,50,11,48,4514,100.0,2215,49.1,3193,70.7,2299,50.9,894,19.8,1321,29.3
04,50,11,49,9934,100.0,4282,43.1,7358,74.1,5652,56.9,1706,17.2,2576,25.9
04,50,11,50,3021,100.0,1217,40.3,2281,75.5,1804,59.7,477,15.8,740,24.5
04,50,11,51,7454,100.0,2698,36.2,5909,79.3,4756,63.8,1153,15.5,1545,20.7
04,50,11,52,6844,100.0,3132,45.8,4982,72.8,3712,54.2,1270,18.6,1862,27.2
04,50,11,53,7681,100.0,3749,48.8,5427,70.7,3932,51.2,1495,19.5,2254,29.3
05,10,01,01,4436,100.0,1171,26.4,3871,87.3,3265,73.6,606,13.7,565,12.7
05,10,01,02,4378,100.0,1295,29.6,3597,82.2,3083,70.4,514,11.7,781,17.8
05,10,01,03,6146,100.0,3261,53.1,4163,67.7,2885,46.9,1278,20.8,1983,32.3
05,10,01,04,6815,100.0,3630,53.3,4511,66.2,3185,46.7,1326,19.5,2304,33.8
05,10,01,05,7669,100.0,1787,23.3,6765,88.2,5882,76.7,883,11.5,904,11.8
05,10,02,06,3627,100.0,1701,46.9,2615,72.1,1926,53.1,689,19.0,1012,27.9
05,10,02,07,2307,100.0,673,29.2,2041,88.5,1634,70.8,407,17.6,266,11.5
05,10,02,08,11116,100.0,5765,51.9,7659,68.9,5351,48.1,2308,20.8,3457,31.1
05,10,02,09,11827,100.0,6703,56.7,8361,70.7,5124,43.3,3237,27.4,3466,29.3
05,10,02,10,7839,100.0,3436,43.8,5529,70.5,4403,56.2,1126,14.4,2310,29.5
05,10,02,11,6243,100.0,2508,40.2,4911,78.7,3735,59.8,1176,18.8,1332,21.3
05,10,03,12,4084,100.0,1912,46.8,2803,68.6,2172,53.2,631,15.5,1281,31.4
05,10,03,13,6605,100.0,3772,57.1,4416,66.9,2833,42.9,1583,24.0,2189,33.1
05,10,03,14,7460,100.0,4824,64.7,3842,51.5,2636,35.3,1206,16.2,3618,48.5
05,10,03,15,7300,100.0,3774,51.7,4660,63.8,3526,48.3,1134,15.5,2640,36.2
05,10,03,16,10435,100.0,4870,46.7,7473,71.6,5565,53.3,1908,18.3,2962,28.4
05,10,03,17,4068,100.0,2340,57.5,2172,53.4,1728,42.5,444,10.9,1896,46.6
05,20,04,18,3845,100.0,960,25.0,3527,91.7,2885,75.0,642,16.7,318,8.3
05,20,04,19,1632,100.0,94,5.8,1599,98.0,1538,94.2,61,3.7,33,2.0
05,20,04,20,5874,100.0,2107,35.9,4827,82.2,3767,64.1,1060,18.0,1047,17.8
05,20,04,21,4411,100.0,1525,34.6,3410,77.3,2886,65.4,524,11.9,1001,22.7
05,20,04,22,1191,100.0,356,29.9,986,82.8,835,70.1,151,12.7,205,17.2
05,20,04,23,6813,100.0,2715,39.9,5143,75.5,4098,60.1,1045,15.3,1670,24.5
05,20,05,24,3377,100.0,1064,31.5,2923,86.6,2313,68.5,610,18.1,454,13.4
05,20,05,25,2458,100.0,729,29.7,2159,87.8,1729,70.3,430,17.5,299,12.2
05,20,05,26,5821,100.0,3661,62.9,3229,55.5,2160,37.1,1069,18.4,2592,44.5
05,20,05,27,12039,100.0,8059,66.9,7119,59.1,3980,33.1,3139,26.1,4920,40.9
05,20,05,28,7251,100.0,2391,33.0,5931,81.8,4860,67.0,1071,14.8,1320,18.2
05,20,06,29,8346,100.0,3830,45.9,5855,70.2,4516,54.1,1339,16.0,2491,29.8
05,20,06,30,10023,100.0,4294,42.8,7178,71.6,5729,57.2,1449,14.5,2845,28.4
05,20,06,31,8629,100.0,3863,44.8,6068,70.3,4766,55.2,1302,15.1,2561,29.7
05,20,06,32,3725,100.0,1927,51.7,2457,66.0,1798,48.3,659,17.7,1268,34.0
05,20,06,33,2125,100.0,698,32.8,1746,82.2,1427,67.2,319,15.0,379,17.8
05,20,06,34,4356,100.0,872,20.0,3873,88.9,3484,80.0,389,8.9,483,11.1
05,30,07,35,4480,100.0,2907,64.9,3125,69.8,1573,35.1,1552,34.6,1355,30.2
05,30,07,36,3602,100.0,2015,55.9,2713,75.3,1587,44.1,1126,31.3,889,24.7
05,30,07,37,11878,100.0,5924,49.9,8681,73.1,5954,50.1,2727,23.0,3197,26.9
05,30,08,38,21,100.0,6,28.6,15,71.4,15,71.4,0,0.0,6,28.6
05,30,08,39,8046,100.0,4333,53.9,5529,68.7,3713,46.1,1816,22.6,2517,31.3
05,30,08,40,498,100.0,277,55.6,331,66.5,221,44.4,110,22.1,167,33.5
05,30,08,41,4644,100.0,2389,51.4,3178,68.4,2255,48.6,923,19.9,1466,31.6
05,40,09,42,3717,100.0,837,22.5,3337,89.8,2880,77.5,457,12.3,380,10.2
05,40,09,43,10501,100.0,2260,21.5,9651,91.9,8241,78.5,1410,13.4,850,8.1
05,40,09,44,2199,100.0,423,19.2,2019,91.8,1776,80.8,243,11.1,180,8.2
05,40,09,45,3634,100.0,650,17.9,3349,92.2,2984,82.1,365,10.0,285,7.8
06,10,01,01,6904,100.0,2026,29.3,5830,84.4,4878,70.7,952,13.8,1074,15.6
06,10,01,02,9087,100.0,3783,41.6,6866,75.6,5304,58.4,1562,17.2,2221,24.4
06,10,01,03,6137,100.0,2108,34.3,5077,82.7,4029,65.7,1048,17.1,1060,17.3
06,10,02,04,6823,100.0,2625,38.5,5412,79.3,4198,61.5,1214,17.8,1411,20.7
06,10,02,05,9985,100.0,3753,37.6,7935,79.5,6232,62.4,1703,17.1,2050,20.5
06,10,02,06,7701,100.0,2667,34.6,6224,80.8,5034,65.4,1190,15.5,1477,19.2
06,10,02,07,8124,100.0,3100,38.2,6376,78.5,5024,61.8,1352,16.6,1748,21.5
06,10,02,08,7010,100.0,2412,34.4,5697,81.3,4598,65.6,1099,15.7,1313,18.7
06,10,02,09,9377,100.0,3750,40.0,7254,77.4,5627,60.0,1627,17.4,2123,22.6
06,10,02,10,5045,100.0,1733,34.4,4089,81.1,3312,65.6,777,15.4,956,18.9
06,20,03,11,4867,100.0,1368,28.1,4153,85.3,3499,71.9,654,13.4,714,14.7
06,20,03,12,6278,100.0,2217,35.3,4929,78.5,4061,64.7,868,13.8,1349,21.5
06,20,03,13,7436,100.0,2727,36.7,5924,79.7,4709,63.3,1215,16.3,1512,20.3
06,20,03,14,7174,100.0,2457,34.2,5841,81.4,4717,65.8,1124,15.7,1333,18.6
06,20,03,15,6782,100.0,2509,37.0,5497,81.1,4273,63.0,1224,18.0,1285,18.9
06,20,03,16,5808,100.0,2678,46.1,4209,72.5,3130,53.9,1079,18.6,1599,27.5
06,20,03,17,6261,100.0,1444,23.1,5586,89.2,4817,76.9,769,12.3,675,10.8
06,20,04,18,0,100.0,0,0.0,0,0.0,0,0.0,0,0.0,0,0.0
06,20,04,19,4596,100.0,2544,55.4,3202,69.7,2052,44.6,1150,25.0,1394,30.3
06,20,04,20,7361,100.0,2434,33.1,5910,80.3,4927,66.9,983,13.4,1451,19.7
06,20,04,21,8422,100.0,2637,31.3,6857,81.4,5785,68.7,1072,12.7,1565,18.6
06,20,04,22,7099,100.0,1807,25.5,5984,84.3,5292,74.5,692,9.7,1115,15.7
06,20,04,23,8576,100.0,2680,31.3,7216,84.1,5896,68.8,1320,15.4,1360,15.9
06,30,05,24,5725,100.0,1600,27.9,4799,83.8,4125,72.1,674,11.8,926,16.2
06,30,05,25,5780,100.0,1700,29.4,4771,82.5,4080,70.6,691,12.0,1009,17.5
06,30,05,26,3366,100.0,1155,34.3,2721,80.8,2211,65.7,510,15.2,645,19.2
06,30,05,27,8499,100.0,2654,31.2,7133,83.9,5845,68.8,1288,15.2,1366,16.1
06,30,05,28,10954,100.0,2941,26.8,9443,86.2,8013,73.2,1430,13.1,1511,13.8
06,30,06,29,6998,100.0,2183,31.2,5796,82.8,4815,68.8,981,14.0,1202,17.2
06,30,06,30,5708,100.0,2456,43.0,4080,71.5,3252,57.0,828,14.5,1628,28.5
06,30,06,31,2878,100.0,1068,37.1,2199,76.4,1810,62.9,389,13.5,679,23.6
06,30,06,32,13706,100.0,4311,31.5,11658,85.1,9395,68.5,2263,16.5,2048,14.9
06,30,06,33,12015,100.0,3501,29.1,10054,83.7,8514,70.9,1540,12.8,1961,16.3
06,30,06,34,8272,100.0,2147,26.0,7117,86.0,6125,74.0,992,12.0,1155,14.0
06,40,07,35,10296,100.0,2678,26.0,8724,84.7,7618,74.0,1106,10.7,1572,15.3
06,40,07,36,5170,100.0,1195,23.1,4655,90.0,3975,76.9,680,13.2,515,10.0
06,40,07,37,11270,100.0,3879,34.4,8590,76.2,7391,65.6,1199,10.6,2680,23.8
06,40,08,38,7369,100.0,1509,20.5,6642,90.1,5860,79.5,782,10.6,727,9.9
06,40,08,39,5206,100.0,1216,23.4,4598,88.3,3990,76.6,608,11.7,608,11.7
06,40,08,40,7099,100.0,1375,19.4,6388,90.0,5724,80.6,664,9.4,711,10.0
06,40,08,41,6205,100.0,1869,30.1,5138,82.8,4336,69.9,802,12.9,1067,17.2
06,40,08,42,4814,100.0,1880,39.1,4026,83.6,2934,60.9,1092,22.7,788,16.4
06,40,08,43,4727,100.0,1479,31.3,3904,82.6,3248,68.7,656,13.9,823,17.4
06,40,08,44,7217,100.0,2576,35.7,5822,80.7,4641,64.3,1181,16.4,1395,19.3
07,10,01,01,9771,100.0,4969,50.9,6871,70.3,4802,49.1,2069,21.2,2900,29.7
07,10,01,02,8701,100.0,4667,53.6,5635,64.8,4034,46.4,1601,18.4,3066,35.2
07,10,01,03,7707,100.0,4964,64.4,4868,63.2,2743,35.6,2125,27.6,2839,36.8
07,10,02,04,10354,100.0,4342,41.9,7704,74.4,6012,58.1,1692,16.3,2650,25.6
07,10,02,05,5178,100.0,3486,67.3,3175,61.3,1692,32.7,1483,28.6,2003,38.7
07,10,02,06,8324,100.0,4271,51.3,5818,69.9,4053,48.7,1765,21.2,2506,30.1
07,20,03,07,10553,100.0,4090,38.8,8320,78.8,6463,61.2,1857,17.6,2233,21.2
07,20,03,08,10643,100.0,5106,48.0,7541,70.9,5537,52.0,2004,18.8,3102,29.1
07,20,04,09,9343,100.0,3630,38.9,7289,78.0,5713,61.1,1576,16.9,2054,22.0
07,20,04,10,5649,100.0,3116,55.2,3922,69.4,2533,44.8,1389,24.6,1727,30.6
07,20,04,11,2776,100.0,1271,45.8,2039,73.5,1505,54.2,534,19.2,737,26.5
07,20,04,12,2519,100.0,1545,61.3,1565,62.1,974,38.7,591,23.5,954,37.9
07,20,04,13,7696,100.0,2846,37.0,6036,78.4,4850,63.0,1186,15.4,1660,21.6
07,20,04,14,3798,100.0,1598,42.1,2908,76.6,2200,57.9,708,18.6,890,23.4
07,30,05,15,6982,100.0,2043,29.3,5939,85.1,4939,70.7,1000,14.3,1043,14.9
07,30,05,16,8904,100.0,2865,32.2,7306,82.1,6039,67.8,1267,14.2,1598,17.9
07,30,05,17,9714,100.0,3567,36.7,7691,79.2,6147,63.3,1544,15.9,2023,20.8
07,30,06,18,9256,100.0,3269,35.3,7469,80.7,5987,64.7,1482,16.0,1787,19.3
07,30,06,19,12182,100.0,5726,47.0,9159,75.2,6456,53.0,2703,22.2,3023,24.8
07,40,07,20,11709,100.0,5111,43.7,9168,78.3,6598,56.3,2570,21.9,2541,21.7
07,40,07,21,7662,100.0,4079,53.2,4551,59.4,3583,46.8,968,12.6,3111,40.6
07,40,08,22,3283,100.0,1332,40.6,2431,74.0,1951,59.4,480,14.6,852,26.0
07,40,08,23,9742,100.0,3817,39.2,7766,79.7,5925,60.8,1841,18.9,1976,20.3
07,40,08,24,7355,100.0,3119,42.4,5593,76.0,4236,57.6,1357,18.5,1762,24.0
07,40,08,25,7213,100.0,3260,45.2,5363,74.4,3953,54.8,1410,19.5,1850,25.6
07,40,08,26,5113,100.0,1605,31.4,4300,84.1,3508,68.6,792,15.5,813,15.9
07,40,09,27,11333,100.0,5584,49.3,8043,71.0,5749,50.7,2294,20.2,3290,29.0
07,40,09,28,4007,100.0,2419,60.4,2452,61.2,1588,39.6,864,21.6,1555,38.8
07,50,10,29,8477,100.0,3964,46.8,6318,74.5,4513,53.2,1805,21.3,2159,25.5
07,50,10,30,8779,100.0,3938,44.9,6679,76.1,4841,55.1,1838,20.9,2100,23.9
07,50,10,31,9101,100.0,3400,37.4,7375,81.0,5701,62.6,1674,18.4,1726,19.0
07,50,10,32,6158,100.0,2461,40.0,5004,81.3,3697,60.0,1307,21.2,1154,18.7
07,50,11,33,8311,100.0,3714,44.7,6070,73.0,4597,55.3,1473,17.7,2241,27.0
07,50,11,34,10540,100.0,3512,33.3,8845,83.9,7028,66.7,1817,17.2,1695,16.1
07,50,11,35,2250,100.0,653,29.0,1948,86.6,1597,71.0,351,15.6,302,13.4
07,60,12,36,10287,100.0,4841,47.1,7502,72.9,5446,52.9,2056,20.0,2785,27.1
07,60,12,37,4801,100.0,1441,30.0,4123,85.9,3360,70.0,763,15.9,678,14.1
07,60,12,38,2876,100.0,1239,43.1,2342,81.4,1637,56.9,705,24.5,534,18.6
07,60,13,39,5670,100.0,2532,44.7,4631,81.7,3138,55.3,1493,26.3,1039,18.3
07,60,13,40,6413,100.0,2940,45.8,5119,79.8,3473,54.2,1646,25.7,1294,20.2
07,60,13,41,2270,100.0,774,34.1,1855,81.7,1496,65.9,359,15.8,415,18.3
07,60,14,42,10384,100.0,2757,26.6,9050,87.2,7627,73.4,1423,13.7,1334,12.8
07,60,14,43,10834,100.0,2832,26.1,9592,88.5,8002,73.9,1590,14.7,1242,11.5
07,60,15,44,9076,100.0,3317,36.5,7441,82.0,5759,63.5,1682,18.5,1635,18.0
07,60,15,45,8512,100.0,3626,42.6,6537,76.8,4886,57.4,1651,19.4,1975,23.2
07,60,15,46,7006,100.0,1634,23.3,6252,89.2,5372,76.7,880,12.6,754,10.8
07,60,15,47,3833,100.0,999,26.1,3247,84.7,2834,73.9,413,10.8,586,15.3
07,60,15,48,2903,100.0,623,21.5,2615,90.1,2280,78.5,335,11.5,288,9.9
08,10,01,01,4661,100.0,2692,57.8,2835,60.8,1969,42.2,866,18.6,1826,39.2
08,10,01,02,8140,100.0,4441,54.6,5239,64.4,3699,45.4,1540,18.9,2901,35.6
08,10,01,03,7205,100.0,3722,51.7,4809,66.7,3483,48.3,1326,18.4,2396,33.3
08,10,01,04,6688,100.0,4030,60.3,4103,61.3,2658,39.7,1445,21.6,2585,38.7
08,10,01,05,6290,100.0,3968,63.1,3926,62.4,2322,36.9,1604,25.5,2364,37.6
08,10,02,06,9377,100.0,5546,59.1,5760,61.4,3831,40.9,1929,20.6,3617,38.6
08,10,02,07,7460,100.0,5060,67.8,4777,64.0,2400,32.2,2377,31.9,2683,36.0
08,10,02,08,12010,100.0,6937,57.8,7500,62.4,5073,42.2,2427,20.2,4510,37.6
08,10,02,09,8735,100.0,5290,60.6,5167,59.2,3445,39.4,1722,19.7,3568,40.8
08,10,03,10,7604,100.0,3981,52.4,5122,67.4,3623,47.6,1499,19.7,2482,32.6
08,10,03,11,7124,100.0,3533,49.6,4828,67.8,3591,50.4,1237,17.4,2296,32.2
08,10,03,12,11518,100.0,6129,53.2,7567,65.7,5389,46.8,2178,18.9,3951,34.3
08,10,03,13,3763,100.0,1462,38.9,2949,78.4,2301,61.1,648,17.2,814,21.6
08,10,03,14,7940,100.0,4908,61.8,4720,59.4,3032,38.2,1688,21.3,3220,40.6
08,10,04,15,6461,100.0,3557,55.1,4158,64.4,2904,44.9,1254,19.4,2303,35.6
08,10,04,16,6507,100.0,3539,54.4,4239,65.1,2968,45.6,1271,19.5,2268,34.9
08,10,04,17,9510,100.0,5349,56.2,6059,63.7,4161,43.8,1898,20.0,3451,36.3
08,10,04,18,9205,100.0,4522,49.1,6323,68.7,4683,50.9,1640,17.8,2882,31.3
08,10,04,19,7233,100.0,4633,64.1,4079,56.4,2600,35.9,1479,20.4,3154,43.6
08,10,05,20,5756,100.0,4373,76.0,3460,60.1,1383,24.0,2077,36.1,2296,39.9
08,10,05,21,9513,100.0,6532,68.7,6429,67.6,2981,31.3,3448,36.2,3084,32.4
08,20,06,22,5823,100.0,4149,71.3,3033,52.1,1674,28.7,1359,23.3,2790,47.9
08,20,06,23,6707,100.0,3632,54.2,4405,65.7,3075,45.8,1330,19.8,2302,34.3
08,20,06,24,8993,100.0,4714,52.4,6410,71.3,4279,47.6,2131,23.7,2583,28.7
08,20,07,25,2556,100.0,909,35.6,2179,85.3,1647,64.4,532,20.8,377,14.7
08,20,07,26,6179,100.0,2043,33.1,5199,84.1,4136,66.9,1063,17.2,980,15.9
08,20,07,27,8097,100.0,2920,36.1,6630,81.9,5177,63.9,1453,17.9,1467,18.1
08,20,07,28,1201,100.0,421,35.1,1008,83.9,780,64.9,228,19.0,193,16.1
08,20,07,29,1882,100.0,745,39.6,1559,82.8,1137,60.4,422,22.4,323,17.2
08,20,07,30,3374,100.0,1238,36.7,2705,80.2,2136,63.3,569,16.9,669,19.8
08,20,08,31,8286,100.0,2687,32.4,7037,84.9,5599,67.6,1438,17.4,1249,15.1
08,20,08,32,11775,100.0,4391,37.3,9731,82.6,7384,62.7,2347,19.9,2044,17.4
08,20,08,33,9230,100.0,4899,53.1,6576,71.2,4331,46.9,2245,24.3,2654,28.8
08,30,09,34,12687,100.0,7136,56.2,9712,76.6,5551,43.8,4161,32.8,2975,23.4
08,30,09,35,7551,100.0,3790,50.2,5811,77.0,3761,49.8,2050,27.1,1740,23.0
08,30,10,36,7464,100.0,3919,52.5,5788,77.5,3545,47.5,2243,30.1,1676,22.5
08,30,10,37,11026,100.0,6661,60.4,8251,74.8,4365,39.6,3886,35.2,2775,25.2
08,40,11,38,2884,100.0,1103,38.2,2377,82.4,1781,61.8,596,20.7,507,17.6
08,40,11,39,4121,100.0,1613,39.1,3377,81.9,2508,60.9,869,21.1,744,18.1
08,40,11,40,2702,100.0,1062,39.3,2225,82.3,1640,60.7,585,21.7,477,17.7
08,40,12,41,8256,100.0,3391,41.1,6737,81.6,4865,58.9,1872,22.7,1519,18.4
08,40,12,42,6900,100.0,2122,30.8,5996,86.9,4778,69.2,1218,17.7,904,13.1
08,40,12,43,10066,100.0,3495,34.7,8365,83.1,6571,65.3,1794,17.8,1701,16.9
08,40,12,44,7299,100.0,2131,29.2,6547,89.7,5168,70.8,1379,18.9,752,10.3
08,40,12,45,3716,100.0,1269,34.1,3253,87.5,2447,65.9,806,21.7,463,12.5
08,40,12,46,7844,100.0,2376,30.3,6831,87.1,5468,69.7,1363,17.4,1013,12.9
09,10,01,01,13513,100.0,4952,36.6,10472,77.5,8561,63.4,1911,14.1,3041,22.5
09,10,02,02,4317,100.0,1017,23.6,3721,86.2,3300,76.4,421,9.8,596,13.8
09,10,02,03,7306,100.0,2067,28.3,5786,79.2,5239,71.7,547,7.5,1520,20.8
09,10,03,04,11989,100.0,2828,23.6,10226,85.3,9161,76.4,1065,8.9,1763,14.7
09,10,03,05,4285,100.0,1218,28.4,3503,81.8,3067,71.6,436,10.2,782,18.2
09,10,03,06,3101,100.0,1071,34.5,2487,80.2,2030,65.5,457,14.7,614,19.8
09,10,04,07,8598,100.0,1636,19.0,7570,88.0,6962,81.0,608,7.1,1028,12.0
09,10,04,08,8541,100.0,2037,23.8,7210,84.4,6504,76.2,706,8.3,1331,15.6
09,10,04,09,4010,100.0,1173,29.3,3440,85.8,2837,70.7,603,15.0,570,14.2
09,20,05,10,8013,100.0,3333,41.6,5369,67.0,4680,58.4,689,8.6,2644,33.0
09,20,05,11,13295,100.0,4220,31.7,10264,77.2,9075,68.3,1189,8.9,3031,22.8
09,20,05,12,4196,100.0,1587,37.8,2963,70.6,2609,62.2,354,8.4,1233,29.4
09,20,06,13,10708,100.0,4388,41.0,7276,67.9,6320,59.0,956,8.9,3432,32.1
09,20,06,14,3842,100.0,706,18.4,3328,86.6,3136,81.6,192,5.0,514,13.4
09,20,07,15,4306,100.0,2187,50.8,2702,62.7,2119,49.2,583,13.5,1604,37.3
09,20,07,16,8343,100.0,2728,32.7,6205,74.4,5615,67.3,590,7.1,2138,25.6
09,20,07,17,9771,100.0,2642,27.0,7773,79.6,7129,73.0,644,6.6,1998,20.4
09,20,08,18,4103,100.0,1085,26.4,3273,79.8,3018,73.6,255,6.2,830,20.2
09,20,08,19,8660,100.0,2646,30.6,6677,77.1,6014,69.4,663,7.7,1983,22.9
09,30,09,20,13156,100.0,3181,24.2,11470,87.2,9975,75.8,1495,11.4,1686,12.8
09,30,09,21,2767,100.0,483,17.5,2507,90.6,2284,82.5,223,8.1,260,9.4
09,30,09,22,5976,100.0,1568,26.2,4919,82.3,4408,73.8,511,8.6,1057,17.7
09,30,09,23,9094,100.0,2972,32.7,7248,79.7,6122,67.3,1126,12.4,1846,20.3
09,30,10,24,3736,100.0,1079,28.9,3078,82.4,2657,71.1,421,11.3,658,17.6
09,30,10,25,11959,100.0,2815,23.5,10022,83.8,9144,76.5,878,7.3,1937,16.2
09,30,11,26,8283,100.0,1740,21.0,7138,86.2,6543,79.0,595,7.2,1145,13.8
09,30,12,27,1852,100.0,214,11.6,1757,94.9,1638,88.4,119,6.4,95,5.1
09,30,12,28,2624,100.0,369,14.1,2428,92.5,2255,85.9,173,6.6,196,7.5
09,40,13,29,10903,100.0,1424,13.1,9969,91.4,9479,86.9,490,4.5,934,8.6
09,40,13,30,1884,100.0,243,12.9,1761,93.5,1641,87.1,120,6.4,123,6.5
09,40,14,31,5918,100.0,1132,19.1,5064,85.6,4786,80.9,278,4.7,854,14.4
09,40,14,32,1570,100.0,319,20.3,1368,87.1,1251,79.7,117,7.5,202,12.9
09,40,14,33,4533,100.0,956,21.1,3831,84.5,3577,78.9,254,5.6,702,15.5
09,40,15,34,7508,100.0,2058,27.4,6052,80.6,5450,72.6,602,8.0,1456,19.4
09,40,16,35,7055,100.0,756,10.7,6675,94.6,6299,89.3,376,5.3,380,5.4
09,50,17,36,4690,100.0,632,13.5,4246,90.5,4058,86.5,188,4.0,444,9.5
09,50,17,37,14387,100.0,1586,11.0,13477,93.7,12801,89.0,676,4.7,910,6.3
09,50,18,38,10810,100.0,1697,15.7,9763,90.3,9113,84.3,650,6.0,1047,9.7
09,50,19,39,6862,100.0,1774,25.9,5587,81.4,5088,74.1,499,7.3,1275,18.6
09,50,19,40,2727,100.0,640,23.5,2234,81.9,2087,76.5,147,5.4,493,18.1
09,50,19,41,2887,100.0,573,19.8,2492,86.3,2314,80.2,178,6.2,395,13.7
09,50,20,42,4272,100.0,746,17.5,3758,88.0,3526,82.5,232,5.4,514,12.0
09,50,20,43,9085,100.0,1086,12.0,8407,92.5,7999,88.0,408,4.5,678,7.5
10,10,01,01,5849,100.0,1998,34.2,4534,77.5,3851,65.8,683,11.7,1315,22.5
10,10,01,02,3701,100.0,1383,37.4,2682,72.5,2318,62.6,364,9.8,1019,27.5
10,10,01,03,8099,100.0,2510,31.0,6481,80.0,5589,69.0,892,11.0,1618,20.0
10,10,01,04,7592,100.0,2460,32.4,6352,83.7,5132,67.6,1220,16.1,1240,16.3
10,10,02,05,1233,100.0,876,71.0,418,33.9,357,29.0,61,4.9,815,66.1
10,10,02,06,11652,100.0,3788,32.5,9256,79.4,7864,67.5,1392,11.9,2396,20.6
10,10,02,07,8311,100.0,1807,21.7,7111,85.6,6504,78.3,607,7.3,1200,14.4
10,10,02,08,10133,100.0,3322,32.8,8000,78.9,6811,67.2,1189,11.7,2133,21.1
10,10,02,09,9584,100.0,3577,37.3,7043,73.5,6007,62.7,1036,10.8,2541,26.5
10,10,02,10,10846,100.0,3373,31.1,8924,82.3,7473,68.9,1451,13.4,1922,17.7
10,10,03,11,2347,100.0,904,38.5,1724,73.5,1443,61.5,281,12.0,623,26.5
10,10,03,12,16040,100.0,5675,35.4,12430,77.5,10365,64.6,2065,12.9,3610,22.5
10,10,03,13,5022,100.0,1881,37.5,3706,73.8,3141,62.5,565,11.3,1316,26.2
10,10,03,14,6425,100.0,1568,24.4,5519,85.9,4857,75.6,662,10.3,906,14.1
10,10,03,15,8200,100.0,2904,35.4,6455,78.7,5296,64.6,1159,14.1,1745,21.3
10,10,03,16,3680,100.0,663,18.0,3373,91.7,3017,82.0,356,9.7,307,8.3
10,20,04,17,8051,100.0,3506,43.5,5631,69.9,4545,56.5,1086,13.5,2420,30.1
10,20,04,18,7381,100.0,2203,29.8,5718,77.5,5178,70.2,540,7.3,1663,22.5
10,20,04,19,4344,100.0,2026,46.6,2846,65.5,2318,53.4,528,12.2,1498,34.5
10,20,04,20,8933,100.0,3740,41.9,5858,65.6,5193,58.1,665,7.4,3075,34.4
10,20,04,21,1742,100.0,859,49.3,1209,69.4,883,50.7,326,18.7,533,30.6
10,20,04,22,7356,100.0,3569,48.5,4393,59.7,3787,51.5,606,8.2,2963,40.3
10,20,04,23,6146,100.0,2525,41.1,4282,69.7,3621,58.9,661,10.8,1864,30.3
10,20,05,24,11610,100.0,3613,31.1,8865,76.4,7997,68.9,868,7.5,2745,23.6
10,20,05,25,5389,100.0,1845,34.2,3953,73.4,3544,65.8,409,7.6,1436,26.6
10,20,05,26,6204,100.0,2516,40.6,4293,69.2,3688,59.4,605,9.8,1911,30.8
10,20,06,27,3662,100.0,1025,28.0,2978,81.3,2637,72.0,341,9.3,684,18.7
10,20,06,28,6582,100.0,2116,32.1,5023,76.3,4466,67.9,557,8.5,1559,23.7
10,20,06,29,9114,100.0,2025,22.2,7848,86.1,7089,77.8,759,8.3,1266,13.9
10,20,06,30,6560,100.0,1216,18.5,5820,88.7,5344,81.5,476,7.3,740,11.3
10,30,07,31,7870,100.0,1699,21.6,6756,85.8,6171,78.4,585,7.4,1114,14.2
10,30,07,32,7204,100.0,1916,26.6,5965,82.8,5288,73.4,677,9.4,1239,17.2
10,30,07,33,5277,100.0,1661,31.5,4190,79.4,3616,68.5,574,10.9,1087,20.6
10,30,07,34,10638,100.0,1670,15.7,9834,92.4,8968,84.3,866,8.1,804,7.6
10,40,08,35,7845,100.0,902,11.5,7388,94.2,6943,88.5,445,5.7,457,5.8
10,40,08,36,3995,100.0,577,14.4,3616,90.5,3418,85.6,198,5.0,379,9.5
10,40,08,37,7904,100.0,779,9.9,7557,95.6,7125,90.1,432,5.5,347,4.4
10,40,09,38,10243,100.0,1122,11.0,9691,94.6,9121,89.0,570,5.6,552,5.4
10,40,09,39,4482,100.0,667,14.9,4119,91.9,3815,85.1,304,6.8,363,8.1
10,40,09,40,5854,100.0,494,8.4,5599,95.6,5360,91.6,239,4.1,255,4.4
10,40,09,41,9801,100.0,1003,10.2,9350,95.4,8798,89.8,552,5.6,451,4.6
11,10,01,01,3365,100.0,410,12.2,3154,93.7,2955,87.8,199,5.9,211,6.3
11,10,01,02,3144,100.0,1386,44.1,2087,66.4,1758,55.9,329,10.5,1057,33.6
11,10,02,03,9412,100.0,3732,39.7,6897,73.3,5680,60.3,1217,12.9,2515,26.7
11,10,02,04,7435,100.0,2925,39.3,5438,73.1,4510,60.7,928,12.5,1997,26.9
11,10,02,05,6293,100.0,2372,37.7,4578,72.7,3921,62.3,657,10.4,1715,27.3
11,10,02,06,7758,100.0,2857,36.8,5615,72.4,4901,63.2,714,9.2,2143,27.6
11,10,03,07,11725,100.0,4088,34.9,9178,78.3,7637,65.1,1541,13.1,2547,21.7
11,10,03,08,9840,100.0,3585,36.4,7362,74.8,6255,63.6,1107,11.3,2478,25.2
11,10,03,09,6659,100.0,2167,32.5,5067,76.1,4492,67.5,575,8.6,1592,23.9
11,20,04,10,10370,100.0,3782,36.5,7536,72.7,6588,63.5,948,9.1,2834,27.3
11,20,04,11,6890,100.0,2030,29.5,5499,79.8,4860,70.5,639,9.3,1391,20.2
11,20,05,12,3945,100.0,932,23.6,3226,81.8,3013,76.4,213,5.4,719,18.2
11,20,05,13,10332,100.0,3447,33.4,7689,74.4,6885,66.6,804,7.8,2643,25.6
11,20,05,14,15694,100.0,5508,35.1,12037,76.7,10186,64.9,1851,11.8,3657,23.3
11,20,05,15,4737,100.0,1594,33.6,3671,77.5,3143,66.4,528,11.1,1066,22.5
11,30,06,16,6001,100.0,2451,40.8,4486,74.8,3550,59.2,936,15.6,1515,25.2
11,30,06,17,4396,100.0,1480,33.7,3496,79.5,2916,66.3,580,13.2,900,20.5
11,30,06,18,3820,100.0,1379,36.1,2833,74.2,2441,63.9,392,10.3,987,25.8
11,30,06,19,8901,100.0,3632,40.8,6249,70.2,5269,59.2,980,11.0,2652,29.8
11,30,06,20,11366,100.0,4488,39.5,8406,74.0,6878,60.5,1528,13.4,2960,26.0
11,30,07,21,6674,100.0,4679,70.1,2472,37.0,1995,29.9,477,7.1,4202,63.0
11,30,07,22,10215,100.0,3186,31.2,8291,81.2,7029,68.8,1262,12.4,1924,18.8
11,30,07,23,2674,100.0,1881,70.3,1016,38.0,793,29.7,223,8.3,1658,62.0
11,30,07,24,4307,100.0,1478,34.3,3278,76.1,2829,65.7,449,10.4,1029,23.9
11,30,07,25,10078,100.0,2822,28.0,8120,80.6,7256,72.0,864,8.6,1958,19.4
11,30,08,26,10479,100.0,4578,43.7,7462,71.2,5901,56.3,1561,14.9,3017,28.8
11,40,09,27,4231,100.0,1192,28.2,3474,82.1,3039,71.8,435,10.3,757,17.9
11,40,09,28,2812,100.0,1192,42.4,1881,66.9,1620,57.6,261,9.3,931,33.1
11,40,09,29,16826,100.0,5629,33.5,12642,75.1,11197,66.5,1445,8.6,4184,24.9
11,40,09,30,4739,100.0,1062,22.4,4061,85.7,3677,77.6,384,8.1,678,14.3
11,40,09,31,7081,100.0,2236,31.6,5559,78.5,4845,68.4,714,10.1,1522,21.5
11,40,10,32,6241,100.0,2562,41.1,4384,70.2,3679,58.9,705,11.3,1857,29.8
11,40,10,33,6838,100.0,2973,43.5,4919,71.9,3865,56.5,1054,15.4,1919,28.1
11,40,10,34,3381,100.0,1288,38.1,2434,72.0,2093,61.9,341,10.1,947,28.0
11,40,11,35,10984,100.0,4119,37.5,8277,75.4,6865,62.5,1412,12.9,2707,24.6
11,40,11,36,8350,100.0,2546,30.5,6411,76.8,5804,69.5,607,7.3,1939,23.2
11,40,11,37,8829,100.0,3469,39.3,6543,74.1,5360,60.7,1183,13.4,2286,25.9
11,50,12,38,4810,100.0,1502,31.2,3893,80.9,3308,68.8,585,12.2,917,19.1
11,50,13,39,10543,100.0,2988,28.3,8419,79.9,7555,71.7,864,8.2,2124,20.1
11,50,13,40,11178,100.0,2184,19.5,9783,87.5,8994,80.5,789,7.1,1395,12.5
11,50,13,41,9778,100.0,3176,32.5,7483,76.5,6602,67.5,881,9.0,2295,23.5
12,10,01,01,11107,100.0,6598,59.4,7068,63.6,4509,40.6,2559,23.0,4039,36.4
12,10,01,02,9986,100.0,5484,54.9,6444,64.5,4502,45.1,1942,19.4,3542,35.5
12,10,01,03,7586,100.0,3722,49.1,5422,71.5,3864,50.9,1558,20.5,2164,28.5
12,10,02,04,9479,100.0,5163,54.5,6260,66.0,4316,45.5,1944,20.5,3219,34.0
12,10,02,05,13893,100.0,7070,50.9,9639,69.4,6823,49.1,2816,20.3,4254,30.6
12,10,02,06,4745,100.0,1894,39.9,3671,77.4,2851,60.1,820,17.3,1074,22.6
12,20,03,07,2794,100.0,1315,47.1,1944,69.6,1479,52.9,465,16.6,850,30.4
12,20,03,08,5787,100.0,2801,48.4,4225,73.0,2986,51.6,1239,21.4,1562,27.0
12,20,03,09,11205,100.0,6603,58.9,6856,61.2,4602,41.1,2254,20.1,4349,38.8
12,20,03,10,8313,100.0,5232,62.9,5081,61.1,3081,37.1,2000,24.1,3232,38.9
12,20,04,11,319,100.0,226,70.8,183,57.4,93,29.2,90,28.2,136,42.6
12,20,04,12,6537,100.0,2571,39.3,5077,77.7,3966,60.7,1111,17.0,1460,22.3
12,20,04,13,8094,100.0,3676,45.4,6026,74.5,4418,54.6,1608,19.9,2068,25.5
12,20,04,14,6575,100.0,5588,85.0,1188,18.1,987,15.0,201,3.1,5387,81.9
12,20,05,15,11040,100.0,3165,28.7,9135,82.7,7875,71.3,1260,11.4,1905,17.3
12,40,06,16,6144,100.0,1170,19.0,5551,90.3,4974,81.0,577,9.4,593,9.7
12,40,06,17,6753,100.0,1033,15.3,6327,93.7,5720,84.7,607,9.0,426,6.3
12,40,06,18,3799,100.0,720,19.0,3474,91.4,3079,81.0,395,10.4,325,8.6
12,40,06,19,7732,100.0,1324,17.1,7103,91.9,6408,82.9,695,9.0,629,8.1
12,40,07,20,8466,100.0,1295,15.3,7910,93.4,7171,84.7,739,8.7,556,6.6
12,40,07,21,7904,100.0,1295,16.4,7282,92.1,6609,83.6,673,8.5,622,7.9
12,40,07,22,8439,100.0,1479,17.5,7683,91.0,6960,82.5,723,8.6,756,9.0
12,40,07,23,8100,100.0,1521,18.8,7338,90.6,6579,81.2,759,9.4,762,9.4
12,50,08,24,9691,100.0,1951,20.1,8672,89.5,7740,79.9,932,9.6,1019,10.5
12,50,08,25,6927,100.0,2376,34.3,5280,76.2,4551,65.7,729,10.5,1647,23.8
12,50,09,26,5206,100.0,1739,33.4,4193,80.5,3467,66.6,726,13.9,1013,19.5
12,50,09,27,6867,100.0,2073,30.2,5800,84.5,4794,69.8,1006,14.6,1067,15.5
12,50,09,28,5130,100.0,1172,22.8,4534,88.4,3958,77.2,576,11.2,596,11.6
12,50,09,29,5094,100.0,1022,20.1,4684,92.0,4072,79.9,612,12.0,410,8.0
12,50,09,30,9936,100.0,3802,38.3,7561,76.1,6134,61.7,1427,14.4,2375,23.9
12,60,10,31,3255,100.0,1091,33.5,2729,83.8,2164,66.5,565,17.4,526,16.2
12,60,10,32,6143,100.0,3503,57.0,3940,64.1,2640,43.0,1300,21.2,2203,35.9
12,60,11,33,11370,100.0,6175,54.3,8251,72.6,5195,45.7,3056,26.9,3119,27.4
12,60,11,34,15962,100.0,8078,50.6,11715,73.4,7884,49.4,3831,24.0,4247,26.6
12,60,12,35,10657,100.0,6439,60.4,7293,68.4,4218,39.6,3075,28.9,3364,31.6
12,60,12,36,3161,100.0,1471,46.5,2505,79.2,1690,53.5,815,25.8,656,20.8
