district_id,forecast_area_id,district_region_id,planning_area_id,inhabitants,inhabitants_percentage,inhabitants_with_migration_background,inhabitants_with_migration_background_percentage,inhabitants_germans,inhabitants_germans_percentage,inhabitants_germans_without_migration_background,inhabitants_germans_without_migration_background_percentage,inhabitants_germans_with_migration_background,inhabitants_germans_with_migration_background_percentage,inhabitants_foreigners,inhabitants_foreigners_percentage
01,10,01,01,3406,100.0,2103,61.7,1988,58.4,1303,38.3,685,20.1,1418,41.6
01,10,01,02,1816,100.0,1214,66.9,913,50.3,602,33.1,311,17.1,903,49.7
01,10,01,03,5333,100.0,3182,59.7,3393,63.6,2151,40.3,1242,23.3,1940,36.4
01,10,01,04,4694,100.0,3075,65.5,2859,60.9,1619,34.5,1240,26.4,1835,39.1
01,10,02,05,2784,100.0,1811,65.1,1440,51.7,973,34.9,467,16.8,1344,48.3
01,10,02,06,1806,100.0,971,53.8,1143,63.3,835,46.2,308,17.1,663,36.7
01,10,02,07,8481,100.0,4506,53.1,5529,65.2,3975,46.9,1554,18.3,2952,34.8
01,10,03,08,7113,100.0,3246,45.6,4807,67.6,3867,54.4,940,13.2,2306,32.4
01,10,03,09,12307,100.0,5125,41.6,8977,72.9,7182,58.4,1795,14.6,3330,27.1
01,10,03,10,10045,100.0,5070,50.5,6411,63.8,4975,49.5,1436,14.3,3634,36.2
01,10,03,11,9205,100.0,4434,48.2,6296,68.4,4771,51.8,1525,16.6,2909,31.6
01,10,03,12,9877,100.0,4652,47.1,6784,68.7,5225,52.9,1559,15.8,3093,31.3
01,10,03,13,11047,100.0,5305,48.0,7408,67.1,5742,52.0,1666,15.1,3639,32.9
01,10,04,14,5393,100.0,2998,55.6,3152,58.4,2395,44.4,757,14.0,2241,41.6
01,10,04,15,12833,100.0,5308,41.4,9289,72.4,7525,58.6,1764,13.7,3544,27.6
01,10,04,16,13290,100.0,5438,40.9,9717,73.1,7852,59.1,1865,14.0,3573,26.9
01,20,05,17,3733,100.0,2190,58.7,2205,59.1,1543,41.3,662,17.7,1528,40.9
01,20,05,18,6897,100.0,4397,63.8,3860,56.0,2500,36.2,1360,19.7,3037,44.0
01,20,05,19,9080,100.0,4968,54.7,5711,62.9,4112,45.3,1599,17.6,3369,37.1
01,20,05,20,9421,100.0,4553,48.3,6655,70.6,4868,51.7,1787,19.0,2766,29.4
01,20,05,21,5192,100.0,3090,59.5,3241,62.4,2102,40.5,1139,21.9,1951,37.6
01,20,05,22,11351,100.0,4105,36.2,9044,79.7,7246,63.8,1798,15.8,2307,20.3
01,20,06,23,10766,100.0,5544,51.5,7381,68.6,5222,48.5,2159,20.1,3385,31.4
01,20,06,24,6111,100.0,4267,69.8,3126,51.2,1844,30.2,1282,21.0,2985,48.8
01,20,06,25,6877,100.0,4137,60.2,4546,66.1,2740,39.8,1806,26.3,2331,33.9
01,20,06,26,5840,100.0,2522,43.2,4322,74.0,3318,56.8,1004,17.2,1518,26.0
01,20,06,27,3219,100.0,2081,64.6,2170,67.4,1138,35.4,1032,32.1,1049,32.6
01,20,06,28,3252,100.0,1424,43.8,2482,76.3,1828,56.2,654,20.1,770,23.7
01,20,06,29,5926,100.0,2904,49.0,3897,65.8,3022,51.0,875,14.8,2029,34.2
01,30,07,30,7917,100.0,5702,72.0,4195,53.0,2215,28.0,1980,25.0,3722,47.0
01,30,07,31,8558,100.0,5039,58.9,5323,62.2,3519,41.1,1804,21.1,3235,37.8
01,30,07,32,9758,100.0,6125,62.8,5870,60.2,3633,37.2,2237,22.9,3888,39.8
01,30,07,33,11486,100.0,7142,62.2,7104,61.8,4344,37.8,2760,24.0,4382,38.2
01,30,08,34,14323,100.0,9633,67.3,9901,69.1,4690,32.7,5211,36.4,4422,30.9
01,30,08,35,10590,100.0,6403,60.5,7260,68.6,4187,39.5,3073,29.0,3330,31.4
01,30,08,36,14727,100.0,9585,65.1,8839,60.0,5142,34.9,3697,25.1,5888,40.0
01,40,09,37,10614,100.0,5234,49.3,7455,70.2,5380,50.7,2075,19.5,3159,29.8
01,40,09,38,9666,100.0,5133,53.1,6375,66.0,4533,46.9,1842,19.1,3291,34.0
01,40,09,39,5952,100.0,3153,53.0,3756,63.1,2799,47.0,957,16.1,2196,36.9
01,40,09,40,6773,100.0,2541,37.5,5625,83.1,4232,62.5,1393,20.6,1148,16.9
01,40,09,41,3783,100.0,1753,46.3,2811,74.3,2030,53.7,781,20.6,972,25.7
01,40,09,42,8662,100.0,4717,54.5,5448,62.9,3945,45.5,1503,17.4,3214,37.1
01,40,10,43,7671,100.0,5184,67.6,4514,58.8,2487,32.4,2027,26.4,3157,41.2
01,40,10,44,10110,100.0,6884,68.1,5661,56.0,3226,31.9,2435,24.1,4449,44.0
01,40,10,45,5539,100.0,4014,72.5,3071,55.4,1525,27.5,1546,27.9,2468,44.6
01,40,10,46,8737,100.0,4390,50.2,5948,68.1,4347,49.8,1601,18.3,2789,31.9
01,40,10,47,7829,100.0,5449,69.6,3887,49.6,2380,30.4,1507,19.2,3942,50.4
01,40,10,48,9263,100.0,5587,60.3,5655,61.0,3676,39.7,1979,21.4,3608,39.0
01,40,10,49,6639,100.0,4028,60.7,3906,58.8,2611,39.3,1295,19.5,2733,41.2
02,10,01,01,6216,100.0,4364,70.2,3684,59.3,1852,29.8,1832,29.5,2532,40.7
02,10,01,02,8637,100.0,6138,71.1,5566,64.4,2499,28.9,3067,35.5,3071,35.6
02,10,01,03,5379,100.0,3418,63.5,3694,68.7,1961,36.5,1733,32.2,1685,31.3
02,10,01,04,5627,100.0,3891,69.1,3506,62.3,1736,30.9,1770,31.5,2121,37.7
02,10,01,05,9495,100.0,6779,71.4,6215,65.5,2716,28.6,3499,36.9,3280,34.5
02,10,01,06,4993,100.0,3263,65.4,3371,67.5,1730,34.6,1641,32.9,1622,32.5
02,20,02,07,2242,100.0,922,41.1,1710,76.3,1320,58.9,390,17.4,532,23.7
02,20,02,08,5853,100.0,2610,44.6,4210,71.9,3243,55.4,967,16.5,1643,28.1
02,20,02,09,10845,100.0,4476,41.3,8165,75.3,6369,58.7,1796,16.6,2680,24.7
02,20,02,10,12225,100.0,5373,44.0,8883,72.7,6852,56.0,2031,16.6,3342,27.3
02,20,02,11,14689,100.0,6228,42.4,11013,75.0,8461,57.6,2552,17.4,3676,25.0
02,20,02,12,8537,100.0,4338,50.8,6230,73.0,4199,49.2,2031,23.8,2307,27.0
02,20,02,13,10142,100.0,4652,45.9,7176,70.8,5490,54.1,1686,16.6,2966,29.2
02,30,03,14,7479,100.0,4574,61.2,4741,63.4,2905,38.8,1836,24.5,2738,36.6
02,30,03,15,8530,100.0,4888,57.3,5638,66.1,3642,42.7,1996,23.4,2892,33.9
02,30,03,16,4215,100.0,2089,49.6,2967,70.4,2126,50.4,841,20.0,1248,29.6
02,30,04,17,8242,100.0,4561,55.3,5431,65.9,3681,44.7,1750,21.2,2811,34.1
02,30,04,18,7653,100.0,3680,48.1,5371,70.2,3973,51.9,1398,18.3,2282,29.8
02,30,04,19,10710,100.0,5541,51.7,7130,66.6,5169,48.3,1961,18.3,3580,33.4
02,40,05,20,5673,100.0,2020,35.6,4464,78.7,3653,64.4,811,14.3,1209,21.3
02,40,05,21,7867,100.0,2794,35.5,6127,77.9,5073,64.5,1054,13.4,1740,22.1
02,40,05,22,11223,100.0,3457,30.8,9020,80.4,7766,69.2,1254,11.2,2203,19.6
02,40,06,23,13383,100.0,6435,48.1,9184,68.6,6948,51.9,2236,16.7,4199,31.4
02,40,06,24,11459,100.0,4056,35.4,8512,74.3,7403,64.6,1109,9.7,2947,25.7
02,40,06,25,1093,100.0,754,69.0,440,40.3,339,31.0,101,9.2,653,59.7
02,50,07,26,9247,100.0,3512,38.0,6776,73.3,5735,62.0,1041,11.3,2471,26.7
02,50,07,27,6586,100.0,2447,37.2,4903,74.4,4139,62.8,764,11.6,1683,25.6
02,50,07,28,10036,100.0,3410,34.0,7642,76.1,6626,66.0,1016,10.1,2394,23.9
02,50,07,29,5444,100.0,1914,35.2,4211,77.4,3530,64.8,681,12.5,1233,22.6
02,50,08,30,3914,100.0,1572,40.2,2809,71.8,2342,59.8,467,11.9,1105,28.2
02,50,08,31,7841,100.0,3079,39.3,5666,72.3,4762,60.7,904,11.5,2175,27.7
02,50,08,32,9115,100.0,3915,43.0,6329,69.4,5200,57.0,1129,12.4,2786,30.6
02,50,08,33,10186,100.0,3951,38.8,7215,70.8,6235,61.2,980,9.6,2971,29.2
02,50,08,34,11444,100.0,4112,35.9,8596,75.1,7332,64.1,1264,11.0,2848,24.9
02,50,08,35,7931,100.0,3235,40.8,5601,70.6,4696,59.2,905,11.4,2330,29.4
02,50,08,36,4863,100.0,1170,24.1,4323,88.9,3693,75.9,630,13.0,540,11.1
03,10,01,01,4592,100.0,831,18.1,4072,88.7,3761,81.9,311,6.8,520,11.3
03,10,01,02,3180,100.0,885,27.8,2511,79.0,2295,72.2,216,6.8,669,21.0
03,10,01,03,8856,100.0,1674,18.9,7652,86.4,7182,81.1,470,5.3,1204,13.6
03,20,02,04,2113,100.0,199,9.4,2008,95.0,1914,90.6,94,4.4,105,5.0
03,20,02,05,8751,100.0,1488,17.0,7924,90.5,7263,83.0,661,7.6,827,9.5
03,20,02,06,6406,100.0,1335,20.8,5548,86.6,5071,79.2,477,7.4,858,13.4
03,20,02,07,11427,100.0,2048,17.9,10265,89.8,9379,82.1,886,7.8,1162,10.2
03,20,03,08,5193,100.0,702,13.5,4896,94.3,4491,86.5,405,7.8,297,5.7
03,20,03,09,5286,100.0,890,16.8,4810,91.0,4396,83.2,414,7.8,476,9.0
03,20,03,10,8018,100.0,1286,16.0,7458,93.0,6732,84.0,726,9.1,560,7.0
03,30,04,11,11592,100.0,2526,21.8,10028,86.5,9066,78.2,962,8.3,1564,13.5
03,30,04,12,5137,100.0,504,9.8,4941,96.2,4633,90.2,308,6.0,196,3.8
03,30,04,13,3092,100.0,273,8.8,2979,96.3,2819,91.2,160,5.2,113,3.7
03,30,05,14,6860,100.0,651,9.5,6548,95.5,6209,90.5,339,4.9,312,4.5
03,30,05,15,50,100.0,0,0.0,50,100.0,50,100.0,0,0.0,0,0.0
03,30,05,16,7982,100.0,1765,22.1,6765,84.8,6217,77.9,548,6.9,1217,15.2
03,30,05,17,1118,100.0,52,4.7,1100,98.4,1066,95.3,34,3.0,18,1.6
03,40,06,18,4854,100.0,1073,22.1,4486,92.4,3781,77.9,705,14.5,368,7.6
03,40,06,19,10371,100.0,2084,20.1,9312,89.8,8287,79.9,1025,9.9,1059,10.2
03,40,06,20,3545,100.0,696,19.6,3199,90.2,2849,80.4,350,9.9,346,9.8
03,40,07,21,11607,100.0,2538,21.9,10224,88.1,9069,78.1,1155,10.0,1383,11.9
03,40,07,22,3610,100.0,601,16.6,3330,92.2,3009,83.4,321,8.9,280,7.8
03,40,07,23,7067,100.0,1685,23.8,6096,86.3,5382,76.2,714,10.1,971,13.7
03,40,07,24,7584,100.0,1105,14.6,6970,91.9,6479,85.4,491,6.5,614,8.1
03,40,07,25,7416,100.0,1023,13.8,6842,92.3,6393,86.2,449,6.1,574,7.7
03,40,08,26,6789,100.0,1492,22.0,5726,84.3,5297,78.0,429,6.3,1063,15.7
03,40,08,27,9659,100.0,2412,25.0,8105,83.9,7247,75.0,858,8.9,1554,16.1
03,40,08,28,4818,100.0,1246,25.9,3947,81.9,3572,74.1,375,7.8,871,18.1
03,40,08,29,5544,100.0,1036,18.7,4919,88.7,4508,81.3,411,7.4,625,11.3
03,40,08,30,9232,100.0,1575,17.1,8290,89.8,7657,82.9,633,6.9,942,10.2
03,40,08,31,0,100.0,0,0.0,0,0.0,0,0.0,0,0.0,0,0.0
03,50,09,32,5834,100.0,1365,23.4,4754,81.5,4469,76.6,285,4.9,1080,18.5
03,50,09,33,7632,100.0,1379,18.1,6769,88.7,6253,81.9,516,6.8,863,11.3
03,50,09,34,10203,100.0,2854,28.0,8272,81.1,7349,72.0,923,9.0,1931,18.9
03,50,09,35,6585,100.0,1814,27.5,5385,81.8,4771,72.5,614,9.3,1200,18.2
03,50,09,36,9819,100.0,2205,22.5,8387,85.4,7614,77.5,773,7.9,1432,14.6
03,50,10,37,8560,100.0,1794,21.0,7329,85.6,6766,79.0,563,6.6,1231,14.4
03,50,10,38,7422,100.0,1233,16.6,6596,88.9,6189,83.4,407,5.5,826,11.1
03,60,11,39,3751,100.0,1340,35.7,2862,76.3,2411,64.3,451,12.0,889,23.7
03,60,11,40,5902,100.0,1873,31.7,4661,79.0,4029,68.3,632,10.7,1241,21.0
03,60,11,41,6585,100.0,2273,34.5,5047,76.6,4312,65.5,735,11.2,1538,23.4
03,60,11,42,10748,100.0,3901,36.3,8050,74.9,6847,63.7,1203,11.2,2698,25.1
03,60,12,43,6987,100.0,2068,29.6,5634,80.6,4919,70.4,715,10.2,1353,19.4
03,60,12,44,7546,100.0,2100,27.8,6206,82.2,5446,72.2,760,10.1,1340,17.8
03,60,12,45,12758,100.0,3638,28.5,10310,80.8,9120,71.5,1190,9.3,2448,19.2
03,60,13,46,5875,100.0,2171,37.0,4393,74.8,3704,63.0,689,11.7,1482,25.2
03,60,13,47,9376,100.0,3060,32.6,7427,79.2,6316,67.4,1111,11.8,1949,20.8
03,60,13,48,7419,100.0,2522,34.0,5749,77.5,4897,66.0,852,11.5,1670,22.5
03,60,14,49,9890,100.0,1996,20.2,8651,87.5,7894,79.8,757,7.7,1239,12.5
03,60,14,50,4116,100.0,1903,46.2,2555,62.1,2213,53.8,342,8.3,1561,37.9
03,60,14,51,6296,100.0,1952,31.0,4918,78.1,4344,69.0,574,9.1,1378,21.9
03,60,14,52,4412,100.0,1631,37.0,3269,74.1,2781,63.0,488,11.1,1143,25.9
03,60,14,53,3017,100.0,970,32.2,2488,82.5,2047,67.8,441,14.6,529,17.5
03,70,15,54,11385,100.0,4411,38.7,8502,74.7,6974,61.3,1528,13.4,2883,25.3
03,70,15,55,7260,100.0,2431,33.5,5696,78.5,4829,66.5,867,11.9,1564,21.5
03,70,15,56,8636,100.0,3446,39.9,6280,72.7,5190,60.1,1090,12.6,2356,27.3
03,70,16,57,3216,100.0,1116,34.7,2463,76.6,2100,65.3,363,11.3,753,23.4
03,70,16,58,8395,100.0,2806,33.4,6534,77.8,5589,66.6,945,11.3,1861,22.2
03,70,16,59,9086,100.0,3169,34.9,7072,77.8,5917,65.1,1155,12.7,2014,22.2
03,70,16,60,12708,100.0,3690,29.0,10438,82.1,9018,71.0,1420,11.2,2270,17.9
04,10,01,01,11396,100.0,5762,50.6,7927,69.6,5634,49.4,2293,20.1,3469,30.4
04,10,01,02,7755,100.0,4375,56.4,5569,71.8,3380,43.6,2189,28.2,2186,28.2
04,20,02,03,1455,100.0,388,26.7,1265,86.9,1067,73.3,198,13.6,190,13.1
04,20,02,04,2841,100.0,960,33.8,2224,78.3,1881,66.2,343,12.1,617,21.7
04,20,02,05,2477,100.0,756,30.5,2057,83.0,1721,69.5,336,13.6,420,17.0
04,20,02,06,2846,100.0,773,27.2,2490,87.5,2073,72.8,417,14.7,356,12.5
04,20,02,07,3010,100.0,1088,36.1,2229,74.1,1922,63.9,307,10.2,781,25.9
04,20,03,08,6141,100.0,2185,35.6,4759,77.5,3956,64.4,803,13.1,1382,22.5
04,20,03,09,6784,100.0,1851,27.3,5861,86.4,4933,72.7,928,13.7,923,13.6
04,20,03,10,7618,100.0,2805,36.8,6082,79.8,4813,63.2,1269,16.7,1536,20.2
04,20,03,11,7237,100.0,2871,39.7,5528,76.4,4366,60.3,1162,16.1,1709,23.6
04,30,04,12,3687,100.0,1999,54.2,2270,61.6,1688,45.8,582,15.8,1417,38.4
04,30,04,13,10011,100.0,4757,47.5,7531,75.2,5254,52.5,2277,22.7,2480,24.8
04,30,04,14,10520,100.0,4041,38.4,8265,78.6,6479,61.6,1786,17.0,2255,21.4
04,30,04,15,6267,100.0,2399,38.3,4913,78.4,3868,61.7,1045,16.7,1354,21.6
04,30,04,16,11650,100.0,4671,40.1,8931,76.7,6979,59.9,1952,16.8,2719,23.3
04,30,05,17,9436,100.0,4436,47.0,6809,72.2,5000,53.0,1809,19.2,2627,27.8
04,30,05,18,5717,100.0,2612,45.7,4234,74.1,3105,54.3,1129,19.7,1483,25.9
04,30,06,19,8583,100.0,3838,44.7,6419,74.8,4745,55.3,1674,19.5,2164,25.2
04,30,06,20,3397,100.0,2029,59.7,2163,63.7,1368,40.3,795,23.4,1234,36.3
04,30,06,21,10501,100.0,5056,48.1,7650,72.9,5445,51.9,2205,21.0,2851,27.1
04,30,06,22,5150,100.0,2982,57.9,3487,67.7,2168,42.1,1319,25.6,1663,32.3
04,30,06,23,11938,100.0,6543,54.8,7811,65.4,5395,45.2,2416,20.2,4127,34.6
04,30,06,24,9175,100.0,4142,45.1,6606,72.0,5033,54.9,1573,17.1,2569,28.0
04,40,07,25,107,100.0,74,69.2,42,39.3,33,30.8,9,8.4,65,60.7
04,40,07,26,5298,100.0,2237,42.2,4089,77.2,3061,57.8,1028,19.4,1209,22.8
04,40,07,27,8251,100.0,3319,40.2,6477,78.5,4932,59.8,1545,18.7,1774,21.5
04,40,07,28,3066,100.0,1132,36.9,2479,80.9,1934,63.1,545,17.8,587,19.1
04,40,07,29,2832,100.0,1097,38.7,2266,80.0,1735,61.3,531,18.8,566,20.0
04,40,08,30,7100,100.0,2859,40.3,5636,79.4,4241,59.7,1395,19.6,1464,20.6
04,40,08,31,1510,100.0,438,29.0,1305,86.4,1072,71.0,233,15.4,205,13.6
04,40,08,32,6813,100.0,1727,25.3,5956,87.4,5086,74.7,870,12.8,857,12.6
04,40,08,33,4119,100.0,1524,37.0,3329,80.8,2595,63.0,734,17.8,790,19.2
04,40,08,34,3512,100.0,1140,32.5,2931,83.5,2372,67.5,559,15.9,581,16.5
04,40,08,35,10341,100.0,2929,28.3,8745,84.6,7412,71.7,1333,12.9,1596,15.4
04,50,09,36,5499,100.0,2479,45.1,4086,74.3,3020,54.9,1066,19.4,1413,25.7
04,50,09,37,7503,100.0,3131,41.7,5702,76.0,4372,58.3,1330,17.7,1801,24.0
04,50,09,38,7894,100.0,3657,46.3,5800,73.5,4237,53.7,1563,19.8,2094,26.5
04,50,09,39,6461,100.0,3049,47.2,4858,75.2,3412,52.8,1446,22.4,1603,24.8
04,50,10,40,5865,100.0,2589,44.1,4400,75.0,3276,55.9,1124,19.2,1465,25.0
04,50,10,41,5175,100.0,2262,43.7,3925,75.8,2913,56.3,1012,19.6,1250,24.2
04,50,10,42,3492,100.0,1964,56.2,2228,63.8,1528,43.8,700,20.0,1264,36.2
04,50,10,43,10890,100.0,4934,45.3,8124,74.6,5956,54.7,2168,19.9,2766,25.4
04,50,10,44,5224,100.0,2264,43.3,3916,75.0,2960,56.7,956,18.3,1308,25.0
04,50,10,45,9019,100.0,4286,47.5,6416,71.1,4733,52.5,1683,18.7,2603,28.9
04,50,11,46,4456,100.0,1917,43.0,3362,75.4,2539,57.0,823,18.5,1094,24.6
04,50,11,47,5471,100.0,2380,43.5,4110,75.1,3091,56.5,1019,18.6,1361,24.9
04,50,11,48,4291,100.0,1875,43.7,3262,76.0,2416,56.3,846,19.7,1029,24.0
04,50,11,49,9732,100.0,3956,40.6,7421,76.3,5776,59.4,1645,16.9,2311,23.7
04,50,11,50,3038,100.0,1169,38.5,2349,77.3,1869,61.5,480,15.8,689,22.7
04,50,11,51,7338,100.0,2397,32.7,6015,82.0,4941,67.3,1074,14.6,1323,18.0
04,50,11,52,6756,100.0,2968,43.9,5022,74.3,3788,56.1,1234,18.3,1734,25.7
04,50,11,53,7353,100.0,3301,44.9,5513,75.0,4052,55.1,1461,19.9,1840,25.0
05,10,01,01,4126,100.0,785,19.0,3814,92.4,3341,81.0,473,11.5,312,7.6
05,10,01,02,4264,100.0,1046,24.5,3670,86.1,3218,75.5,452,10.6,594,13.9
05,10,01,03,5922,100.0,2847,48.1,4204,71.0,3075,51.9,1129,19.1,1718,29.0
05,10,01,04,4955,100.0,2115,42.7,3877,78.2,2840,57.3,1037,20.9,1078,21.8
05,10,01,05,7511,100.0,1540,20.5,6789,90.4,5971,79.5,818,10.9,722,9.6
05,10,02,06,3552,100.0,1571,44.2,2681,75.5,1981,55.8,700,19.7,871,24.5
05,10,02,07,2298,100.0,661,28.8,2046,89.0,1637,71.2,409,17.8,252,11.0
05,10,02,08,10744,100.0,4973,46.3,7945,73.9,5771,53.7,2174,20.2,2799,26.1
05,10,02,09,11756,100.0,6230,53.0,8874,75.5,5526,47.0,3348,28.5,2882,24.5
05,10,02,10,7666,100.0,2960,38.6,5811,75.8,4706,61.4,1105,14.4,1855,24.2
05,10,02,11,6015,100.0,2074,34.5,5018,83.4,3941,65.5,1077,17.9,997,16.6
05,10,03,12,4030,100.0,1734,43.0,2911,72.2,2296,57.0,615,15.3,1119,27.8
05,10,03,13,6134,100.0,3330,54.3,4337,70.7,2804,45.7,1533,25.0,1797,29.3
05,10,03,14,7362,100.0,4453,60.5,4095,55.6,2909,39.5,1186,16.1,3267,44.4
05,10,03,15,6878,100.0,3187,46.3,4804,69.8,3691,53.7,1113,16.2,2074,30.2
05,10,03,16,10259,100.0,4348,42.4,7846,76.5,5911,57.6,1935,18.9,2413,23.5
05,10,03,17,3575,100.0,1741,48.7,2256,63.1,1834,51.3,422,11.8,1319,36.9
05,20,04,18,3824,100.0,887,23.2,3562,93.1,2937,76.8,625,16.3,262,6.9
05,20,04,19,1664,100.0,102,6.1,1643,98.7,1562,93.9,81,4.9,21,1.3
05,20,04,20,5770,100.0,1866,32.3,4899,84.9,3904,67.7,995,17.2,871,15.1
05,20,04,21,4295,100.0,1238,28.8,3539,82.4,3057,71.2,482,11.2,756,17.6
05,20,04,22,1095,100.0,238,21.7,991,90.5,857,78.3,134,12.2,104,9.5
05,20,04,23,6583,100.0,2282,34.7,5280,80.2,4301,65.3,979,14.9,1303,19.8
05,20,05,24,3319,100.0,976,29.4,2942,88.6,2343,70.6,599,18.0,377,11.4
05,20,05,25,2414,100.0,621,25.7,2192,90.8,1793,74.3,399,16.5,222,9.2
05,20,05,26,5644,100.0,3247,57.5,3420,60.6,2397,42.5,1023,18.1,2224,39.4
05,20,05,27,11602,100.0,7294,62.9,7509,64.7,4308,37.1,3201,27.6,4093,35.3
05,20,05,28,7009,100.0,1937,27.6,6058,86.4,5072,72.4,986,14.1,951,13.6
05,20,06,29,8167,100.0,3409,41.7,6049,74.1,4758,58.3,1291,15.8,2118,25.9
05,20,06,30,9771,100.0,3731,38.2,7429,76.0,6040,61.8,1389,14.2,2342,24.0
05,20,06,31,8435,100.0,3325,39.4,6315,74.9,5110,60.6,1205,14.3,2120,25.1
05,20,06,32,3673,100.0,1726,47.0,2590,70.5,1947,53.0,643,17.5,1083,29.5
05,20,06,33,2006,100.0,558,27.8,1748,87.1,1448,72.2,300,15.0,258,12.9
05,20,06,34,4402,100.0,756,17.2,4020,91.3,3646,82.8,374,8.5,382,8.7
05,30,07,35,2912,100.0,1768,60.7,2254,77.4,1144,39.3,1110,38.1,658,22.6
05,30,07,36,3651,100.0,1973,54.0,2790,76.4,1678,46.0,1112,30.5,861,23.6
05,30,07,37,11550,100.0,5318,46.0,8896,77.0,6232,54.0,2664,23.1,2654,23.0
05,30,08,38,33,100.0,15,45.5,18,54.5,18,54.5,0,0.0,15,45.5
05,30,08,39,7595,100.0,3798,50.0,5325,70.1,3797,50.0,1528,20.1,2270,29.9
05,30,08,40,466,100.0,227,48.7,346,74.2,239,51.3,107,23.0,120,25.8
05,30,08,41,4543,100.0,2192,48.3,3284,72.3,2351,51.7,933,20.5,1259,27.7
05,40,09,42,3685,100.0,774,21.0,3356,91.1,2911,79.0,445,12.1,329,8.9
05,40,09,43,10400,100.0,2003,19.3,9760,93.8,8397,80.7,1363,13.1,640,6.2
05,40,09,44,2180,100.0,376,17.2,2031,93.2,1804,82.8,227,10.4,149,6.8
05,40,09,45,3661,100.0,597,16.3,3428,93.6,3064,83.7,364,9.9,233,6.4
06,10,01,01,6858,100.0,1848,26.9,5921,86.3,5010,73.1,911,13.3,937,13.7
06,10,01,02,8843,100.0,3316,37.5,7072,80.0,5527,62.5,1545,17.5,1771,20.0
06,10,01,03,6168,100.0,2006,32.5,5168,83.8,4162,67.5,1006,16.3,1000,16.2
06,10,02,04,6838,100.0,2517,36.8,5558,81.3,4321,63.2,1237,18.1,1280,18.7
06,10,02,05,9869,100.0,3377,34.2,8131,82.4,6492,65.8,1639,16.6,1738,17.6
06,10,02,06,7686,100.0,2362,30.7,6432,83.7,5324,69.3,1108,14.4,1254,16.3
06,10,02,07,7876,100.0,2711,34.4,6465,82.1,5165,65.6,1300,16.5,1411,17.9
06,10,02,08,6816,100.0,2214,32.5,5673,83.2,4602,67.5,1071,15.7,1143,16.8
06,10,02,09,9241,100.0,3393,36.7,7437,80.5,5848,63.3,1589,17.2,1804,19.5
06,10,02,10,4865,100.0,1497,30.8,4067,83.6,3368,69.2,699,14.4,798,16.4
06,20,03,11,4907,100.0,1215,24.8,4338,88.4,3692,75.2,646,13.2,569,11.6
06,20,03,12,6092,100.0,2011,33.0,4933,81.0,4081,67.0,852,14.0,1159,19.0
06,20,03,13,7380,100.0,2492,33.8,6073,82.3,4888,66.2,1185,16.1,1307,17.7
06,20,03,14,7207,100.0,2234,31.0,6069,84.2,4973,69.0,1096,15.2,1138,15.8
06,20,03,15,5953,100.0,1884,31.6,5003,84.0,4069,68.4,934,15.7,950,16.0
06,20,03,16,5328,100.0,2264,42.5,4109,77.1,3064,57.5,1045,19.6,1219,22.9
06,20,03,17,6360,100.0,1366,21.5,5739,90.2,4994,78.5,745,11.7,621,9.8
06,20,04,18,3,100.0,3,100.0,0,0.0,0,0.0,0,0.0,3,100.0
06,20,04,19,4594,100.0,2368,51.5,3373,73.4,2226,48.5,1147,25.0,1221,26.6
06,20,04,20,7138,100.0,2106,29.5,5985,83.8,5032,70.5,953,13.4,1153,16.2
06,20,04,21,8309,100.0,2292,27.6,7028,84.6,6017,72.4,1011,12.2,1281,15.4
06,20,04,22,7084,100.0,1599,22.6,6158,86.9,5485,77.4,673,9.5,926,13.1
06,20,04,23,8576,100.0,2418,28.2,7431,86.6,6158,71.8,1273,14.8,1145,13.4
06,30,05,24,5702,100.0,1445,25.3,4825,84.6,4257,74.7,568,10.0,877,15.4
06,30,05,25,5654,100.0,1445,25.6,4874,86.2,4209,74.4,665,11.8,780,13.8
06,30,05,26,3317,100.0,1062,32.0,2737,82.5,2255,68.0,482,14.5,580,17.5
06,30,05,27,8337,100.0,2422,29.1,7120,85.4,5915,70.9,1205,14.5,1217,14.6
06,30,05,28,10997,100.0,2612,23.8,9759,88.7,8385,76.2,1374,12.5,1238,11.3
06,30,06,29,7054,100.0,2006,28.4,5986,84.9,5048,71.6,938,13.3,1068,15.1
06,30,06,30,5630,100.0,2257,40.1,4205,74.7,3373,59.9,832,14.8,1425,25.3
06,30,06,31,2969,100.0,1069,36.0,2253,75.9,1900,64.0,353,11.9,716,24.1
06,30,06,32,13824,100.0,4105,29.7,11954,86.5,9719,70.3,2235,16.2,1870,13.5
06,30,06,33,11981,100.0,3140,26.2,10298,86.0,8841,73.8,1457,12.2,1683,14.0
06,30,06,34,8451,100.0,2041,24.2,7383,87.4,6410,75.8,973,11.5,1068,12.6
06,40,07,35,10122,100.0,2354,23.3,8835,87.3,7768,76.7,1067,10.5,1287,12.7
06,40,07,36,5237,100.0,1151,22.0,4772,91.1,4086,78.0,686,13.1,465,8.9
06,40,07,37,11237,100.0,3396,30.2,8947,79.6,7841,69.8,1106,9.8,2290,20.4
06,40,08,38,7413,100.0,1435,19.4,6748,91.0,5978,80.6,770,10.4,665,9.0
06,40,08,39,5209,100.0,1175,22.6,4639,89.1,4034,77.4,605,11.6,570,10.9
06,40,08,40,7170,100.0,1207,16.8,6581,91.8,5963,83.2,618,8.6,589,8.2
06,40,08,41,6001,100.0,1558,26.0,5247,87.4,4443,74.0,804,13.4,754,12.6
06,40,08,42,4808,100.0,1805,37.5,4094,85.1,3003,62.5,1091,22.7,714,14.9
06,40,08,43,4797,100.0,1463,30.5,3966,82.7,3334,69.5,632,13.2,831,17.3
06,40,08,44,7234,100.0,2406,33.3,5965,82.5,4828,66.7,1137,15.7,1269,17.5
07,10,01,01,9719,100.0,4745,48.8,7034,72.4,4974,51.2,2060,21.2,2685,27.6
07,10,01,02,8477,100.0,4333,51.1,5652,66.7,4144,48.9,1508,17.8,2825,33.3
07,10,01,03,7675,100.0,4860,63.3,4924,64.2,2815,36.7,2109,27.5,2751,35.8
07,10,02,04,10410,100.0,4151,39.9,7934,76.2,6259,60.1,1675,16.1,2476,23.8
07,10,02,05,5154,100.0,3489,67.7,3199,62.1,1665,32.3,1534,29.8,1955,37.9
07,10,02,06,8304,100.0,4145,49.9,5841,70.3,4159,50.1,1682,20.3,2463,29.7
07,20,03,07,10501,100.0,3849,36.7,8437,80.3,6652,63.3,1785,17.0,2064,19.7
07,20,03,08,10436,100.0,4818,46.2,7557,72.4,5618,53.8,1939,18.6,2879,27.6
07,20,04,09,9251,100.0,3516,38.0,7280,78.7,5735,62.0,1545,16.7,1971,21.3
07,20,04,10,5619,100.0,3109,55.3,3860,68.7,2510,44.7,1350,24.0,1759,31.3
07,20,04,11,2763,100.0,1227,44.4,2066,74.8,1536,55.6,530,19.2,697,25.2
07,20,04,12,1706,100.0,1013,59.4,1061,62.2,693,40.6,368,21.6,645,37.8
07,20,04,13,7753,100.0,2742,35.4,6183,79.7,5011,64.6,1172,15.1,1570,20.3
07,20,04,14,3723,100.0,1476,39.6,2907,78.1,2247,60.4,660,17.7,816,21.9
07,30,05,15,6809,100.0,1786,26.2,5964,87.6,5023,73.8,941,13.8,845,12.4
07,30,05,16,8808,100.0,2632,29.9,7367,83.6,6176,70.1,1191,13.5,1441,16.4
07,30,05,17,9180,100.0,3040,33.1,7534,82.1,6140,66.9,1394,15.2,1646,17.9
07,30,06,18,9307,100.0,3057,32.8,7714,82.9,6250,67.2,1464,15.7,1593,17.1
07,30,06,19,12234,100.0,5560,45.4,9387,76.7,6674,54.6,2713,22.2,2847,23.3
07,40,07,20,11909,100.0,4994,41.9,9511,79.9,6915,58.1,2596,21.8,2398,20.1
07,40,07,21,5375,100.0,1738,32.3,4625,86.0,3637,67.7,988,18.4,750,14.0
07,40,08,22,2288,100.0,550,24.0,2040,89.2,1738,76.0,302,13.2,248,10.8
07,40,08,23,9702,100.0,3610,37.2,7859,81.0,6092,62.8,1767,18.2,1843,19.0
07,40,08,24,7264,100.0,2952,40.6,5614,77.3,4312,59.4,1302,17.9,1650,22.7
07,40,08,25,7361,100.0,3200,43.5,5553,75.4,4161,56.5,1392,18.9,1808,24.6
07,40,08,26,5140,100.0,1466,28.5,4445,86.5,3674,71.5,771,15.0,695,13.5
07,40,09,27,11225,100.0,5282,47.1,8195,73.0,5943,52.9,2252,20.1,3030,27.0
07,40,09,28,3897,100.0,2254,57.8,2479,63.6,1643,42.2,836,21.5,1418,36.4
07,50,10,29,8044,100.0,3413,42.4,6295,78.3,4631,57.6,1664,20.7,1749,21.7
07,50,10,30,8716,100.0,3741,42.9,6803,78.1,4975,57.1,1828,21.0,1913,21.9
07,50,10,31,9025,100.0,3109,34.4,7542,83.6,5916,65.6,1626,18.0,1483,16.4
07,50,10,32,5579,100.0,1929,34.6,4695,84.2,3650,65.4,1045,18.7,884,15.8
07,50,11,33,8012,100.0,3289,41.1,6078,75.9,4723,58.9,1355,16.9,1934,24.1
07,50,11,34,10540,100.0,3215,30.5,9051,85.9,7325,69.5,1726,16.4,1489,14.1
07,50,11,35,2225,100.0,573,25.8,1964,88.3,1652,74.2,312,14.0,261,11.7
07,60,12,36,10226,100.0,4510,44.1,7700,75.3,5716,55.9,1984,19.4,2526,24.7
07,60,12,37,4766,100.0,1287,27.0,4208,88.3,3479,73.0,729,15.3,558,11.7
07,60,12,38,2868,100.0,1164,40.6,2346,81.8,1704,59.4,642,22.4,522,18.2
07,60,13,39,5706,100.0,2408,42.2,4794,84.0,3298,57.8,1496,26.2,912,16.0
07,60,13,40,6384,100.0,2756,43.2,5236,82.0,3628,56.8,1608,25.2,1148,18.0
07,60,13,41,2247,100.0,696,31.0,1875,83.4,1551,69.0,324,14.4,372,16.6
07,60,14,42,10413,100.0,2506,24.1,9277,89.1,7907,75.9,1370,13.2,1136,10.9
07,60,14,43,10926,100.0,2661,24.4,9876,90.4,8265,75.6,1611,14.7,1050,9.6
07,60,15,44,8883,100.0,2893,32.6,7475,84.1,5990,67.4,1485,16.7,1408,15.9
07,60,15,45,8341,100.0,3390,40.6,6404,76.8,4951,59.4,1453,17.4,1937,23.2
07,60,15,46,6907,100.0,1412,20.4,6300,91.2,5495,79.6,805,11.7,607,8.8
07,60,15,47,3832,100.0,832,21.7,3363,87.8,3000,78.3,363,9.5,469,12.2
07,60,15,48,2893,100.0,547,18.9,2630,90.9,2346,81.1,284,9.8,263,9.1
08,10,01,01,4709,100.0,2692,57.2,2883,61.2,2017,42.8,866,18.4,1826,38.8
08,10,01,02,8237,100.0,4425,53.7,5262,63.9,3812,46.3,1450,17.6,2975,36.1
08,10,01,03,7350,100.0,3703,50.4,4967,67.6,3647,49.6,1320,18.0,2383,32.4
08,10,01,04,6592,100.0,3822,58.0,4222,64.0,2770,42.0,1452,22.0,2370,36.0
08,10,01,05,5690,100.0,3641,64.0,3511,61.7,2049,36.0,1462,25.7,2179,38.3
08,10,02,06,9570,100.0,5666,59.2,5893,61.6,3904,40.8,1989,20.8,3677,38.4
08,10,02,07,7465,100.0,5038,67.5,4887,65.5,2427,32.5,2460,33.0,2578,34.5
08,10,02,08,12172,100.0,6826,56.1,7822,64.3,5346,43.9,2476,20.3,4350,35.7
08,10,02,09,8476,100.0,5041,59.5,5098,60.1,3435,40.5,1663,19.6,3378,39.9
08,10,03,10,7771,100.0,3979,51.2,5332,68.6,3792,48.8,1540,19.8,2439,31.4
08,10,03,11,7267,100.0,3508,48.3,4976,68.5,3759,51.7,1217,16.7,2291,31.5
08,10,03,12,11824,100.0,6135,51.9,7857,66.4,5689,48.1,2168,18.3,3967,33.6
08,10,03,13,3832,100.0,1473,38.4,2972,77.6,2359,61.6,613,16.0,860,22.4
08,10,03,14,8070,100.0,4969,61.6,4768,59.1,3101,38.4,1667,20.7,3302,40.9
08,10,04,15,6498,100.0,3470,53.4,4279,65.9,3028,46.6,1251,19.3,2219,34.1
08,10,04,16,6480,100.0,3425,52.9,4298,66.3,3055,47.1,1243,19.2,2182,33.7
08,10,04,17,9805,100.0,5421,55.3,6274,64.0,4384,44.7,1890,19.3,3531,36.0
08,10,04,18,9508,100.0,4554,47.9,6600,69.4,4954,52.1,1646,17.3,2908,30.6
08,10,04,19,7153,100.0,4395,61.4,4196,58.7,2758,38.6,1438,20.1,2957,41.3
08,10,05,20,5836,100.0,4381,75.1,3623,62.1,1455,24.9,2168,37.1,2213,37.9
08,10,05,21,9547,100.0,6350,66.5,6671,69.9,3197,33.5,3474,36.4,2876,30.1
08,20,06,22,5645,100.0,3905,69.2,3099,54.9,1740,30.8,1359,24.1,2546,45.1
08,20,06,23,6016,100.0,2779,46.2,4518,75.1,3237,53.8,1281,21.3,1498,24.9
08,20,06,24,8762,100.0,4239,48.4,6603,75.4,4523,51.6,2080,23.7,2159,24.6
08,20,07,25,2462,100.0,815,33.1,2150,87.3,1647,66.9,503,20.4,312,12.7
08,20,07,26,6172,100.0,1832,29.7,5339,86.5,4340,70.3,999,16.2,833,13.5
08,20,07,27,7921,100.0,2445,30.9,6803,85.9,5476,69.1,1327,16.8,1118,14.1
08,20,07,28,1211,100.0,409,33.8,1032,85.2,802,66.2,230,19.0,179,14.8
08,20,07,29,1854,100.0,676,36.5,1598,86.2,1178,63.5,420,22.7,256,13.8
08,20,07,30,3381,100.0,1162,34.4,2788,82.5,2219,65.6,569,16.8,593,17.5
08,20,08,31,8319,100.0,2456,29.5,7251,87.2,5863,70.5,1388,16.7,1068,12.8
08,20,08,32,11614,100.0,3842,33.1,9938,85.6,7772,66.9,2166,18.6,1676,14.4
08,20,08,33,8652,100.0,4134,47.8,6563,75.9,4518,52.2,2045,23.6,2089,24.1
08,30,09,34,12550,100.0,6736,53.7,9810,78.2,5814,46.3,3996,31.8,2740,21.8
08,30,09,35,7336,100.0,3347,45.6,5954,81.2,3989,54.4,1965,26.8,1382,18.8
08,30,10,36,7141,100.0,3511,49.2,5656,79.2,3630,50.8,2026,28.4,1485,20.8
08,30,10,37,10798,100.0,6403,59.3,8190,75.8,4395,40.7,3795,35.1,2608,24.2
08,40,11,38,2897,100.0,997,34.4,2485,85.8,1900,65.6,585,20.2,412,14.2
08,40,11,39,4106,100.0,1481,36.1,3460,84.3,2625,63.9,835,20.3,646,15.7
08,40,11,40,2665,100.0,946,35.5,2250,84.4,1719,64.5,531,19.9,415,15.6
08,40,12,41,8179,100.0,3044,37.2,6878,84.1,5135,62.8,1743,21.3,1301,15.9
08,40,12,42,6808,100.0,1831,26.9,6066,89.1,4977,73.1,1089,16.0,742,10.9
08,40,12,43,10005,100.0,3118,31.2,8572,85.7,6887,68.8,1685,16.8,1433,14.3
08,40,12,44,7145,100.0,1876,26.3,6547,91.6,5269,73.7,1278,17.9,598,8.4
08,40,12,45,3727,100.0,1158,31.1,3319,89.1,2569,68.9,750,20.1,408,10.9
08,40,12,46,7882,100.0,2217,28.1,6967,88.4,5665,71.9,1302,16.5,915,11.6
09,10,01,01,13108,100.0,4413,33.7,10511,80.2,8695,66.3,1816,13.9,2597,19.8
09,10,02,02,4310,100.0,877,20.3,3826,88.8,3433,79.7,393,9.1,484,11.2
09,10,02,03,6901,100.0,1451,21.0,5934,86.0,5450,79.0,484,7.0,967,14.0
09,10,03,04,11766,100.0,2287,19.4,10393,88.3,9479,80.6,914,7.8,1373,11.7
09,10,03,05,4022,100.0,858,21.3,3496,86.9,3164,78.7,332,8.3,526,13.1
09,10,03,06,3101,100.0,1000,32.2,2558,82.5,2101,67.8,457,14.7,543,17.5
09,10,04,07,8446,100.0,1180,14.0,7756,91.8,7266,86.0,490,5.8,690,8.2
09,10,04,08,8225,100.0,1441,17.5,7368,89.6,6784,82.5,584,7.1,857,10.4
09,10,04,09,3861,100.0,952,24.7,3460,89.6,2909,75.3,551,14.3,401,10.4
09,20,05,10,7562,100.0,2636,34.9,5558,73.5,4926,65.1,632,8.4,2004,26.5
09,20,05,11,12795,100.0,3249,25.4,10600,82.8,9546,74.6,1054,8.2,2195,17.2
09,20,05,12,3766,100.0,1120,29.7,2955,78.5,2646,70.3,309,8.2,811,21.5
09,20,06,13,9999,100.0,3485,34.9,7295,73.0,6514,65.1,781,7.8,2704,27.0
09,20,06,14,3560,100.0,380,10.7,3333,93.6,3180,89.3,153,4.3,227,6.4
09,20,07,15,3068,100.0,1300,42.4,2137,69.7,1768,57.6,369,12.0,931,30.3
09,20,07,16,7699,100.0,1833,23.8,6361,82.6,5866,76.2,495,6.4,1338,17.4
09,20,07,17,9561,100.0,1982,20.7,8141,85.1,7579,79.3,562,5.9,1420,14.9
09,20,08,18,3342,100.0,488,14.6,3019,90.3,2854,85.4,165,4.9,323,9.7
09,20,08,19,8359,100.0,2002,24.0,6924,82.8,6357,76.0,567,6.8,1435,17.2
09,30,09,20,12261,100.0,2363,19.3,11088,90.4,9898,80.7,1190,9.7,1173,9.6
09,30,09,21,2740,100.0,387,14.1,2554,93.2,2353,85.9,201,7.3,186,6.8
09,30,09,22,5916,100.0,1262,21.3,5108,86.3,4654,78.7,454,7.7,808,13.7
09,30,09,23,8140,100.0,1832,22.5,7252,89.1,6308,77.5,944,11.6,888,10.9
09,30,10,24,2663,100.0,403,15.1,2476,93.0,2260,84.9,216,8.1,187,7.0
09,30,10,25,10939,100.0,1810,16.5,9786,89.5,9129,83.5,657,6.0,1153,10.5
09,30,11,26,7480,100.0,1300,17.4,6686,89.4,6180,82.6,506,6.8,794,10.6
09,30,12,27,1883,100.0,200,10.6,1816,96.4,1683,89.4,133,7.1,67,3.6
09,30,12,28,2652,100.0,321,12.1,2501,94.3,2331,87.9,170,6.4,151,5.7
09,40,13,29,10151,100.0,805,7.9,9719,95.7,9346,92.1,373,3.7,432,4.3
09,40,13,30,1869,100.0,208,11.1,1779,95.2,1661,88.9,118,6.3,90,4.8
09,40,14,31,5393,100.0,550,10.2,5132,95.2,4843,89.8,289,5.4,261,4.8
09,40,14,32,1567,100.0,275,17.5,1402,89.5,1292,82.5,110,7.0,165,10.5
09,40,14,33,4483,100.0,752,16.8,3951,88.1,3731,83.2,220,4.9,532,11.9
09,40,15,34,7372,100.0,1629,22.1,6281,85.2,5743,77.9,538,7.3,1091,14.8
09,40,16,35,6908,100.0,620,9.0,6657,96.4,6288,91.0,369,5.3,251,3.6
09,50,17,36,4618,100.0,584,12.6,4227,91.5,4034,87.4,193,4.2,391,8.5
09,50,17,37,14446,100.0,1381,9.6,13731,95.1,13065,90.4,666,4.6,715,4.9
09,50,18,38,10233,100.0,1213,11.9,9553,93.4,9020,88.1,533,5.2,680,6.6
09,50,19,39,6414,100.0,1194,18.6,5616,87.6,5220,81.4,396,6.2,798,12.4
09,50,19,40,2708,100.0,498,18.4,2372,87.6,2210,81.6,162,6.0,336,12.4
09,50,19,41,2755,100.0,394,14.3,2512,91.2,2361,85.7,151,5.5,243,8.8
09,50,20,42,4164,100.0,498,12.0,3856,92.6,3666,88.0,190,4.6,308,7.4
09,50,20,43,9151,100.0,869,9.5,8666,94.7,8282,90.5,384,4.2,485,5.3
10,10,01,01,5732,100.0,1729,30.2,4691,81.8,4003,69.8,688,12.0,1041,18.2
10,10,01,02,3524,100.0,1104,31.3,2761,78.3,2420,68.7,341,9.7,763,21.7
10,10,01,03,7677,100.0,2075,27.0,6514,84.9,5602,73.0,912,11.9,1163,15.1
10,10,01,04,7577,100.0,2272,30.0,6540,86.3,5305,70.0,1235,16.3,1037,13.7
10,10,02,05,1275,100.0,867,68.0,461,36.2,408,32.0,53,4.2,814,63.8
10,10,02,06,11192,100.0,3112,27.8,9469,84.6,8080,72.2,1389,12.4,1723,15.4
10,10,02,07,8177,100.0,1488,18.2,7268,88.9,6689,81.8,579,7.1,909,11.1
10,10,02,08,9401,100.0,2504,26.6,7948,84.5,6897,73.4,1051,11.2,1453,15.5
10,10,02,09,8311,100.0,2439,29.3,6701,80.6,5872,70.7,829,10.0,1610,19.4
10,10,02,10,10756,100.0,2992,27.8,9213,85.7,7764,72.2,1449,13.5,1543,14.3
10,10,03,11,2221,100.0,659,29.7,1833,82.5,1562,70.3,271,12.2,388,17.5
10,10,03,12,15087,100.0,4356,28.9,12760,84.6,10731,71.1,2029,13.4,2327,15.4
10,10,03,13,4734,100.0,1459,30.8,3811,80.5,3275,69.2,536,11.3,923,19.5
10,10,03,14,6320,100.0,1320,20.9,5650,89.4,5000,79.1,650,10.3,670,10.6
10,10,03,15,7341,100.0,2060,28.1,6354,86.6,5281,71.9,1073,14.6,987,13.4
10,10,03,16,3708,100.0,578,15.6,3495,94.3,3130,84.4,365,9.8,213,5.7
10,20,04,17,7180,100.0,2507,34.9,5710,79.5,4673,65.1,1037,14.4,1470,20.5
10,20,04,18,5940,100.0,991,16.7,5317,89.5,4949,83.3,368,6.2,623,10.5
10,20,04,19,3554,100.0,1488,41.9,2508,70.6,2066,58.1,442,12.4,1046,29.4
10,20,04,20,7205,100.0,2064,28.6,5601,77.7,5141,71.4,460,6.4,1604,22.3
10,20,04,21,1754,100.0,914,52.1,1217,69.4,840,47.9,377,21.5,537,30.6
10,20,04,22,6622,100.0,2675,40.4,4471,67.5,3947,59.6,524,7.9,2151,32.5
10,20,04,23,5899,100.0,1941,32.9,4550,77.1,3958,67.1,592,10.0,1349,22.9
10,20,05,24,10600,100.0,2498,23.6,8847,83.5,8102,76.4,745,7.0,1753,16.5
10,20,05,25,5328,100.0,1497,28.1,4240,79.6,3831,71.9,409,7.7,1088,20.4
10,20,05,26,6054,100.0,2157,35.6,4498,74.3,3897,64.4,601,9.9,1556,25.7
10,20,06,27,3474,100.0,784,22.6,2997,86.3,2690,77.4,307,8.8,477,13.7
10,20,06,28,6479,100.0,1740,26.9,5292,81.7,4739,73.1,553,8.5,1187,18.3
10,20,06,29,8973,100.0,1656,18.5,8047,89.7,7317,81.5,730,8.1,926,10.3
10,20,06,30,6452,100.0,957,14.8,5978,92.7,5495,85.2,483,7.5,474,7.3
10,30,07,31,7712,100.0,1393,18.1,6890,89.3,6319,81.9,571,7.4,822,10.7
10,30,07,32,7052,100.0,1613,22.9,6169,87.5,5439,77.1,730,10.4,883,12.5
10,30,07,33,4729,100.0,1197,25.3,4023,85.1,3532,74.7,491,10.4,706,14.9
10,30,07,34,10361,100.0,1338,12.9,9808,94.7,9023,87.1,785,7.6,553,5.3
10,40,08,35,7774,100.0,754,9.7,7425,95.5,7020,90.3,405,5.2,349,4.5
10,40,08,36,3871,100.0,469,12.1,3583,92.6,3402,87.9,181,4.7,288,7.4
10,40,08,37,7711,100.0,601,7.8,7522,97.5,7110,92.2,412,5.3,189,2.5
10,40,09,38,9974,100.0,907,9.1,9603,96.3,9067,90.9,536,5.4,371,3.7
10,40,09,39,4426,100.0,546,12.3,4161,94.0,3880,87.7,281,6.3,265,6.0
10,40,09,40,5788,100.0,428,7.4,5602,96.8,5360,92.6,242,4.2,186,3.2
10,40,09,41,9694,100.0,821,8.5,9391,96.9,8873,91.5,518,5.3,303,3.1
11,10,01,01,3283,100.0,288,8.8,3140,95.6,2995,91.2,145,4.4,143,4.4
11,10,01,02,2700,100.0,971,36.0,1958,72.5,1729,64.0,229,8.5,742,27.5
11,10,02,03,8955,100.0,3099,34.6,6962,77.7,5856,65.4,1106,12.4,1993,22.3
11,10,02,04,7000,100.0,2425,34.6,5444,77.8,4575,65.4,869,12.4,1556,22.2
11,10,02,05,6152,100.0,1897,30.8,4849,78.8,4255,69.2,594,9.7,1303,21.2
11,10,02,06,7571,100.0,2339,30.9,5857,77.4,5232,69.1,625,8.3,1714,22.6
11,10,03,07,11761,100.0,3770,32.1,9474,80.6,7991,67.9,1483,12.6,2287,19.4
11,10,03,08,9591,100.0,2955,30.8,7680,80.1,6636,69.2,1044,10.9,1911,19.9
11,10,03,09,6010,100.0,1460,24.3,4989,83.0,4550,75.7,439,7.3,1021,17.0
11,20,04,10,10088,100.0,3224,32.0,7711,76.4,6864,68.0,847,8.4,2377,23.6
11,20,04,11,6786,100.0,1682,24.8,5747,84.7,5104,75.2,643,9.5,1039,15.3
11,20,05,12,3887,100.0,804,20.7,3284,84.5,3083,79.3,201,5.2,603,15.5
11,20,05,13,10037,100.0,2795,27.8,7942,79.1,7242,72.2,700,7.0,2095,20.9
11,20,05,14,15627,100.0,4919,31.5,12521,80.1,10708,68.5,1813,11.6,3106,19.9
11,20,05,15,4215,100.0,1019,24.2,3652,86.6,3196,75.8,456,10.8,563,13.4
11,30,06,16,5988,100.0,2226,37.2,4649,77.6,3762,62.8,887,14.8,1339,22.4
11,30,06,17,4275,100.0,1206,28.2,3611,84.5,3069,71.8,542,12.7,664,15.5
11,30,06,18,3728,100.0,1115,29.9,2960,79.4,2613,70.1,347,9.3,768,20.6
11,30,06,19,8472,100.0,3023,35.7,6410,75.7,5449,64.3,961,11.3,2062,24.3
11,30,06,20,11227,100.0,3991,35.5,8737,77.8,7236,64.5,1501,13.4,2490,22.2
11,30,07,21,5405,100.0,3423,63.3,2300,42.6,1982,36.7,318,5.9,3105,57.4
11,30,07,22,10088,100.0,2650,26.3,8578,85.0,7438,73.7,1140,11.3,1510,15.0
11,30,07,23,2358,100.0,1558,66.1,1022,43.3,800,33.9,222,9.4,1336,56.7
11,30,07,24,4039,100.0,1121,27.8,3303,81.8,2918,72.2,385,9.5,736,18.2
11,30,07,25,9958,100.0,2411,24.2,8340,83.8,7547,75.8,793,8.0,1618,16.2
11,30,08,26,9852,100.0,3832,38.9,7428,75.4,6020,61.1,1408,14.3,2424,24.6
11,40,09,27,4188,100.0,1065,25.4,3497,83.5,3123,74.6,374,8.9,691,16.5
11,40,09,28,2406,100.0,784,32.6,1864,77.5,1622,67.4,242,10.1,542,22.5
11,40,09,29,16263,100.0,4476,27.5,13044,80.2,11787,72.5,1257,7.7,3219,19.8
11,40,09,30,4687,100.0,858,18.3,4182,89.2,3829,81.7,353,7.5,505,10.8
11,40,09,31,6754,100.0,1893,28.0,5518,81.7,4861,72.0,657,9.7,1236,18.3
11,40,10,32,6011,100.0,2244,37.3,4386,73.0,3767,62.7,619,10.3,1625,27.0
11,40,10,33,6776,100.0,2596,38.3,5194,76.7,4180,61.7,1014,15.0,1582,23.3
11,40,10,34,3345,100.0,1114,33.3,2580,77.1,2231,66.7,349,10.4,765,22.9
11,40,11,35,10768,100.0,3614,33.6,8513,79.1,7154,66.4,1359,12.6,2255,20.9
11,40,11,36,8105,100.0,1982,24.5,6664,82.2,6123,75.5,541,6.7,1441,17.8
11,40,11,37,8659,100.0,2933,33.9,6849,79.1,5726,66.1,1123,13.0,1810,20.9
11,50,12,38,4266,100.0,1034,24.2,3680,86.3,3232,75.8,448,10.5,586,13.7
11,50,13,39,10338,100.0,2440,23.6,8668,83.8,7898,76.4,770,7.4,1670,16.2
11,50,13,40,10657,100.0,1498,14.1,9889,92.8,9159,85.9,730,6.8,768,7.2
11,50,13,41,7410,100.0,1264,17.1,6669,90.0,6146,82.9,523,7.1,741,10.0
12,10,01,01,10965,100.0,6174,56.3,7249,66.1,4791,43.7,2458,22.4,3716,33.9
12,10,01,02,9859,100.0,5040,51.1,6754,68.5,4819,48.9,1935,19.6,3105,31.5
12,10,01,03,7587,100.0,3465,45.7,5584,73.6,4122,54.3,1462,19.3,2003,26.4
12,10,02,04,8822,100.0,4278,48.5,6397,72.5,4544,51.5,1853,21.0,2425,27.5
12,10,02,05,13877,100.0,6561,47.3,10079,72.6,7316,52.7,2763,19.9,3798,27.4
12,10,02,06,4613,100.0,1544,33.5,3771,81.7,3069,66.5,702,15.2,842,18.3
12,20,03,07,2714,100.0,1114,41.0,2027,74.7,1600,59.0,427,15.7,687,25.3
12,20,03,08,5644,100.0,2523,44.7,4288,76.0,3121,55.3,1167,20.7,1356,24.0
12,20,03,09,10813,100.0,5992,55.4,7000,64.7,4821,44.6,2179,20.2,3813,35.3
12,20,03,10,8211,100.0,4994,60.8,5205,63.4,3217,39.2,1988,24.2,3006,36.6
12,20,04,11,362,100.0,259,71.5,206,56.9,103,28.5,103,28.5,156,43.1
12,20,04,12,6398,100.0,2295,35.9,5130,80.2,4103,64.1,1027,16.1,1268,19.8
12,20,04,13,8026,100.0,3414,42.5,6161,76.8,4612,57.5,1549,19.3,1865,23.2
12,20,04,14,1431,100.0,394,27.5,1243,86.9,1037,72.5,206,14.4,188,13.1
12,20,05,15,10973,100.0,2739,25.0,9384,85.5,8234,75.0,1150,10.5,1589,14.5
12,40,06,16,5960,100.0,879,14.7,5612,94.2,5081,85.3,531,8.9,348,5.8
12,40,06,17,6786,100.0,959,14.1,6422,94.6,5827,85.9,595,8.8,364,5.4
12,40,06,18,3762,100.0,637,16.9,3518,93.5,3125,83.1,393,10.4,244,6.5
12,40,06,19,7733,100.0,1187,15.3,7218,93.3,6546,84.7,672,8.7,515,6.7
12,40,07,20,8538,100.0,1177,13.8,8104,94.9,7361,86.2,743,8.7,434,5.1
12,40,07,21,8002,100.0,1195,14.9,7466,93.3,6807,85.1,659,8.2,536,6.7
12,40,07,22,8519,100.0,1247,14.6,7965,93.5,7272,85.4,693,8.1,554,6.5
12,40,07,23,8125,100.0,1368,16.8,7488,92.2,6757,83.2,731,9.0,637,7.8
12,50,08,24,9641,100.0,1647,17.1,8855,91.8,7994,82.9,861,8.9,786,8.2
12,50,08,25,6731,100.0,1936,28.8,5469,81.3,4795,71.2,674,10.0,1262,18.7
12,50,09,26,5089,100.0,1473,28.9,4264,83.8,3616,71.1,648,12.7,825,16.2
12,50,09,27,6445,100.0,1651,25.6,5652,87.7,4794,74.4,858,13.3,793,12.3
12,50,09,28,5107,100.0,1044,20.4,4636,90.8,4063,79.6,573,11.2,471,9.2
12,50,09,29,5137,100.0,907,17.7,4814,93.7,4230,82.3,584,11.4,323,6.3
12,50,09,30,10302,100.0,3868,37.5,7739,75.1,6434,62.5,1305,12.7,2563,24.9
12,60,10,31,3233,100.0,997,30.8,2779,86.0,2236,69.2,543,16.8,454,14.0
12,60,10,32,5920,100.0,3062,51.7,4006,67.7,2858,48.3,1148,19.4,1914,32.3
12,60,11,33,11412,100.0,6048,53.0,8360,73.3,5364,47.0,2996,26.3,3052,26.7
12,60,11,34,15316,100.0,7258,47.4,11654,76.1,8058,52.6,3596,23.5,3662,23.9
12,60,12,35,10598,100.0,6212,58.6,7338,69.2,4386,41.4,2952,27.9,3260,30.8
12,60,12,36,3121,100.0,1371,43.9,2524,80.9,1750,56.1,774,24.8,597,19.1
