district_id,forecast_area_id,district_region_id,planning_area_id,inhabitants,inhabitants_percentage,inhabitants_with_migration_background,inhabitants_with_migration_background_percentage,inhabitants_germans,inhabitants_germans_percentage,inhabitants_germans_without_migration_background,inhabitants_germans_without_migration_background_percentage,inhabitants_germans_with_migration_background,inhabitants_germans_with_migration_background_percentage,inhabitants_foreigners,inhabitants_foreigners_percentage
01,01,11,01,3419,100.0,2049,59.9,2032,59.4,1370,40.1,662,19.4,1387,40.6
01,01,11,02,192,100.0,90,46.9,119,62.0,102,53.1,17,8.9,73,38.0
01,01,11,03,5211,100.0,3041,58.4,3358,64.4,2170,41.6,1188,22.8,1853,35.6
01,01,11,04,4636,100.0,2994,64.6,2849,61.5,1642,35.4,1207,26.0,1787,38.5
01,01,11,05,1599,100.0,1109,69.4,763,47.7,490,30.6,273,17.1,836,52.3
01,01,12,01,2573,100.0,1593,61.9,1439,55.9,980,38.1,459,17.8,1134,44.1
01,01,12,02,646,100.0,316,48.9,418,64.7,330,51.1,88,13.6,228,35.3
01,01,12,03,1157,100.0,630,54.5,732,63.3,527,45.5,205,17.7,425,36.7
01,01,12,04,8312,100.0,4291,51.6,5498,66.1,4021,48.4,1477,17.8,2814,33.9
01,01,13,01,6967,100.0,3077,44.2,4814,69.1,3890,55.8,924,13.3,2153,30.9
01,01,13,02,12352,100.0,5060,41.0,9044,73.2,7292,59.0,1752,14.2,3308,26.8
01,01,13,03,9903,100.0,4845,48.9,6433,65.0,5058,51.1,1375,13.9,3470,35.0
01,01,13,04,9013,100.0,4134,45.9,6357,70.5,4879,54.1,1478,16.4,2656,29.5
01,01,13,05,9422,100.0,4188,44.4,6657,70.7,5234,55.6,1423,15.1,2765,29.3
01,01,13,06,10779,100.0,4967,46.1,7432,68.9,5812,53.9,1620,15.0,3347,31.1
01,01,14,01,17771,100.0,7829,44.1,12333,69.4,9942,55.9,2391,13.5,5438,30.6
01,01,14,02,13443,100.0,5433,40.4,9824,73.1,8010,59.6,1814,13.5,3619,26.9
01,02,21,01,3450,100.0,1929,55.9,2151,62.3,1521,44.1,630,18.3,1299,37.7
01,02,21,02,6866,100.0,4318,62.9,3879,56.5,2548,37.1,1331,19.4,2987,43.5
01,02,21,03,275,100.0,218,79.3,101,36.7,57,20.7,44,16.0,174,63.3
01,02,21,04,18536,100.0,9423,50.8,12473,67.3,9113,49.2,3360,18.1,6063,32.7
01,02,21,05,5235,100.0,3087,59.0,3315,63.3,2148,41.0,1167,22.3,1920,36.7
01,02,21,06,11333,100.0,4035,35.6,9066,80.0,7298,64.4,1768,15.6,2267,20.0
01,02,22,01,10825,100.0,5466,50.5,7505,69.3,5359,49.5,2146,19.8,3320,30.7
01,02,22,02,5178,100.0,3486,67.3,2838,54.8,1692,32.7,1146,22.1,2340,45.2
01,02,22,03,6976,100.0,4169,59.8,4602,66.0,2807,40.2,1795,25.7,2374,34.0
01,02,22,04,5935,100.0,2546,42.9,4408,74.3,3389,57.1,1019,17.2,1527,25.7
01,02,22,05,3280,100.0,2125,64.8,2190,66.8,1155,35.2,1035,31.6,1090,33.2
01,02,22,06,3132,100.0,1328,42.4,2419,77.2,1804,57.6,615,19.6,713,22.8
01,02,22,07,5807,100.0,2781,47.9,3829,65.9,3026,52.1,803,13.8,1978,34.1
01,03,31,01,26381,100.0,16815,63.7,15536,58.9,9566,36.3,5970,22.6,10845,41.1
01,03,31,02,11665,100.0,7224,61.9,7246,62.1,4441,38.1,2805,24.0,4419,37.9
01,03,32,01,14193,100.0,9418,66.4,9890,69.7,4775,33.6,5115,36.0,4303,30.3
01,03,32,02,10443,100.0,6224,59.6,7287,69.8,4219,40.4,3068,29.4,3156,30.2
01,03,32,03,14657,100.0,9466,64.6,8805,60.1,5191,35.4,3614,24.7,5852,39.9
01,04,41,01,20529,100.0,10333,50.3,14067,68.5,10196,49.7,3871,18.9,6462,31.5
01,04,41,02,16506,100.0,7160,43.4,12340,74.8,9346,56.6,2994,18.1,4166,25.2
01,04,41,03,8643,100.0,4643,53.7,5477,63.4,4000,46.3,1477,17.1,3166,36.6
01,04,42,01,23685,100.0,16244,68.6,13508,57.0,7441,31.4,6067,25.6,10177,43.0
01,04,42,02,16648,100.0,9796,58.8,9894,59.4,6852,41.2,3042,18.3,6754,40.6
01,04,42,03,15787,100.0,9459,59.9,9581,60.7,6328,40.1,3253,20.6,6206,39.3
02,01,01,01,6281,100.0,4366,69.5,3741,59.6,1915,30.5,1826,29.1,2540,40.4
02,01,01,02,14029,100.0,9558,68.1,9270,66.1,4471,31.9,4799,34.2,4759,33.9
02,01,01,03,15171,100.0,10702,70.5,9768,64.4,4469,29.5,5299,34.9,5403,35.6
02,01,01,04,5009,100.0,3273,65.3,3411,68.1,1736,34.7,1675,33.4,1598,31.9
02,02,02,01,2067,100.0,829,40.1,1587,76.8,1238,59.9,349,16.9,480,23.2
02,02,02,02,6008,100.0,2663,44.3,4317,71.9,3345,55.7,972,16.2,1691,28.1
02,02,02,03,10969,100.0,4456,40.6,8242,75.1,6513,59.4,1729,15.8,2727,24.9
02,02,02,04,12384,100.0,5420,43.8,8951,72.3,6964,56.2,1987,16.0,3433,27.7
02,02,02,05,14760,100.0,6176,41.8,11116,75.3,8584,58.2,2532,17.2,3644,24.7
02,02,02,06,18886,100.0,9019,47.8,13547,71.7,9867,52.2,3680,19.5,5339,28.3
02,03,03,01,8775,100.0,5537,63.1,5503,62.7,3238,36.9,2265,25.8,3272,37.3
02,03,03,02,12938,100.0,7120,55.0,8677,67.1,5818,45.0,2859,22.1,4261,32.9
02,03,04,01,14955,100.0,7436,49.7,10193,68.2,7519,50.3,2674,17.9,4762,31.8
02,03,04,02,10903,100.0,5590,51.3,7269,66.7,5313,48.7,1956,17.9,3634,33.3
02,04,05,01,5451,100.0,1726,31.7,4487,82.3,3725,68.3,762,14.0,964,17.7
02,04,05,02,7858,100.0,2670,34.0,6179,78.6,5188,66.0,991,12.6,1679,21.4
02,04,05,03,11262,100.0,3329,29.6,9130,81.1,7933,70.4,1197,10.6,2132,18.9
02,04,07,01,13307,100.0,6080,45.7,9371,70.4,7227,54.3,2144,16.1,3936,29.6
02,04,07,02,11314,100.0,3783,33.4,8607,76.1,7531,66.6,1076,9.5,2707,23.9
02,04,07,03,1136,100.0,782,68.8,445,39.2,354,31.2,91,8.0,691,60.8
02,05,06,01,9134,100.0,3266,35.8,6839,74.9,5868,64.2,971,10.6,2295,25.1
02,05,06,02,22173,100.0,7575,34.2,16914,76.3,14598,65.8,2316,10.4,5259,23.7
02,05,08,01,20872,100.0,8202,39.3,14992,71.8,12670,60.7,2322,11.1,5880,28.2
02,05,08,02,21568,100.0,7742,35.9,15942,73.9,13826,64.1,2116,9.8,5626,26.1
02,05,08,03,7868,100.0,3007,38.2,5719,72.7,4861,61.8,858,10.9,2149,27.3
02,05,08,04,4709,100.0,1078,22.9,4207,89.3,3631,77.1,576,12.2,502,10.7
03,01,01,01,4305,100.0,725,16.8,3835,89.1,3580,83.2,255,5.9,470,10.9
03,01,01,02,12165,100.0,2527,20.8,10323,84.9,9638,79.2,685,5.6,1842,15.1
03,01,01,04,222,100.0,55,24.8,189,85.1,167,75.2,22,9.9,33,14.9
03,02,02,03,2058,100.0,127,6.2,2011,97.7,1931,93.8,80,3.9,47,2.3
03,02,02,09,15100,100.0,2635,17.5,13573,89.9,12465,82.5,1108,7.3,1527,10.1
03,02,02,10,11464,100.0,1922,16.8,10378,90.5,9542,83.2,836,7.3,1086,9.5
03,02,03,07,18419,100.0,2700,14.7,17195,93.4,15719,85.3,1476,8.0,1224,6.6
03,03,04,05,11455,100.0,2264,19.8,10120,88.3,9191,80.2,929,8.1,1335,11.7
03,03,04,06,8239,100.0,773,9.4,7907,96.0,7466,90.6,441,5.4,332,4.0
03,03,07,11,6913,100.0,603,8.7,6655,96.3,6310,91.3,345,5.0,258,3.7
03,03,07,15,7779,100.0,1591,20.5,6694,86.1,6188,79.5,506,6.5,1085,13.9
03,03,07,16,1120,100.0,48,4.3,1103,98.5,1072,95.7,31,2.8,17,1.5
03,04,05,08,4742,100.0,999,21.1,4404,92.9,3743,78.9,661,13.9,338,7.1
03,04,05,12,10438,100.0,1998,19.1,9449,90.5,8440,80.9,1009,9.7,989,9.5
03,04,05,13,3509,100.0,652,18.6,3189,90.9,2857,81.4,332,9.5,320,9.1
03,04,06,14,37240,100.0,6568,17.6,33611,90.3,30672,82.4,2939,7.9,3629,9.7
03,04,08,18,35738,100.0,7037,19.7,31213,87.3,28701,80.3,2512,7.0,4525,12.7
03,05,09,19,5096,100.0,710,13.9,4612,90.5,4386,86.1,226,4.4,484,9.5
03,05,09,20,7551,100.0,1302,17.2,6776,89.7,6249,82.8,527,7.0,775,10.3
03,05,09,23,10049,100.0,2608,26.0,8325,82.8,7441,74.0,884,8.8,1724,17.2
03,05,09,24,6407,100.0,1628,25.4,5306,82.8,4779,74.6,527,8.2,1101,17.2
03,05,09,25,9819,100.0,2052,20.9,8506,86.6,7767,79.1,739,7.5,1313,13.4
03,05,10,17,4212,100.0,981,23.3,3527,83.7,3231,76.7,296,7.0,685,16.3
03,05,10,21,6981,100.0,1119,16.0,6231,89.3,5862,84.0,369,5.3,750,10.7
03,05,10,22,4640,100.0,548,11.8,4318,93.1,4092,88.2,226,4.9,322,6.9
03,06,11,26,16255,100.0,5324,32.8,12657,77.9,10931,67.2,1726,10.6,3598,22.1
03,06,11,31,10744,100.0,3798,35.3,8137,75.7,6946,64.7,1191,11.1,2607,24.3
03,06,12,27,14632,100.0,4101,28.0,11956,81.7,10531,72.0,1425,9.7,2676,18.3
03,06,12,28,12813,100.0,3459,27.0,10508,82.0,9354,73.0,1154,9.0,2305,18.0
03,06,13,32,22534,100.0,7454,33.1,17594,78.1,15080,66.9,2514,11.2,4940,21.9
03,06,14,29,9970,100.0,1931,19.4,8805,88.3,8039,80.6,766,7.7,1165,11.7
03,06,14,30,3965,100.0,1673,42.2,2606,65.7,2292,57.8,314,7.9,1359,34.3
03,06,14,34,6373,100.0,1927,30.2,5018,78.7,4446,69.8,572,9.0,1355,21.3
03,06,14,35,4063,100.0,1307,32.2,3175,78.1,2756,67.8,419,10.3,888,21.9
03,06,14,41,2825,100.0,817,28.9,2387,84.5,2008,71.1,379,13.4,438,15.5
03,07,15,36,11328,100.0,4314,38.1,8451,74.6,7014,61.9,1437,12.7,2877,25.4
03,07,15,37,15930,100.0,5747,36.1,12021,75.5,10183,63.9,1838,11.5,3909,24.5
03,07,16,33,3188,100.0,1040,32.6,2488,78.0,2148,67.4,340,10.7,700,22.0
03,07,16,38,17612,100.0,5918,33.6,13742,78.0,11694,66.4,2048,11.6,3870,22.0
03,07,16,39,12823,100.0,3635,28.3,10570,82.4,9188,71.7,1382,10.8,2253,17.6
04,01,01,01,10765,100.0,5402,50.2,7619,70.8,5363,49.8,2256,21.0,3146,29.2
04,01,01,02,783,100.0,323,41.3,513,65.5,460,58.7,53,6.8,270,34.5
04,01,01,03,7855,100.0,4401,56.0,5649,71.9,3454,44.0,2195,27.9,2206,28.1
04,02,02,04,178,100.0,66,37.1,137,77.0,112,62.9,25,14.0,41,23.0
04,02,02,05,1304,100.0,337,25.8,1116,85.6,967,74.2,149,11.4,188,14.4
04,02,02,06,2832,100.0,900,31.8,2249,79.4,1932,68.2,317,11.2,583,20.6
04,02,02,07,2569,100.0,829,32.3,2089,81.3,1740,67.7,349,13.6,480,18.7
04,02,02,08,2963,100.0,840,28.3,2537,85.6,2123,71.7,414,14.0,426,14.4
04,02,02,09,3140,100.0,1217,38.8,2206,70.3,1923,61.2,283,9.0,934,29.7
04,02,03,10,806,100.0,531,65.9,345,42.8,275,34.1,70,8.7,461,57.2
04,02,03,11,14745,100.0,4924,33.4,11936,80.9,9821,66.6,2115,14.3,2809,19.1
04,02,03,12,5573,100.0,1885,33.8,4424,79.4,3688,66.2,736,13.2,1149,20.6
04,02,03,13,7212,100.0,2803,38.9,5533,76.7,4409,61.1,1124,15.6,1679,23.3
04,02,03,14,6,100.0,6,100.0,0,0.0,0,0.0,0,0.0,6,100.0
04,03,04,15,3329,100.0,1858,55.8,1957,58.8,1471,44.2,486,14.6,1372,41.2
04,03,04,16,10334,100.0,4992,48.3,7613,73.7,5342,51.7,2271,22.0,2721,26.3
04,03,04,17,10786,100.0,4203,39.0,8326,77.2,6583,61.0,1743,16.2,2460,22.8
04,03,05,18,9637,100.0,4538,47.1,6924,71.8,5099,52.9,1825,18.9,2713,28.2
04,03,05,19,5930,100.0,2784,46.9,4264,71.9,3146,53.1,1118,18.9,1666,28.1
04,03,06,20,8859,100.0,4032,45.5,6474,73.1,4827,54.5,1647,18.6,2385,26.9
04,03,06,21,3429,100.0,2044,59.6,2151,62.7,1385,40.4,766,22.3,1278,37.3
04,03,06,22,10811,100.0,5276,48.8,7734,71.5,5535,51.2,2199,20.3,3077,28.5
04,03,06,23,5157,100.0,2984,57.9,3444,66.8,2173,42.1,1271,24.6,1713,33.2
04,03,07,24,6488,100.0,2527,38.9,4978,76.7,3961,61.1,1017,15.7,1510,23.3
04,03,07,25,12142,100.0,5053,41.6,8989,74.0,7089,58.4,1900,15.6,3153,26.0
04,03,07,26,5641,100.0,2575,45.6,4106,72.8,3066,54.4,1040,18.4,1535,27.2
04,03,08,27,12155,100.0,6690,55.0,7828,64.4,5465,45.0,2363,19.4,4327,35.6
04,03,08,28,9538,100.0,4414,46.3,6689,70.1,5124,53.7,1565,16.4,2849,29.9
04,03,09,29,5964,100.0,2630,44.1,4397,73.7,3334,55.9,1063,17.8,1567,26.3
04,03,09,30,5597,100.0,2611,46.6,3996,71.4,2986,53.4,1010,18.0,1601,28.6
04,03,09,31,3581,100.0,2053,57.3,2222,62.0,1528,42.7,694,19.4,1359,38.0
04,03,10,32,15602,100.0,6890,44.2,11540,74.0,8712,55.8,2828,18.1,4062,26.0
04,04,11,33,110,100.0,73,66.4,49,44.5,37,33.6,12,10.9,61,55.5
04,04,11,34,5470,100.0,2329,42.6,4185,76.5,3141,57.4,1044,19.1,1285,23.5
04,04,11,35,2786,100.0,1051,37.7,2231,80.1,1735,62.3,496,17.8,555,19.9
04,04,11,36,3173,100.0,1169,36.8,2556,80.6,2004,63.2,552,17.4,617,19.4
04,04,11,37,8264,100.0,3289,39.8,6455,78.1,4975,60.2,1480,17.9,1809,21.9
04,04,12,38,6081,100.0,2205,36.3,5032,82.7,3876,63.7,1156,19.0,1049,17.3
04,04,12,39,1038,100.0,642,61.8,576,55.5,396,38.2,180,17.3,462,44.5
04,04,12,40,1513,100.0,425,28.1,1292,85.4,1088,71.9,204,13.5,221,14.6
04,04,12,41,7023,100.0,1878,26.7,5983,85.2,5145,73.3,838,11.9,1040,14.8
04,04,13,42,4178,100.0,1533,36.7,3328,79.7,2645,63.3,683,16.3,850,20.3
04,04,13,43,3574,100.0,1170,32.7,2984,83.5,2404,67.3,580,16.2,590,16.5
04,04,13,44,10593,100.0,3006,28.4,8874,83.8,7587,71.6,1287,12.1,1719,16.2
04,05,14,45,6496,100.0,2991,46.0,4894,75.3,3505,54.0,1389,21.4,1602,24.7
04,05,14,46,11048,100.0,5040,45.6,8135,73.6,6008,54.4,2127,19.3,2913,26.4
04,05,14,47,5283,100.0,2258,42.7,3971,75.2,3025,57.3,946,17.9,1312,24.8
04,05,14,48,9334,100.0,4507,48.3,6516,69.8,4827,51.7,1689,18.1,2818,30.2
04,05,15,49,4715,100.0,2158,45.8,3361,71.3,2557,54.2,804,17.1,1354,28.7
04,05,15,50,5625,100.0,2439,43.4,4178,74.3,3186,56.6,992,17.6,1447,25.7
04,05,15,51,4436,100.0,1992,44.9,3314,74.7,2444,55.1,870,19.6,1122,25.3
04,05,16,52,9834,100.0,3989,40.6,7416,75.4,5845,59.4,1571,16.0,2418,24.6
04,05,16,53,6913,100.0,3015,43.6,5108,73.9,3898,56.4,1210,17.5,1805,26.1
04,05,16,54,3071,100.0,1177,38.3,2376,77.4,1894,61.7,482,15.7,695,22.6
04,05,16,55,7489,100.0,3395,45.3,5542,74.0,4094,54.7,1448,19.3,1947,26.0
04,05,16,56,7572,100.0,2528,33.4,6123,80.9,5044,66.6,1079,14.2,1449,19.1
04,06,17,57,62,100.0,18,29.0,47,75.8,44,71.0,3,4.8,15,24.2
05,01,01,01,10672,100.0,3263,30.6,9090,85.2,7409,69.4,1681,15.8,1582,14.8
05,01,01,02,8500,100.0,3162,37.2,6551,77.1,5338,62.8,1213,14.3,1949,22.9
05,01,01,03,7608,100.0,1512,19.9,6901,90.7,6096,80.1,805,10.6,707,9.3
05,01,02,04,3619,100.0,1597,44.1,2718,75.1,2022,55.9,696,19.2,901,24.9
05,01,02,05,2314,100.0,631,27.3,2069,89.4,1683,72.7,386,16.7,245,10.6
05,01,02,06,10703,100.0,4746,44.3,8095,75.6,5957,55.7,2138,20.0,2608,24.4
05,01,02,07,11547,100.0,6039,52.3,8776,76.0,5508,47.7,3268,28.3,2771,24.0
05,01,02,08,7709,100.0,2893,37.5,5926,76.9,4816,62.5,1110,14.4,1783,23.1
05,01,02,09,6068,100.0,2033,33.5,5074,83.6,4035,66.5,1039,17.1,994,16.4
05,01,03,10,4025,100.0,1651,41.0,2979,74.0,2374,59.0,605,15.0,1046,26.0
05,01,03,11,5756,100.0,2999,52.1,4231,73.5,2757,47.9,1474,25.6,1525,26.5
05,01,03,12,7335,100.0,4313,58.8,4199,57.2,3022,41.2,1177,16.0,3136,42.8
05,01,03,13,6753,100.0,3041,45.0,4801,71.1,3712,55.0,1089,16.1,1952,28.9
05,01,03,14,12340,100.0,4993,40.5,9513,77.1,7347,59.5,2166,17.6,2827,22.9
05,01,03,39,957,100.0,660,69.0,361,37.7,297,31.0,64,6.7,596,62.3
05,02,04,15,3839,100.0,849,22.1,3584,93.4,2990,77.9,594,15.5,255,6.6
05,02,04,16,1694,100.0,106,6.3,1665,98.3,1588,93.7,77,4.5,29,1.7
05,02,04,17,5780,100.0,1801,31.2,4951,85.7,3979,68.8,972,16.8,829,14.3
05,02,04,18,4386,100.0,1251,28.5,3627,82.7,3135,71.5,492,11.2,759,17.3
05,02,04,19,7200,100.0,2332,32.4,5929,82.3,4868,67.6,1061,14.7,1271,17.7
05,02,04,20,1170,100.0,235,20.1,1059,90.5,935,79.9,124,10.6,111,9.5
05,02,05,21,3254,100.0,942,28.9,2889,88.8,2312,71.1,577,17.7,365,11.2
05,02,05,22,7571,100.0,3741,49.4,5170,68.3,3830,50.6,1340,17.7,2401,31.7
05,02,05,23,12398,100.0,7534,60.8,8305,67.0,4864,39.2,3441,27.8,4093,33.0
05,02,05,24,6241,100.0,1519,24.3,5497,88.1,4722,75.7,775,12.4,744,11.9
05,02,06,25,7858,100.0,3135,39.9,5948,75.7,4723,60.1,1225,15.6,1910,24.3
05,02,06,26,18268,100.0,6837,37.4,13985,76.6,11431,62.6,2554,14.0,4283,23.4
05,02,06,27,4453,100.0,2092,47.0,3109,69.8,2361,53.0,748,16.8,1344,30.2
05,02,06,28,2003,100.0,550,27.5,1752,87.5,1453,72.5,299,14.9,251,12.5
05,02,06,29,4436,100.0,721,16.3,4097,92.4,3715,83.7,382,8.6,339,7.6
05,03,07,30,4608,100.0,2551,55.4,3700,80.3,2057,44.6,1643,35.7,908,19.7
05,03,07,31,11885,100.0,5366,45.1,9232,77.7,6519,54.9,2713,22.8,2653,22.3
05,03,08,32,12254,100.0,5881,48.0,8859,72.3,6373,52.0,2486,20.3,3395,27.7
05,03,08,33,486,100.0,240,49.4,355,73.0,246,50.6,109,22.4,131,27.0
05,04,09,34,3198,100.0,637,19.9,2949,92.2,2561,80.1,388,12.1,249,7.8
05,04,09,35,444,100.0,107,24.1,374,84.2,337,75.9,37,8.3,70,15.8
05,04,09,36,10315,100.0,1912,18.5,9696,94.0,8403,81.5,1293,12.5,619,6.0
05,04,09,37,2198,100.0,375,17.1,2056,93.5,1823,82.9,233,10.6,142,6.5
05,04,09,38,3682,100.0,587,15.9,3460,94.0,3095,84.1,365,9.9,222,6.0
06,01,01,01,6988,100.0,1879,26.9,6029,86.3,5109,73.1,920,13.2,959,13.7
06,01,01,02,8808,100.0,3211,36.5,7087,80.5,5597,63.5,1490,16.9,1721,19.5
06,01,01,03,6281,100.0,2055,32.7,5228,83.2,4226,67.3,1002,16.0,1053,16.8
06,01,02,04,6887,100.0,2471,35.9,5613,81.5,4416,64.1,1197,17.4,1274,18.5
06,01,02,05,9881,100.0,3328,33.7,8163,82.6,6553,66.3,1610,16.3,1718,17.4
06,01,02,06,7694,100.0,2340,30.4,6467,84.1,5354,69.6,1113,14.5,1227,15.9
06,01,02,07,8008,100.0,2762,34.5,6530,81.5,5246,65.5,1284,16.0,1478,18.5
06,01,02,08,6824,100.0,2147,31.5,5704,83.6,4677,68.5,1027,15.0,1120,16.4
06,01,02,09,9339,100.0,3337,35.7,7542,80.8,6002,64.3,1540,16.5,1797,19.2
06,01,02,10,4868,100.0,1422,29.2,4109,84.4,3446,70.8,663,13.6,759,15.6
06,02,03,01,4937,100.0,1198,24.3,4371,88.5,3739,75.7,632,12.8,566,11.5
06,02,03,02,6097,100.0,1944,31.9,4959,81.3,4153,68.1,806,13.2,1138,18.7
06,02,03,03,7410,100.0,2395,32.3,6153,83.0,5015,67.7,1138,15.4,1257,17.0
06,02,03,04,7313,100.0,2224,30.4,6197,84.7,5089,69.6,1108,15.2,1116,15.3
06,02,03,05,11399,100.0,4072,35.7,9221,80.9,7327,64.3,1894,16.6,2178,19.1
06,02,03,06,6402,100.0,1313,20.5,5825,91.0,5089,79.5,736,11.5,577,9.0
06,02,04,07,4636,100.0,2337,50.4,3413,73.6,2299,49.6,1114,24.0,1223,26.4
06,02,04,08,7055,100.0,2047,29.0,5946,84.3,5008,71.0,938,13.3,1109,15.7
06,02,04,09,8349,100.0,2221,26.6,7123,85.3,6128,73.4,995,11.9,1226,14.7
06,02,04,10,7062,100.0,1541,21.8,6163,87.3,5521,78.2,642,9.1,899,12.7
06,02,04,11,8627,100.0,2346,27.2,7501,86.9,6281,72.8,1220,14.1,1126,13.1
06,03,05,01,5670,100.0,1365,24.1,4850,85.5,4305,75.9,545,9.6,820,14.5
06,03,05,02,5616,100.0,1397,24.9,4864,86.6,4219,75.1,645,11.5,752,13.4
06,03,05,03,11696,100.0,3484,29.8,9905,84.7,8212,70.2,1693,14.5,1791,15.3
06,03,05,04,11050,100.0,2584,23.4,9832,89.0,8466,76.6,1366,12.4,1218,11.0
06,03,06,05,7088,100.0,2003,28.3,6009,84.8,5085,71.7,924,13.0,1079,15.2
06,03,06,06,5612,100.0,2203,39.3,4214,75.1,3409,60.7,805,14.3,1398,24.9
06,03,06,07,3152,100.0,1209,38.4,2278,72.3,1943,61.6,335,10.6,874,27.7
06,03,06,08,13747,100.0,3997,29.1,11903,86.6,9750,70.9,2153,15.7,1844,13.4
06,03,06,09,12046,100.0,3075,25.5,10389,86.2,8971,74.5,1418,11.8,1657,13.8
06,03,06,10,8511,100.0,2064,24.3,7417,87.1,6447,75.7,970,11.4,1094,12.9
06,04,07,01,10126,100.0,2294,22.7,8888,87.8,7832,77.3,1056,10.4,1238,12.2
06,04,07,02,5234,100.0,1103,21.1,4783,91.4,4131,78.9,652,12.5,451,8.6
06,04,07,03,11498,100.0,3622,31.5,8947,77.8,7876,68.5,1071,9.3,2551,22.2
06,04,08,04,7511,100.0,1415,18.8,6833,91.0,6096,81.2,737,9.8,678,9.0
06,04,08,05,5278,100.0,1230,23.3,4683,88.7,4048,76.7,635,12.0,595,11.3
06,04,08,06,7266,100.0,1225,16.9,6667,91.8,6041,83.1,626,8.6,599,8.2
06,04,08,07,5958,100.0,1496,25.1,5220,87.6,4462,74.9,758,12.7,738,12.4
06,04,08,08,4810,100.0,1808,37.6,4113,85.5,3002,62.4,1111,23.1,697,14.5
06,04,08,09,4902,100.0,1501,30.6,4006,81.7,3401,69.4,605,12.3,896,18.3
06,04,08,10,7204,100.0,2346,32.6,5954,82.6,4858,67.4,1096,15.2,1250,17.4
07,01,01,01,9808,100.0,4807,49.0,7011,71.5,5001,51.0,2010,20.5,2797,28.5
07,01,01,02,16387,100.0,9340,57.0,10667,65.1,7047,43.0,3620,22.1,5720,34.9
07,01,01,03,10468,100.0,4194,40.1,7989,76.3,6274,59.9,1715,16.4,2479,23.7
07,01,01,04,13480,100.0,7600,56.4,9059,67.2,5880,43.6,3179,23.6,4421,32.8
07,02,02,01,10578,100.0,3839,36.3,8492,80.3,6739,63.7,1753,16.6,2086,19.7
07,02,02,02,10501,100.0,4793,45.6,7630,72.7,5708,54.4,1922,18.3,2871,27.3
07,02,02,03,17811,100.0,7934,44.5,13250,74.4,9877,55.5,3373,18.9,4561,25.6
07,02,02,04,12716,100.0,4916,38.7,9844,77.4,7800,61.3,2044,16.1,2872,22.6
07,03,03,01,24466,100.0,7015,28.7,20660,84.4,17451,71.3,3209,13.1,3806,15.6
07,03,03,02,9371,100.0,3043,32.5,7783,83.1,6328,67.5,1455,15.5,1588,16.9
07,03,03,03,12302,100.0,5489,44.6,9473,77.0,6813,55.4,2660,21.6,2829,23.0
07,04,04,01,17502,100.0,6768,38.7,14273,81.6,10734,61.3,3539,20.2,3229,18.4
07,04,04,02,2255,100.0,497,22.0,2034,90.2,1758,78.0,276,12.2,221,9.8
07,04,04,03,24582,100.0,9718,39.5,19207,78.1,14864,60.5,4343,17.7,5375,21.9
07,04,04,04,5114,100.0,1433,28.0,4429,86.6,3681,72.0,748,14.6,685,13.4
07,04,04,05,11104,100.0,5116,46.1,8177,73.6,5988,53.9,2189,19.7,2927,26.4
07,04,04,06,3980,100.0,2275,57.2,2547,64.0,1705,42.8,842,21.2,1433,36.0
07,05,05,01,17028,100.0,7178,42.2,13300,78.1,9850,57.8,3450,20.3,3728,21.9
07,05,05,02,8141,100.0,3266,40.1,6242,76.7,4875,59.9,1367,16.8,1899,23.3
07,05,05,03,9101,100.0,3086,33.9,7635,83.9,6015,66.1,1620,17.8,1466,16.1
07,05,05,04,5653,100.0,1940,34.3,4767,84.3,3713,65.7,1054,18.6,886,15.7
07,05,05,05,10584,100.0,3192,30.2,9106,86.0,7392,69.8,1714,16.2,1478,14.0
07,05,05,06,2233,100.0,535,24.0,2013,90.1,1698,76.0,315,14.1,220,9.9
07,06,06,01,10193,100.0,4368,42.9,7763,76.2,5825,57.1,1938,19.0,2430,23.8
07,06,06,02,4740,100.0,1227,25.9,4202,88.6,3513,74.1,689,14.5,538,11.4
07,06,06,03,2869,100.0,1147,40.0,2358,82.2,1722,60.0,636,22.2,511,17.8
07,06,06,04,14462,100.0,5765,39.9,12109,83.7,8697,60.1,3412,23.6,2353,16.3
07,07,07,01,10498,100.0,2428,23.1,9398,89.5,8070,76.9,1328,12.7,1100,10.5
07,07,07,02,10895,100.0,2521,23.1,9899,90.9,8374,76.9,1525,14.0,996,9.1
07,07,07,03,8485,100.0,2598,30.6,7241,85.3,5887,69.4,1354,16.0,1244,14.7
07,07,07,04,8431,100.0,3393,40.2,6492,77.0,5038,59.8,1454,17.2,1939,23.0
07,07,07,05,6978,100.0,1401,20.1,6366,91.2,5577,79.9,789,11.3,612,8.8
07,07,07,06,3859,100.0,854,22.1,3361,87.1,3005,77.9,356,9.2,498,12.9
07,07,07,07,2964,100.0,561,18.9,2686,90.6,2403,81.1,283,9.5,278,9.4
08,01,01,15,1010,100.0,477,47.2,690,68.3,533,52.8,157,15.5,320,31.7
08,01,01,16,3542,100.0,2069,58.4,2156,60.9,1473,41.6,683,19.3,1386,39.1
08,01,01,17,15688,100.0,8110,51.7,10294,65.6,7578,48.3,2716,17.3,5394,34.4
08,01,01,18,12240,100.0,7493,61.2,7690,62.8,4747,38.8,2943,24.0,4550,37.2
08,01,02,11,9668,100.0,5673,58.7,5964,61.7,3995,41.3,1969,20.4,3704,38.3
08,01,02,12,7451,100.0,5015,67.3,4903,65.8,2436,32.7,2467,33.1,2548,34.2
08,01,02,13,12288,100.0,6818,55.5,7960,64.8,5470,44.5,2490,20.3,4328,35.2
08,01,02,14,8524,100.0,5092,59.7,5063,59.4,3432,40.3,1631,19.1,3461,40.6
08,01,03,01,27007,100.0,13507,50.0,18390,68.1,13500,50.0,4890,18.1,8617,31.9
08,01,03,02,3868,100.0,1470,38.0,3010,77.8,2398,62.0,612,15.8,858,22.2
08,01,03,03,8264,100.0,5054,61.2,4916,59.5,3210,38.8,1706,20.6,3348,40.5
08,01,04,04,23011,100.0,12312,53.5,15075,65.5,10699,46.5,4376,19.0,7936,34.5
08,01,04,05,8811,100.0,4223,47.9,6096,69.2,4588,52.1,1508,17.1,2715,30.8
08,01,04,06,7100,100.0,4302,60.6,4243,59.8,2798,39.4,1445,20.4,2857,40.2
08,01,04,07,777,100.0,353,45.4,560,72.1,424,54.6,136,17.5,217,27.9
08,01,05,08,5767,100.0,4287,74.3,3639,63.1,1480,25.7,2159,37.4,2128,36.9
08,01,05,09,9172,100.0,6053,66.0,6541,71.3,3119,34.0,3422,37.3,2631,28.7
08,01,05,10,448,100.0,293,65.4,227,50.7,155,34.6,72,16.1,221,49.3
08,02,06,19,11672,100.0,6596,56.5,7699,66.0,5076,43.5,2623,22.5,3973,34.0
08,02,06,20,9329,100.0,4380,47.0,7151,76.7,4949,53.0,2202,23.6,2178,23.3
08,02,06,21,2341,100.0,627,26.8,2144,91.6,1714,73.2,430,18.4,197,8.4
08,02,06,22,14254,100.0,4234,29.7,12305,86.3,10020,70.3,2285,16.0,1949,13.7
08,02,06,23,1253,100.0,419,33.4,1069,85.3,834,66.6,235,18.8,184,14.7
08,02,06,24,1404,100.0,528,37.6,1220,86.9,876,62.4,344,24.5,184,13.1
08,02,06,25,3321,100.0,1072,32.3,2786,83.9,2249,67.7,537,16.2,535,16.1
08,02,07,26,8320,100.0,2339,28.1,7320,88.0,5981,71.9,1339,16.1,1000,12.0
08,02,07,27,11578,100.0,3628,31.3,10034,86.7,7950,68.7,2084,18.0,1544,13.3
08,02,07,28,8698,100.0,4052,46.6,6679,76.8,4646,53.4,2033,23.4,2019,23.2
08,03,08,29,12534,100.0,6603,52.7,9848,78.6,5931,47.3,3917,31.3,2686,21.4
08,03,08,30,7303,100.0,3194,43.7,6017,82.4,4109,56.3,1908,26.1,1286,17.6
08,03,08,31,17754,100.0,9538,53.7,13799,77.7,8216,46.3,5583,31.4,3955,22.3
08,04,09,32,2834,100.0,943,33.3,2451,86.5,1891,66.7,560,19.8,383,13.5
08,04,09,33,4103,100.0,1421,34.6,3505,85.4,2682,65.4,823,20.1,598,14.6
08,04,09,34,2661,100.0,930,34.9,2255,84.7,1731,65.1,524,19.7,406,15.3
08,04,10,35,8264,100.0,3004,36.4,6974,84.4,5260,63.6,1714,20.7,1290,15.6
08,04,10,36,6844,100.0,1783,26.1,6125,89.5,5061,73.9,1064,15.5,719,10.5
08,04,10,37,9997,100.0,3006,30.1,8570,85.7,6991,69.9,1579,15.8,1427,14.3
08,04,10,38,7118,100.0,1769,24.9,6535,91.8,5349,75.1,1186,16.7,583,8.2
08,04,10,39,3776,100.0,1131,30.0,3371,89.3,2645,70.0,726,19.2,405,10.7
08,04,10,40,7951,100.0,2150,27.0,7067,88.9,5801,73.0,1266,15.9,884,11.1
09,01,01,01,13104,100.0,4356,33.2,10506,80.2,8748,66.8,1758,13.4,2598,19.8
09,01,01,02,63,100.0,13,20.6,54,85.7,50,79.4,4,6.3,9,14.3
09,01,02,01,4375,100.0,855,19.5,3912,89.4,3520,80.5,392,9.0,463,10.6
09,01,02,02,6924,100.0,1374,19.8,6033,87.1,5550,80.2,483,7.0,891,12.9
09,01,03,01,15796,100.0,2855,18.1,14089,89.2,12941,81.9,1148,7.3,1707,10.8
09,01,03,02,3098,100.0,951,30.7,2565,82.8,2147,69.3,418,13.5,533,17.2
09,01,04,01,8480,100.0,1093,12.9,7845,92.5,7387,87.1,458,5.4,635,7.5
09,01,04,02,11480,100.0,1988,17.3,10470,91.2,9492,82.7,978,8.5,1010,8.8
09,02,05,01,7535,100.0,2458,32.6,5686,75.5,5077,67.4,609,8.1,1849,24.5
09,02,05,02,16103,100.0,3912,24.3,13431,83.4,12191,75.7,1240,7.7,2672,16.6
09,02,06,01,9424,100.0,2986,31.7,7123,75.6,6438,68.3,685,7.3,2301,24.4
09,02,06,02,3580,100.0,346,9.7,3385,94.6,3234,90.3,151,4.2,195,5.4
09,02,07,01,3059,100.0,1289,42.1,2094,68.5,1770,57.9,324,10.6,965,31.5
09,02,07,02,17151,100.0,3500,20.4,14677,85.6,13651,79.6,1026,6.0,2474,14.4
09,02,08,01,3061,100.0,359,11.7,2830,92.5,2702,88.3,128,4.2,231,7.5
09,02,08,02,8292,100.0,1881,22.7,6949,83.8,6411,77.3,538,6.5,1343,16.2
09,03,09,01,14458,100.0,2347,16.2,13377,92.5,12111,83.8,1266,8.8,1081,7.5
09,03,09,02,5660,100.0,1055,18.6,5010,88.5,4605,81.4,405,7.2,650,11.5
09,03,09,03,8169,100.0,1717,21.0,7378,90.3,6452,79.0,926,11.3,791,9.7
09,03,10,01,13167,100.0,1841,14.0,12088,91.8,11326,86.0,762,5.8,1079,8.2
09,03,11,01,7217,100.0,1127,15.6,6551,90.8,6090,84.4,461,6.4,666,9.2
09,03,12,01,1871,100.0,196,10.5,1796,96.0,1675,89.5,121,6.5,75,4.0
09,03,12,02,2571,100.0,281,10.9,2431,94.6,2290,89.1,141,5.5,140,5.4
09,04,13,01,10138,100.0,726,7.2,9774,96.4,9412,92.8,362,3.6,364,3.6
09,04,13,02,1911,100.0,210,11.0,1810,94.7,1701,89.0,109,5.7,101,5.3
09,04,14,01,5445,100.0,505,9.3,5225,96.0,4940,90.7,285,5.2,220,4.0
09,04,14,02,1569,100.0,253,16.1,1429,91.1,1316,83.9,113,7.2,140,8.9
09,04,14,03,4368,100.0,595,13.6,3966,90.8,3773,86.4,193,4.4,402,9.2
09,04,15,01,7337,100.0,1501,20.5,6364,86.7,5836,79.5,528,7.2,973,13.3
09,04,16,01,6867,100.0,601,8.8,6604,96.2,6266,91.2,338,4.9,263,3.8
09,05,17,01,4062,100.0,472,11.6,3756,92.5,3590,88.4,166,4.1,306,7.5
09,05,17,02,14947,100.0,1309,8.8,14309,95.7,13638,91.2,671,4.5,638,4.3
09,05,18,01,9856,100.0,1022,10.4,9315,94.5,8834,89.6,481,4.9,541,5.5
09,05,19,01,11733,100.0,1832,15.6,10531,89.8,9901,84.4,630,5.4,1202,10.2
09,05,20,01,13294,100.0,1294,9.7,12576,94.6,12000,90.3,576,4.3,718,5.4
10,01,01,01,5709,100.0,1600,28.0,4804,84.1,4109,72.0,695,12.2,905,15.9
10,01,01,02,18613,100.0,5123,27.5,15948,85.7,13490,72.5,2458,13.2,2665,14.3
10,01,02,03,1262,100.0,836,66.2,482,38.2,426,33.8,56,4.4,780,61.8
10,01,02,04,10586,100.0,2735,25.8,9184,86.8,7851,74.2,1333,12.6,1402,13.2
10,01,02,05,8198,100.0,1450,17.7,7335,89.5,6748,82.3,587,7.2,863,10.5
10,01,02,06,17316,100.0,4469,25.8,14718,85.0,12847,74.2,1871,10.8,2598,15.0
10,01,02,07,10782,100.0,2877,26.7,9353,86.7,7905,73.3,1448,13.4,1429,13.3
10,01,03,08,2228,100.0,659,29.6,1846,82.9,1569,70.4,277,12.4,382,17.1
10,01,03,09,14860,100.0,3948,26.6,12907,86.9,10912,73.4,1995,13.4,1953,13.1
10,01,03,10,18273,100.0,4546,24.9,15913,87.1,13727,75.1,2186,12.0,2360,12.9
10,01,03,11,3681,100.0,535,14.5,3498,95.0,3146,85.5,352,9.6,183,5.0
10,02,04,12,7171,100.0,2411,33.6,5793,80.8,4760,66.4,1033,14.4,1378,19.2
10,02,04,13,16168,100.0,4039,25.0,13324,82.4,12129,75.0,1195,7.4,2844,17.6
10,02,04,14,1716,100.0,847,49.4,1231,71.7,869,50.6,362,21.1,485,28.3
10,02,04,15,6503,100.0,2463,37.9,4528,69.6,4040,62.1,488,7.5,1975,30.4
10,02,04,16,5929,100.0,1886,31.8,4626,78.0,4043,68.2,583,9.8,1303,22.0
10,02,05,17,9975,100.0,1874,18.8,8748,87.7,8101,81.2,647,6.5,1227,12.3
10,02,05,18,5317,100.0,1338,25.2,4381,82.4,3979,74.8,402,7.6,936,17.6
10,02,05,19,6111,100.0,2081,34.1,4663,76.3,4030,65.9,633,10.4,1448,23.7
10,02,06,20,3465,100.0,707,20.4,3073,88.7,2758,79.6,315,9.1,392,11.3
10,02,06,21,6342,100.0,1532,24.2,5336,84.1,4810,75.8,526,8.3,1006,15.9
10,02,06,22,8919,100.0,1516,17.0,8092,90.7,7403,83.0,689,7.7,827,9.3
10,02,06,23,6487,100.0,915,14.1,6054,93.3,5572,85.9,482,7.4,433,6.7
10,03,07,24,7805,100.0,1435,18.4,6909,88.5,6370,81.6,539,6.9,896,11.5
10,03,07,25,6952,100.0,1652,23.8,5966,85.8,5300,76.2,666,9.6,986,14.2
10,03,07,26,3938,100.0,722,18.3,3571,90.7,3216,81.7,355,9.0,367,9.3
10,03,07,27,10260,100.0,1239,12.1,9760,95.1,9021,87.9,739,7.2,500,4.9
10,04,08,28,7807,100.0,740,9.5,7455,95.5,7067,90.5,388,5.0,352,4.5
10,04,08,29,3868,100.0,429,11.1,3611,93.4,3439,88.9,172,4.4,257,6.6
10,04,08,30,7733,100.0,571,7.4,7550,97.6,7162,92.6,388,5.0,183,2.4
10,04,09,31,9921,100.0,908,9.2,9558,96.3,9013,90.8,545,5.5,363,3.7
10,04,09,32,4457,100.0,519,11.6,4185,93.9,3938,88.4,247,5.5,272,6.1
10,04,09,33,15379,100.0,1233,8.0,14880,96.8,14146,92.0,734,4.8,499,3.2
11,01,01,01,649,100.0,84,12.9,592,91.2,565,87.1,27,4.2,57,8.8
11,01,01,02,2653,100.0,193,7.3,2565,96.7,2460,92.7,105,4.0,88,3.3
11,01,01,03,2189,100.0,728,33.3,1631,74.5,1461,66.7,170,7.8,558,25.5
11,01,02,04,8986,100.0,2976,33.1,7107,79.1,6010,66.9,1097,12.2,1879,20.9
11,01,02,05,7052,100.0,2377,33.7,5540,78.6,4675,66.3,865,12.3,1512,21.4
11,01,02,06,6095,100.0,1733,28.4,4943,81.1,4362,71.6,581,9.5,1152,18.9
11,01,02,07,7609,100.0,2212,29.1,6023,79.2,5397,70.9,626,8.2,1586,20.8
11,01,03,08,11690,100.0,3570,30.5,9572,81.9,8120,69.5,1452,12.4,2118,18.1
11,01,03,09,9583,100.0,2768,28.9,7858,82.0,6815,71.1,1043,10.9,1725,18.0
11,01,03,10,5825,100.0,1267,21.8,4959,85.1,4558,78.2,401,6.9,866,14.9
11,02,04,11,9998,100.0,3074,30.7,7743,77.4,6924,69.3,819,8.2,2255,22.6
11,02,04,12,6856,100.0,1616,23.6,5868,85.6,5240,76.4,628,9.2,988,14.4
11,02,05,13,3898,100.0,819,21.0,3286,84.3,3079,79.0,207,5.3,612,15.7
11,02,05,14,9897,100.0,2655,26.8,7870,79.5,7242,73.2,628,6.3,2027,20.5
11,02,05,15,15296,100.0,4494,29.4,12516,81.8,10802,70.6,1714,11.2,2780,18.2
11,02,05,16,4125,100.0,844,20.5,3696,89.6,3281,79.5,415,10.1,429,10.4
11,03,06,17,6058,100.0,2198,36.3,4741,78.3,3860,63.7,881,14.5,1317,21.7
11,03,06,18,16427,100.0,4960,30.2,13291,80.9,11467,69.8,1824,11.1,3136,19.1
11,03,06,19,11266,100.0,3811,33.8,8934,79.3,7455,66.2,1479,13.1,2332,20.7
11,03,07,20,6359,100.0,3600,56.6,3176,49.9,2759,43.4,417,6.6,3183,50.1
11,03,07,21,25044,100.0,6832,27.3,20499,81.9,18212,72.7,2287,9.1,4545,18.1
11,03,08,24,9956,100.0,3763,37.8,7591,76.2,6193,62.2,1398,14.0,2365,23.8
11,04,09,25,4218,100.0,1043,24.7,3538,83.9,3175,75.3,363,8.6,680,16.1
11,04,09,26,29849,100.0,7406,24.8,24866,83.3,22443,75.2,2423,8.1,4983,16.7
11,04,10,22,5824,100.0,2133,36.6,4277,73.4,3691,63.4,586,10.1,1547,26.6
11,04,10,23,6756,100.0,2506,37.1,5279,78.1,4250,62.9,1029,15.2,1477,21.9
11,04,10,27,3195,100.0,995,31.1,2538,79.4,2200,68.9,338,10.6,657,20.6
11,04,11,28,27002,100.0,7772,28.8,22097,81.8,19230,71.2,2867,10.6,4905,18.2
11,05,12,29,4244,100.0,962,22.7,3692,87.0,3282,77.3,410,9.7,552,13.0
11,05,13,30,10346,100.0,2345,22.7,8718,84.3,8001,77.3,717,6.9,1628,15.7
11,05,13,31,10640,100.0,1410,13.3,9950,93.5,9230,86.7,720,6.8,690,6.5
11,05,13,32,7252,100.0,1088,15.0,6670,92.0,6164,85.0,506,7.0,582,8.0
12,10,31,15,7702,100.0,3446,44.7,5708,74.1,4256,55.3,1452,18.9,1994,25.9
12,10,31,16,9986,100.0,5025,50.3,6879,68.9,4961,49.7,1918,19.2,3107,31.1
12,10,31,17,10985,100.0,6043,55.0,7296,66.4,4942,45.0,2354,21.4,3689,33.6
12,10,32,18,14057,100.0,6520,46.4,10306,73.3,7537,53.6,2769,19.7,3751,26.7
12,10,32,19,8869,100.0,4188,47.2,6536,73.7,4681,52.8,1855,20.9,2333,26.3
12,10,32,20,4661,100.0,1515,32.5,3859,82.8,3146,67.5,713,15.3,802,17.2
12,21,41,25,7783,100.0,2612,33.6,6379,82.0,5171,66.4,1208,15.5,1404,18.0
12,21,41,26,8091,100.0,3329,41.1,6316,78.1,4762,58.9,1554,19.2,1775,21.9
12,21,44,21,2753,100.0,1099,39.9,2070,75.2,1654,60.1,416,15.1,683,24.8
12,21,44,22,8270,100.0,4990,60.3,5295,64.0,3280,39.7,2015,24.4,2975,36.0
12,21,44,23,5667,100.0,2444,43.1,4381,77.3,3223,56.9,1158,20.4,1286,22.7
12,21,44,24,11022,100.0,5976,54.2,7288,66.1,5046,45.8,2242,20.3,3734,33.9
12,21,45,27,10959,100.0,2657,24.2,9431,86.1,8302,75.8,1129,10.3,1528,13.9
12,21,45,28,266,100.0,105,39.5,198,74.4,161,60.5,37,13.9,68,25.6
12,22,42,29,6011,100.0,854,14.2,5660,94.2,5157,85.8,503,8.4,351,5.8
12,22,42,30,18099,100.0,2584,14.3,17091,94.4,15515,85.7,1576,8.7,1008,5.6
12,23,11,01,16726,100.0,2555,15.3,15535,92.9,14171,84.7,1364,8.2,1191,7.1
12,23,11,02,16689,100.0,2307,13.8,15764,94.5,14382,86.2,1382,8.3,925,5.5
12,30,12,03,15001,100.0,4760,31.7,12111,80.7,10241,68.3,1870,12.5,2890,19.3
12,30,12,04,6434,100.0,1578,24.5,5670,88.1,4856,75.5,814,12.7,764,11.9
12,30,12,05,5166,100.0,983,19.0,4730,91.6,4183,81.0,547,10.6,436,8.4
12,30,12,06,5160,100.0,884,17.1,4846,93.9,4276,82.9,570,11.0,314,6.1
12,30,21,07,3065,100.0,1320,43.1,2512,82.0,1745,56.9,767,25.0,553,18.0
12,30,21,08,14788,100.0,6741,45.6,11418,77.2,8047,54.4,3371,22.8,3370,22.8
12,30,21,09,11610,100.0,6118,52.7,8553,73.7,5492,47.3,3061,26.4,3057,26.3
12,30,21,10,10656,100.0,6157,57.8,7409,69.5,4499,42.2,2910,27.3,3247,30.5
12,30,22,11,3310,100.0,991,29.9,2865,86.6,2319,70.1,546,16.5,445,13.4
12,30,22,12,5922,100.0,2958,49.9,4069,68.7,2964,50.1,1105,18.7,1853,31.3
12,30,43,13,6750,100.0,1868,27.7,5527,81.9,4882,72.3,645,9.6,1223,18.1
12,30,43,14,9665,100.0,1570,16.2,8893,92.0,8095,83.8,798,8.3,772,8.0
